date,geography,geography code,Schoolchild or full-time student indicator: Total: All usual residents aged 5 years and over,Schoolchild or full-time student indicator: Student,Schoolchild or full-time student indicator: Not a student
2021,City of London 001,E02000001,8369,1163,7206
2021,Barking and Dagenham 001,E02000002,7628,2311,5317
2021,Barking and Dagenham 002,E02000003,10591,2637,7954
2021,Barking and Dagenham 003,E02000004,6246,1346,4900
2021,Barking and Dagenham 004,E02000005,10107,2862,7245
2021,Barking and Dagenham 006,E02000007,9413,2753,6660
2021,Barking and Dagenham 007,E02000008,12354,3491,8863
2021,Barking and Dagenham 008,E02000009,11839,3575,8264
2021,Barking and Dagenham 009,E02000010,8801,2438,6363
2021,Barking and Dagenham 010,E02000011,6522,1658,4864
2021,Barking and Dagenham 011,E02000012,10768,3028,7740
2021,Barking and Dagenham 012,E02000013,8700,2446,6254
2021,Barking and Dagenham 013,E02000014,9192,2487,6705
2021,Barking and Dagenham 014,E02000015,7549,2118,5431
2021,Barking and Dagenham 015,E02000016,9549,2916,6633
2021,Barking and Dagenham 016,E02000017,8472,2172,6300
2021,Barking and Dagenham 017,E02000018,8791,2551,6240
2021,Barking and Dagenham 018,E02000019,8833,2560,6273
2021,Barking and Dagenham 019,E02000020,12765,3682,9083
2021,Barking and Dagenham 020,E02000021,8133,2452,5681
2021,Barking and Dagenham 021,E02000022,6904,2283,4621
2021,Barking and Dagenham 022,E02000023,7348,2511,4837
2021,Barnet 001,E02000024,10278,1931,8347
2021,Barnet 002,E02000025,8084,1594,6490
2021,Barnet 003,E02000026,6051,1223,4828
2021,Barnet 004,E02000027,9112,2033,7079
2021,Barnet 005,E02000028,6153,1218,4935
2021,Barnet 006,E02000029,8932,2065,6867
2021,Barnet 007,E02000030,9025,1892,7133
2021,Barnet 008,E02000031,7835,1445,6390
2021,Barnet 009,E02000032,7635,1723,5912
2021,Barnet 010,E02000033,8431,1809,6622
2021,Barnet 011,E02000034,8565,1852,6713
2021,Barnet 012,E02000035,8077,1461,6616
2021,Barnet 013,E02000036,10533,2585,7948
2021,Barnet 014,E02000037,10126,2603,7523
2021,Barnet 015,E02000038,10184,2250,7934
2021,Barnet 016,E02000039,6685,1462,5223
2021,Barnet 017,E02000040,8553,2020,6533
2021,Barnet 018,E02000041,8897,2122,6775
2021,Barnet 019,E02000042,10895,2228,8667
2021,Barnet 020,E02000043,7121,1634,5487
2021,Barnet 021,E02000044,8282,2057,6225
2021,Barnet 022,E02000045,9904,2355,7549
2021,Barnet 023,E02000046,6503,1174,5329
2021,Barnet 024,E02000047,11528,3006,8522
2021,Barnet 025,E02000048,9587,2187,7400
2021,Barnet 026,E02000049,9748,2739,7009
2021,Barnet 027,E02000050,9820,2256,7564
2021,Barnet 028,E02000051,8648,1703,6945
2021,Barnet 029,E02000052,9283,1885,7398
2021,Barnet 031,E02000054,7198,1656,5542
2021,Barnet 032,E02000055,11029,2886,8143
2021,Barnet 033,E02000056,8631,1995,6636
2021,Barnet 034,E02000057,7342,2140,5202
2021,Barnet 035,E02000058,9511,2216,7295
2021,Barnet 036,E02000059,10885,2123,8762
2021,Barnet 037,E02000060,10408,3208,7200
2021,Barnet 038,E02000061,7935,1692,6243
2021,Barnet 039,E02000062,6541,1633,4908
2021,Barnet 040,E02000063,7141,1654,5487
2021,Barnet 041,E02000064,6227,1456,4771
2021,Bexley 001,E02000065,7515,2379,5136
2021,Bexley 002,E02000066,8855,2393,6462
2021,Bexley 003,E02000067,9470,2223,7247
2021,Bexley 004,E02000068,7485,1983,5502
2021,Bexley 005,E02000069,6712,1395,5317
2021,Bexley 006,E02000070,7640,1494,6146
2021,Bexley 007,E02000071,7218,1643,5575
2021,Bexley 008,E02000072,11913,3322,8591
2021,Bexley 009,E02000073,10140,1953,8187
2021,Bexley 010,E02000074,8297,1942,6355
2021,Bexley 011,E02000075,7614,1355,6259
2021,Bexley 013,E02000077,7670,1566,6104
2021,Bexley 014,E02000078,7433,1360,6073
2021,Bexley 015,E02000079,8254,1515,6739
2021,Bexley 016,E02000080,9505,1910,7595
2021,Bexley 017,E02000081,7794,1556,6238
2021,Bexley 018,E02000082,8772,1768,7004
2021,Bexley 019,E02000083,10560,2294,8266
2021,Bexley 020,E02000084,10481,2035,8446
2021,Bexley 021,E02000085,7472,1480,5992
2021,Bexley 022,E02000086,6822,1264,5558
2021,Bexley 023,E02000087,7756,1402,6354
2021,Bexley 024,E02000088,7306,1392,5914
2021,Bexley 025,E02000089,7419,1502,5917
2021,Bexley 026,E02000090,9149,1846,7303
2021,Bexley 027,E02000091,9615,1762,7853
2021,Bexley 028,E02000092,6325,1362,4963
2021,Brent 001,E02000093,11204,2336,8868
2021,Brent 002,E02000094,9808,2253,7555
2021,Brent 003,E02000095,9896,2089,7807
2021,Brent 004,E02000096,7191,1389,5802
2021,Brent 005,E02000097,8976,1957,7019
2021,Brent 006,E02000098,8305,1904,6401
2021,Brent 007,E02000099,8831,2113,6718
2021,Brent 008,E02000100,7964,1753,6211
2021,Brent 009,E02000101,9370,2354,7016
2021,Brent 010,E02000102,7711,2215,5496
2021,Brent 011,E02000103,9320,2279,7041
2021,Brent 012,E02000104,7146,1458,5688
2021,Brent 013,E02000105,9167,2259,6908
2021,Brent 014,E02000106,9715,2342,7373
2021,Brent 015,E02000107,10356,2046,8310
2021,Brent 016,E02000108,6824,1609,5215
2021,Brent 018,E02000110,7725,1625,6100
2021,Brent 019,E02000111,10586,2419,8167
2021,Brent 020,E02000112,11141,2315,8826
2021,Brent 021,E02000113,9132,2748,6384
2021,Brent 022,E02000114,8530,1607,6923
2021,Brent 023,E02000115,8206,1582,6624
2021,Brent 024,E02000116,7937,1983,5954
2021,Brent 025,E02000117,11905,3257,8648
2021,Brent 026,E02000118,10678,2267,8411
2021,Brent 027,E02000119,9866,2688,7178
2021,Brent 028,E02000120,8540,1518,7022
2021,Brent 029,E02000121,11464,2594,8870
2021,Brent 030,E02000122,7762,1648,6114
2021,Brent 031,E02000123,12758,3042,9716
2021,Brent 032,E02000124,9285,1830,7455
2021,Brent 033,E02000125,9299,1809,7490
2021,Brent 034,E02000126,7759,1928,5831
2021,Bromley 001,E02000127,8674,1921,6753
2021,Bromley 002,E02000128,7268,1504,5764
2021,Bromley 004,E02000130,7880,1430,6450
2021,Bromley 005,E02000131,9705,1598,8107
2021,Bromley 006,E02000132,9194,1339,7855
2021,Bromley 007,E02000133,10192,2011,8181
2021,Bromley 008,E02000134,10961,2124,8837
2021,Bromley 009,E02000135,9258,1946,7312
2021,Bromley 010,E02000136,5418,1048,4370
2021,Bromley 011,E02000137,7906,1431,6475
2021,Bromley 012,E02000138,8028,1094,6934
2021,Bromley 013,E02000139,7187,1380,5807
2021,Bromley 014,E02000140,8012,1877,6135
2021,Bromley 015,E02000141,6707,1225,5482
2021,Bromley 016,E02000142,8302,1723,6579
2021,Bromley 018,E02000144,9422,1721,7701
2021,Bromley 019,E02000145,8153,1914,6239
2021,Bromley 020,E02000146,9034,1719,7315
2021,Bromley 021,E02000147,7765,1632,6133
2021,Bromley 022,E02000148,6360,1246,5114
2021,Bromley 023,E02000149,7633,1497,6136
2021,Bromley 024,E02000150,8122,1789,6333
2021,Bromley 025,E02000151,7061,1317,5744
2021,Bromley 026,E02000152,7426,1716,5710
2021,Bromley 027,E02000153,7709,1731,5978
2021,Bromley 028,E02000154,8040,1424,6616
2021,Bromley 029,E02000155,6789,1106,5683
2021,Bromley 030,E02000156,11739,2214,9525
2021,Bromley 031,E02000157,7995,1667,6328
2021,Bromley 032,E02000158,7310,1582,5728
2021,Bromley 033,E02000159,6809,1247,5562
2021,Bromley 034,E02000160,7768,1623,6145
2021,Bromley 035,E02000161,8251,1713,6538
2021,Bromley 036,E02000162,6823,1352,5471
2021,Bromley 037,E02000163,7331,1379,5952
2021,Bromley 039,E02000165,6766,1302,5464
2021,Camden 001,E02000166,7418,1421,5997
2021,Camden 002,E02000167,6853,1265,5588
2021,Camden 003,E02000168,7462,1389,6073
2021,Camden 004,E02000169,6729,1446,5283
2021,Camden 005,E02000170,7500,1464,6036
2021,Camden 006,E02000171,7037,1356,5681
2021,Camden 007,E02000172,9474,2436,7038
2021,Camden 008,E02000173,7025,1369,5656
2021,Camden 009,E02000174,7716,1801,5915
2021,Camden 010,E02000175,8638,1612,7026
2021,Camden 011,E02000176,5578,909,4669
2021,Camden 012,E02000177,8059,1833,6226
2021,Camden 013,E02000178,8424,1491,6933
2021,Camden 014,E02000179,5464,1274,4190
2021,Camden 015,E02000180,7550,1796,5754
2021,Camden 016,E02000181,7615,1300,6315
2021,Camden 017,E02000182,6658,1517,5141
2021,Camden 018,E02000183,7204,1429,5775
2021,Camden 019,E02000184,8535,2705,5830
2021,Camden 020,E02000185,8416,1966,6450
2021,Camden 021,E02000186,5990,1598,4392
2021,Camden 022,E02000187,9283,3281,6002
2021,Camden 023,E02000188,6825,2361,4464
2021,Camden 026,E02000191,5226,2393,2833
2021,Camden 027,E02000192,6407,1534,4873
2021,Camden 028,E02000193,5804,1689,4115
2021,Croydon 001,E02000194,8584,1555,7029
2021,Croydon 002,E02000195,9076,1937,7139
2021,Croydon 003,E02000196,7428,1453,5975
2021,Croydon 004,E02000197,8549,1875,6674
2021,Croydon 005,E02000198,8311,1952,6359
2021,Croydon 006,E02000199,7903,1771,6132
2021,Croydon 007,E02000200,8451,1636,6815
2021,Croydon 008,E02000201,8090,1814,6276
2021,Croydon 009,E02000202,8461,2039,6422
2021,Croydon 010,E02000203,7424,1701,5723
2021,Croydon 011,E02000204,9026,2133,6893
2021,Croydon 013,E02000206,9982,2379,7603
2021,Croydon 014,E02000207,8372,1879,6493
2021,Croydon 015,E02000208,9943,2642,7301
2021,Croydon 016,E02000209,8535,2425,6110
2021,Croydon 017,E02000210,8148,1770,6378
2021,Croydon 018,E02000211,7854,1442,6412
2021,Croydon 019,E02000212,8782,2400,6382
2021,Croydon 020,E02000213,11677,2641,9036
2021,Croydon 021,E02000214,5844,1107,4737
2021,Croydon 022,E02000215,10906,2000,8906
2021,Croydon 023,E02000216,6702,1328,5374
2021,Croydon 024,E02000217,10985,2399,8586
2021,Croydon 025,E02000218,6302,1701,4601
2021,Croydon 026,E02000219,7329,1198,6131
2021,Croydon 028,E02000221,10159,2620,7539
2021,Croydon 029,E02000222,7793,1463,6330
2021,Croydon 030,E02000223,8020,2800,5220
2021,Croydon 031,E02000224,7459,1505,5954
2021,Croydon 032,E02000225,7084,1752,5332
2021,Croydon 033,E02000226,7266,1427,5839
2021,Croydon 034,E02000227,11003,2151,8852
2021,Croydon 035,E02000228,7534,1456,6078
2021,Croydon 036,E02000229,5866,1545,4321
2021,Croydon 037,E02000230,9855,1799,8056
2021,Croydon 038,E02000231,7542,1433,6109
2021,Croydon 039,E02000232,5906,1122,4784
2021,Croydon 040,E02000233,5951,1266,4685
2021,Croydon 041,E02000234,8802,1862,6940
2021,Croydon 042,E02000235,6499,1173,5326
2021,Croydon 043,E02000236,8416,1754,6662
2021,Croydon 044,E02000237,7140,1314,5826
2021,Ealing 001,E02000238,10089,2288,7801
2021,Ealing 002,E02000239,8592,1800,6792
2021,Ealing 003,E02000240,10496,2659,7837
2021,Ealing 004,E02000241,6956,1625,5331
2021,Ealing 005,E02000242,6540,1434,5106
2021,Ealing 006,E02000243,8252,1780,6472
2021,Ealing 007,E02000244,7436,1590,5846
2021,Ealing 008,E02000245,8503,2245,6258
2021,Ealing 009,E02000246,8843,2412,6431
2021,Ealing 010,E02000247,10430,2601,7829
2021,Ealing 011,E02000248,7146,1516,5630
2021,Ealing 012,E02000249,7864,1772,6092
2021,Ealing 013,E02000250,6172,1314,4858
2021,Ealing 014,E02000251,7864,1807,6057
2021,Ealing 015,E02000252,11668,3988,7680
2021,Ealing 016,E02000253,9714,2503,7211
2021,Ealing 017,E02000254,8761,1987,6774
2021,Ealing 018,E02000255,9288,2128,7160
2021,Ealing 019,E02000256,8707,1470,7237
2021,Ealing 021,E02000258,6503,1463,5040
2021,Ealing 022,E02000259,6238,1474,4764
2021,Ealing 023,E02000260,9318,2279,7039
2021,Ealing 024,E02000261,11896,2576,9320
2021,Ealing 025,E02000262,8777,1842,6935
2021,Ealing 026,E02000263,12934,3251,9683
2021,Ealing 027,E02000264,8120,1472,6648
2021,Ealing 028,E02000265,10514,2099,8415
2021,Ealing 029,E02000266,12280,3052,9228
2021,Ealing 030,E02000267,7653,1702,5951
2021,Ealing 031,E02000268,8779,1610,7169
2021,Ealing 032,E02000269,7654,1469,6185
2021,Ealing 033,E02000270,8906,1778,7128
2021,Ealing 034,E02000271,6524,1257,5267
2021,Ealing 035,E02000272,6384,1401,4983
2021,Ealing 038,E02000275,7729,1808,5921
2021,Ealing 039,E02000276,6337,1360,4977
2021,Enfield 001,E02000277,7037,1905,5132
2021,Enfield 002,E02000278,8860,2525,6335
2021,Enfield 003,E02000279,11372,3286,8086
2021,Enfield 004,E02000280,8051,1786,6265
2021,Enfield 005,E02000281,8998,2321,6677
2021,Enfield 006,E02000282,9170,2877,6293
2021,Enfield 007,E02000283,8012,2182,5830
2021,Enfield 008,E02000284,8140,1646,6494
2021,Enfield 009,E02000285,6271,1224,5047
2021,Enfield 010,E02000286,8190,1489,6701
2021,Enfield 011,E02000287,6964,1318,5646
2021,Enfield 012,E02000288,11896,3648,8248
2021,Enfield 013,E02000289,6451,1346,5105
2021,Enfield 014,E02000290,6135,1825,4310
2021,Enfield 015,E02000291,9435,1954,7481
2021,Enfield 016,E02000292,9200,2262,6938
2021,Enfield 017,E02000293,6104,1196,4908
2021,Enfield 018,E02000294,8843,2423,6420
2021,Enfield 019,E02000295,8156,1753,6403
2021,Enfield 020,E02000296,9719,2111,7608
2021,Enfield 021,E02000297,8863,1605,7258
2021,Enfield 022,E02000298,7790,1469,6321
2021,Enfield 023,E02000299,8873,2548,6325
2021,Enfield 024,E02000300,8181,2175,6006
2021,Enfield 025,E02000301,9565,2736,6829
2021,Enfield 026,E02000302,8176,1668,6508
2021,Enfield 027,E02000303,7803,2091,5712
2021,Enfield 028,E02000304,7621,1530,6091
2021,Enfield 029,E02000305,8313,1470,6843
2021,Enfield 030,E02000306,8464,2394,6070
2021,Enfield 031,E02000307,9517,2494,7023
2021,Enfield 032,E02000308,8227,1750,6477
2021,Enfield 033,E02000309,10919,3149,7770
2021,Enfield 035,E02000311,9897,2079,7818
2021,Enfield 036,E02000312,10523,1884,8639
2021,Greenwich 001,E02000313,6055,1691,4364
2021,Greenwich 002,E02000314,13099,3576,9523
2021,Greenwich 003,E02000315,9197,2760,6437
2021,Greenwich 005,E02000317,7046,1843,5203
2021,Greenwich 006,E02000318,10258,2534,7724
2021,Greenwich 007,E02000319,9868,2263,7605
2021,Greenwich 008,E02000320,6590,1588,5002
2021,Greenwich 009,E02000321,7190,1770,5420
2021,Greenwich 011,E02000323,11943,3148,8795
2021,Greenwich 012,E02000324,7353,1809,5544
2021,Greenwich 014,E02000326,7317,1454,5863
2021,Greenwich 015,E02000327,6131,1499,4632
2021,Greenwich 016,E02000328,6151,1113,5038
2021,Greenwich 017,E02000329,5913,1265,4648
2021,Greenwich 019,E02000331,7666,1743,5923
2021,Greenwich 020,E02000332,7000,1474,5526
2021,Greenwich 021,E02000333,5921,1046,4875
2021,Greenwich 022,E02000334,6230,1328,4902
2021,Greenwich 023,E02000335,6211,1197,5014
2021,Greenwich 025,E02000337,7997,1860,6137
2021,Greenwich 027,E02000339,5928,1136,4792
2021,Greenwich 028,E02000340,6467,1156,5311
2021,Greenwich 029,E02000341,7468,1910,5558
2021,Greenwich 030,E02000342,5969,1751,4218
2021,Greenwich 031,E02000343,6629,1393,5236
2021,Greenwich 032,E02000344,5999,1145,4854
2021,Hackney 001,E02000345,7278,2524,4754
2021,Hackney 002,E02000346,8695,1903,6792
2021,Hackney 003,E02000347,7242,2442,4800
2021,Hackney 004,E02000348,7197,2453,4744
2021,Hackney 006,E02000350,9486,2030,7456
2021,Hackney 007,E02000351,8767,1516,7251
2021,Hackney 008,E02000352,6271,1397,4874
2021,Hackney 009,E02000353,7349,1297,6052
2021,Hackney 010,E02000354,9148,1898,7250
2021,Hackney 011,E02000355,7703,1406,6297
2021,Hackney 012,E02000356,6667,1157,5510
2021,Hackney 013,E02000357,6470,1679,4791
2021,Hackney 014,E02000358,10567,1847,8720
2021,Hackney 015,E02000359,6233,1311,4922
2021,Hackney 016,E02000360,10864,2555,8309
2021,Hackney 017,E02000361,7663,1360,6303
2021,Hackney 018,E02000362,6642,1343,5299
2021,Hackney 019,E02000363,11145,3070,8075
2021,Hackney 020,E02000364,8769,1568,7201
2021,Hackney 022,E02000366,7917,1694,6223
2021,Hackney 023,E02000367,9945,1798,8147
2021,Hackney 024,E02000368,9422,1991,7431
2021,Hackney 025,E02000369,12736,2404,10332
2021,Hackney 026,E02000370,8443,1844,6599
2021,Hammersmith and Fulham 001,E02000372,9534,2251,7283
2021,Hammersmith and Fulham 002,E02000373,6659,1918,4741
2021,Hammersmith and Fulham 003,E02000374,6548,1656,4892
2021,Hammersmith and Fulham 004,E02000375,7083,1453,5630
2021,Hammersmith and Fulham 005,E02000376,6420,1054,5366
2021,Hammersmith and Fulham 006,E02000377,7372,1532,5840
2021,Hammersmith and Fulham 007,E02000378,6162,1059,5103
2021,Hammersmith and Fulham 008,E02000379,6959,1449,5510
2021,Hammersmith and Fulham 009,E02000380,5173,942,4231
2021,Hammersmith and Fulham 010,E02000381,7237,1403,5834
2021,Hammersmith and Fulham 011,E02000382,5906,1223,4683
2021,Hammersmith and Fulham 012,E02000383,8149,1624,6525
2021,Hammersmith and Fulham 013,E02000384,7917,1727,6190
2021,Hammersmith and Fulham 014,E02000385,5408,944,4464
2021,Hammersmith and Fulham 015,E02000386,7268,1640,5628
2021,Hammersmith and Fulham 016,E02000387,5774,1303,4471
2021,Hammersmith and Fulham 017,E02000388,8295,1494,6801
2021,Hammersmith and Fulham 018,E02000389,8231,1792,6439
2021,Hammersmith and Fulham 019,E02000390,5849,1085,4764
2021,Hammersmith and Fulham 020,E02000391,7177,1395,5782
2021,Hammersmith and Fulham 021,E02000392,8753,1834,6919
2021,Hammersmith and Fulham 022,E02000393,5594,1064,4530
2021,Hammersmith and Fulham 023,E02000394,8700,1655,7045
2021,Hammersmith and Fulham 024,E02000395,5416,941,4475
2021,Hammersmith and Fulham 025,E02000396,6500,1500,5000
2021,Haringey 001,E02000397,7478,1418,6060
2021,Haringey 002,E02000398,7051,1826,5225
2021,Haringey 004,E02000400,7549,1735,5814
2021,Haringey 005,E02000401,6559,1613,4946
2021,Haringey 006,E02000402,6111,1475,4636
2021,Haringey 007,E02000403,7019,1315,5704
2021,Haringey 008,E02000404,6774,1455,5319
2021,Haringey 009,E02000405,6122,1500,4622
2021,Haringey 010,E02000406,6418,1158,5260
2021,Haringey 011,E02000407,7154,1547,5607
2021,Haringey 012,E02000408,7737,1918,5819
2021,Haringey 013,E02000409,5738,1186,4552
2021,Haringey 014,E02000410,6079,1393,4686
2021,Haringey 015,E02000411,10752,3144,7608
2021,Haringey 016,E02000412,7018,1379,5639
2021,Haringey 017,E02000413,7327,1781,5546
2021,Haringey 018,E02000414,6653,1328,5325
2021,Haringey 019,E02000415,6851,1315,5536
2021,Haringey 020,E02000416,7968,1355,6613
2021,Haringey 021,E02000417,6261,1164,5097
2021,Haringey 022,E02000418,5160,988,4172
2021,Haringey 023,E02000419,8253,1350,6903
2021,Haringey 024,E02000420,7546,1304,6242
2021,Haringey 025,E02000421,8040,1872,6168
2021,Haringey 026,E02000422,6948,1437,5511
2021,Haringey 027,E02000423,6571,1008,5563
2021,Haringey 028,E02000424,6402,1112,5290
2021,Haringey 029,E02000425,7287,2813,4474
2021,Haringey 030,E02000426,6173,1229,4944
2021,Haringey 031,E02000427,6297,926,5371
2021,Haringey 032,E02000428,7934,1760,6174
2021,Haringey 033,E02000429,6427,1091,5336
2021,Haringey 034,E02000430,6531,1022,5509
2021,Haringey 035,E02000431,5584,837,4747
2021,Haringey 036,E02000432,5824,833,4991
2021,Harrow 001,E02000433,8179,1489,6690
2021,Harrow 002,E02000434,9289,1821,7468
2021,Harrow 003,E02000435,7722,1777,5945
2021,Harrow 004,E02000436,5508,990,4518
2021,Harrow 005,E02000437,8292,1801,6491
2021,Harrow 006,E02000438,7999,1849,6150
2021,Harrow 007,E02000439,8637,2012,6625
2021,Harrow 008,E02000440,9076,2022,7054
2021,Harrow 009,E02000441,7027,1501,5526
2021,Harrow 010,E02000442,8958,2045,6913
2021,Harrow 011,E02000443,10012,2550,7462
2021,Harrow 012,E02000444,8197,1873,6324
2021,Harrow 013,E02000445,10909,2597,8312
2021,Harrow 015,E02000447,7686,1728,5958
2021,Harrow 016,E02000448,6663,1356,5307
2021,Harrow 017,E02000449,7791,1615,6176
2021,Harrow 019,E02000451,6360,1297,5063
2021,Harrow 020,E02000452,8798,2013,6785
2021,Harrow 021,E02000453,7808,1672,6136
2021,Harrow 022,E02000454,6981,1659,5322
2021,Harrow 023,E02000455,10766,2064,8702
2021,Harrow 024,E02000456,7382,1570,5812
2021,Harrow 025,E02000457,6748,1429,5319
2021,Harrow 027,E02000459,8704,2051,6653
2021,Harrow 028,E02000460,6815,1712,5103
2021,Harrow 029,E02000461,6882,1911,4971
2021,Harrow 030,E02000462,6593,1511,5082
2021,Harrow 031,E02000463,8281,2079,6202
2021,Havering 001,E02000464,7259,1619,5640
2021,Havering 002,E02000465,8684,2059,6625
2021,Havering 003,E02000466,8445,1757,6688
2021,Havering 004,E02000467,10609,3007,7602
2021,Havering 005,E02000468,8102,1758,6344
2021,Havering 006,E02000469,6746,1561,5185
2021,Havering 007,E02000470,9132,1463,7669
2021,Havering 008,E02000471,7444,1297,6147
2021,Havering 009,E02000472,8910,1781,7129
2021,Havering 010,E02000473,9824,1935,7889
2021,Havering 011,E02000474,8519,1832,6687
2021,Havering 012,E02000475,9039,1518,7521
2021,Havering 013,E02000476,8632,1573,7059
2021,Havering 014,E02000477,9013,1545,7468
2021,Havering 015,E02000478,5748,952,4796
2021,Havering 016,E02000479,8748,1803,6945
2021,Havering 017,E02000480,12701,2949,9752
2021,Havering 018,E02000481,7769,1460,6309
2021,Havering 019,E02000482,6305,1204,5101
2021,Havering 020,E02000483,7554,1221,6333
2021,Havering 021,E02000484,8053,1470,6583
2021,Havering 022,E02000485,7983,1429,6554
2021,Havering 023,E02000486,6955,1086,5869
2021,Havering 024,E02000487,7583,1314,6269
2021,Havering 025,E02000488,7187,1107,6080
2021,Havering 026,E02000489,8090,1645,6445
2021,Havering 027,E02000490,7919,1582,6337
2021,Havering 028,E02000491,9889,2340,7549
2021,Havering 029,E02000492,6481,1141,5340
2021,Havering 030,E02000493,6241,1437,4804
2021,Hillingdon 001,E02000494,7590,1378,6212
2021,Hillingdon 002,E02000495,9805,1989,7816
2021,Hillingdon 003,E02000496,7391,1327,6064
2021,Hillingdon 004,E02000497,8980,1822,7158
2021,Hillingdon 005,E02000498,5994,1068,4926
2021,Hillingdon 006,E02000499,7339,1366,5973
2021,Hillingdon 007,E02000500,7892,1411,6481
2021,Hillingdon 008,E02000501,7979,1542,6437
2021,Hillingdon 009,E02000502,8262,1654,6608
2021,Hillingdon 010,E02000503,8098,1512,6586
2021,Hillingdon 011,E02000504,7233,1398,5835
2021,Hillingdon 013,E02000506,7580,1403,6177
2021,Hillingdon 014,E02000507,7716,1797,5919
2021,Hillingdon 015,E02000508,11143,3559,7584
2021,Hillingdon 016,E02000509,9937,4011,5926
2021,Hillingdon 017,E02000510,8603,1935,6668
2021,Hillingdon 018,E02000511,9293,2189,7104
2021,Hillingdon 019,E02000512,8191,2010,6181
2021,Hillingdon 020,E02000513,8965,2490,6475
2021,Hillingdon 021,E02000514,9970,2675,7295
2021,Hillingdon 022,E02000515,12231,2937,9294
2021,Hillingdon 023,E02000516,8099,2030,6069
2021,Hillingdon 024,E02000517,9739,2575,7164
2021,Hillingdon 025,E02000518,8829,2234,6595
2021,Hillingdon 026,E02000519,8968,2467,6501
2021,Hillingdon 027,E02000520,13043,3315,9728
2021,Hillingdon 028,E02000521,12156,3083,9073
2021,Hillingdon 029,E02000522,8899,2066,6833
2021,Hillingdon 030,E02000523,10650,2561,8089
2021,Hillingdon 031,E02000524,7045,1415,5630
2021,Hillingdon 032,E02000525,9354,2290,7064
2021,Hounslow 001,E02000526,8235,1634,6601
2021,Hounslow 004,E02000529,9070,2237,6833
2021,Hounslow 005,E02000530,7538,2169,5369
2021,Hounslow 006,E02000531,10878,2157,8721
2021,Hounslow 007,E02000532,8479,1658,6821
2021,Hounslow 008,E02000533,7951,1632,6319
2021,Hounslow 009,E02000534,8053,1658,6395
2021,Hounslow 010,E02000535,9494,2119,7375
2021,Hounslow 011,E02000536,10196,2365,7831
2021,Hounslow 012,E02000537,9299,2108,7191
2021,Hounslow 013,E02000538,9510,2063,7447
2021,Hounslow 014,E02000539,11416,2548,8868
2021,Hounslow 015,E02000540,11225,2472,8753
2021,Hounslow 016,E02000541,9898,2180,7718
2021,Hounslow 017,E02000542,11411,2719,8692
2021,Hounslow 018,E02000543,12877,2940,9937
2021,Hounslow 019,E02000544,8130,1703,6427
2021,Hounslow 020,E02000545,8635,2093,6542
2021,Hounslow 021,E02000546,9795,2397,7398
2021,Hounslow 022,E02000547,10275,2289,7986
2021,Hounslow 023,E02000548,9853,2365,7488
2021,Hounslow 024,E02000549,11839,2646,9193
2021,Hounslow 025,E02000550,10012,2441,7571
2021,Hounslow 026,E02000551,9061,2247,6814
2021,Hounslow 027,E02000552,8641,1970,6671
2021,Hounslow 028,E02000553,6665,1521,5144
2021,Islington 001,E02000554,8811,1823,6988
2021,Islington 002,E02000555,9092,1913,7179
2021,Islington 003,E02000556,10820,1991,8829
2021,Islington 004,E02000557,8367,1541,6826
2021,Islington 005,E02000558,8830,2090,6740
2021,Islington 006,E02000559,9043,1716,7327
2021,Islington 007,E02000560,7023,1358,5665
2021,Islington 008,E02000561,7062,1451,5611
2021,Islington 009,E02000562,7465,1326,6139
2021,Islington 010,E02000563,8262,1855,6407
2021,Islington 011,E02000564,11819,2323,9496
2021,Islington 012,E02000565,8121,1759,6362
2021,Islington 013,E02000566,8060,1401,6659
2021,Islington 014,E02000567,9891,1493,8398
2021,Islington 015,E02000568,10793,2638,8155
2021,Islington 016,E02000569,9363,1775,7588
2021,Islington 017,E02000570,7864,1209,6655
2021,Islington 018,E02000571,8311,1513,6798
2021,Islington 019,E02000572,8190,2114,6076
2021,Islington 020,E02000573,9797,1667,8130
2021,Islington 021,E02000574,7539,1819,5720
2021,Islington 022,E02000575,10729,2828,7901
2021,Islington 023,E02000576,10129,2494,7635
2021,Kensington and Chelsea 001,E02000577,7408,1745,5663
2021,Kensington and Chelsea 002,E02000578,5674,1317,4357
2021,Kensington and Chelsea 003,E02000579,8478,1617,6861
2021,Kensington and Chelsea 004,E02000580,7613,1142,6471
2021,Kensington and Chelsea 005,E02000581,7095,1552,5543
2021,Kensington and Chelsea 006,E02000582,6254,1089,5165
2021,Kensington and Chelsea 007,E02000583,6151,1089,5062
2021,Kensington and Chelsea 008,E02000584,6832,1429,5403
2021,Kensington and Chelsea 009,E02000585,7715,1640,6075
2021,Kensington and Chelsea 010,E02000586,6225,1403,4822
2021,Kensington and Chelsea 011,E02000587,6213,1253,4960
2021,Kensington and Chelsea 012,E02000588,5740,1151,4589
2021,Kensington and Chelsea 013,E02000589,6990,1827,5163
2021,Kensington and Chelsea 014,E02000590,5749,1107,4642
2021,Kensington and Chelsea 015,E02000591,5963,1273,4690
2021,Kensington and Chelsea 016,E02000592,5493,1198,4295
2021,Kensington and Chelsea 017,E02000593,6998,1581,5417
2021,Kensington and Chelsea 018,E02000594,6280,916,5364
2021,Kensington and Chelsea 019,E02000595,5877,1084,4793
2021,Kensington and Chelsea 020,E02000596,6384,1337,5047
2021,Kensington and Chelsea 021,E02000597,6072,1207,4865
2021,Kingston upon Thames 001,E02000598,7733,2023,5710
2021,Kingston upon Thames 002,E02000599,6756,1617,5139
2021,Kingston upon Thames 003,E02000600,7849,1930,5919
2021,Kingston upon Thames 004,E02000601,11128,2722,8406
2021,Kingston upon Thames 005,E02000602,9648,2982,6666
2021,Kingston upon Thames 006,E02000603,8144,2215,5929
2021,Kingston upon Thames 007,E02000604,8656,1919,6737
2021,Kingston upon Thames 008,E02000605,8000,1713,6287
2021,Kingston upon Thames 009,E02000606,9991,2420,7571
2021,Kingston upon Thames 010,E02000607,6415,1841,4574
2021,Kingston upon Thames 011,E02000608,6799,1275,5524
2021,Kingston upon Thames 012,E02000609,7278,1585,5693
2021,Kingston upon Thames 013,E02000610,7502,1273,6229
2021,Kingston upon Thames 014,E02000611,7064,1585,5479
2021,Kingston upon Thames 015,E02000612,7808,1468,6340
2021,Kingston upon Thames 016,E02000613,7525,1591,5934
2021,Kingston upon Thames 017,E02000614,8727,2003,6724
2021,Kingston upon Thames 018,E02000615,7455,1566,5889
2021,Kingston upon Thames 019,E02000616,5701,1092,4609
2021,Kingston upon Thames 020,E02000617,8325,1660,6665
2021,Lambeth 002,E02000619,8636,1777,6859
2021,Lambeth 003,E02000620,9460,1826,7634
2021,Lambeth 004,E02000621,12087,2333,9754
2021,Lambeth 005,E02000622,8049,1353,6696
2021,Lambeth 006,E02000623,7574,1548,6026
2021,Lambeth 007,E02000624,9215,1641,7574
2021,Lambeth 008,E02000625,8850,1880,6970
2021,Lambeth 009,E02000626,7948,1891,6057
2021,Lambeth 010,E02000627,9135,1693,7442
2021,Lambeth 011,E02000628,10364,2109,8255
2021,Lambeth 012,E02000629,8785,1206,7579
2021,Lambeth 013,E02000630,7241,1024,6217
2021,Lambeth 014,E02000631,9047,1825,7222
2021,Lambeth 015,E02000632,9348,926,8422
2021,Lambeth 016,E02000633,8762,1630,7132
2021,Lambeth 017,E02000634,6510,1077,5433
2021,Lambeth 018,E02000635,9381,1584,7797
2021,Lambeth 019,E02000636,7300,1110,6190
2021,Lambeth 020,E02000637,8040,1104,6936
2021,Lambeth 021,E02000638,9770,1676,8094
2021,Lambeth 022,E02000639,7982,1484,6498
2021,Lambeth 023,E02000640,8737,1525,7212
2021,Lambeth 024,E02000641,8156,2068,6088
2021,Lambeth 025,E02000642,9274,1886,7388
2021,Lambeth 026,E02000643,8900,1647,7253
2021,Lambeth 027,E02000644,7996,1596,6400
2021,Lambeth 028,E02000645,8929,1728,7201
2021,Lambeth 029,E02000646,9021,1539,7482
2021,Lambeth 030,E02000647,8018,1580,6438
2021,Lambeth 031,E02000648,7296,1762,5534
2021,Lambeth 032,E02000649,11754,1975,9779
2021,Lambeth 033,E02000650,7182,1458,5724
2021,Lambeth 034,E02000651,8188,1424,6764
2021,Lambeth 035,E02000652,7120,1494,5626
2021,Lewisham 001,E02000653,11955,2480,9475
2021,Lewisham 002,E02000654,8303,2115,6188
2021,Lewisham 003,E02000655,9675,2484,7191
2021,Lewisham 005,E02000657,9418,2558,6860
2021,Lewisham 006,E02000658,8210,1662,6548
2021,Lewisham 007,E02000659,7633,1533,6100
2021,Lewisham 008,E02000660,7736,1449,6287
2021,Lewisham 009,E02000661,6113,1054,5059
2021,Lewisham 010,E02000662,7749,1740,6009
2021,Lewisham 011,E02000663,6413,1246,5167
2021,Lewisham 013,E02000665,7611,1505,6106
2021,Lewisham 014,E02000666,6716,1418,5298
2021,Lewisham 015,E02000667,6203,1313,4890
2021,Lewisham 016,E02000668,6297,1417,4880
2021,Lewisham 017,E02000669,7334,1301,6033
2021,Lewisham 018,E02000670,6230,1272,4958
2021,Lewisham 019,E02000671,8054,1494,6560
2021,Lewisham 020,E02000672,9477,1861,7616
2021,Lewisham 021,E02000673,7658,1449,6209
2021,Lewisham 022,E02000674,7839,1620,6219
2021,Lewisham 023,E02000675,7971,1611,6360
2021,Lewisham 024,E02000676,7250,1400,5850
2021,Lewisham 025,E02000677,6752,1307,5445
2021,Lewisham 026,E02000678,6454,1634,4820
2021,Lewisham 027,E02000679,7558,1600,5958
2021,Lewisham 028,E02000680,6555,1465,5090
2021,Lewisham 029,E02000681,7886,1807,6079
2021,Lewisham 030,E02000682,8401,2307,6094
2021,Lewisham 031,E02000683,6338,1328,5010
2021,Lewisham 033,E02000685,7632,1688,5944
2021,Lewisham 034,E02000686,7025,1818,5207
2021,Lewisham 035,E02000687,7699,1486,6213
2021,Merton 001,E02000689,8314,1748,6566
2021,Merton 002,E02000690,5306,1025,4281
2021,Merton 003,E02000691,6932,1288,5644
2021,Merton 004,E02000692,7269,1145,6124
2021,Merton 005,E02000693,9252,1327,7925
2021,Merton 006,E02000694,8380,1404,6976
2021,Merton 007,E02000695,8110,1534,6576
2021,Merton 008,E02000696,8100,1534,6566
2021,Merton 009,E02000697,8097,1310,6787
2021,Merton 010,E02000698,7785,1774,6011
2021,Merton 011,E02000699,7625,1522,6103
2021,Merton 012,E02000700,8134,1824,6310
2021,Merton 013,E02000701,8485,1914,6571
2021,Merton 014,E02000702,8641,2180,6461
2021,Merton 015,E02000703,7553,1574,5979
2021,Merton 016,E02000704,7997,1382,6615
2021,Merton 017,E02000705,8829,1931,6898
2021,Merton 018,E02000706,9319,2379,6940
2021,Merton 019,E02000707,7814,2003,5811
2021,Merton 020,E02000708,8328,1801,6527
2021,Merton 021,E02000709,7510,1550,5960
2021,Merton 022,E02000710,8614,1778,6836
2021,Merton 023,E02000711,8843,1910,6933
2021,Merton 024,E02000712,9080,2064,7016
2021,Merton 025,E02000713,7338,1447,5891
2021,Newham 001,E02000714,7148,1696,5452
2021,Newham 002,E02000715,6707,2168,4539
2021,Newham 003,E02000716,6801,1889,4912
2021,Newham 004,E02000717,7748,2356,5392
2021,Newham 005,E02000718,6854,2271,4583
2021,Newham 006,E02000719,7570,1724,5846
2021,Newham 007,E02000720,6931,1828,5103
2021,Newham 008,E02000721,8835,2482,6353
2021,Newham 009,E02000722,7687,1655,6032
2021,Newham 010,E02000723,10340,2720,7620
2021,Newham 011,E02000724,9214,2733,6481
2021,Newham 012,E02000725,9350,2104,7246
2021,Newham 014,E02000727,7919,2372,5547
2021,Newham 015,E02000728,7974,2212,5762
2021,Newham 016,E02000729,6727,1550,5177
2021,Newham 017,E02000730,9048,2348,6700
2021,Newham 018,E02000731,9278,2682,6596
2021,Newham 019,E02000732,8227,2338,5889
2021,Newham 020,E02000733,9491,2297,7194
2021,Newham 021,E02000734,6876,1630,5246
2021,Newham 022,E02000735,8034,2260,5774
2021,Newham 023,E02000736,8560,2701,5859
2021,Newham 024,E02000737,9703,2889,6814
2021,Newham 025,E02000738,8849,2490,6359
2021,Newham 026,E02000739,7200,1923,5277
2021,Newham 027,E02000740,6363,1512,4851
2021,Newham 028,E02000741,7729,2123,5606
2021,Newham 029,E02000742,8085,2428,5657
2021,Newham 030,E02000743,9712,2559,7153
2021,Newham 031,E02000744,8495,2236,6259
2021,Newham 032,E02000745,8073,2108,5965
2021,Newham 033,E02000746,8789,2269,6520
2021,Newham 034,E02000747,12401,2545,9856
2021,Newham 035,E02000748,5907,1638,4269
2021,Newham 036,E02000749,8965,2357,6608
2021,Redbridge 001,E02000751,10602,2039,8563
2021,Redbridge 002,E02000752,8134,1883,6251
2021,Redbridge 003,E02000753,6376,1434,4942
2021,Redbridge 004,E02000754,6340,1263,5077
2021,Redbridge 005,E02000755,5157,1041,4116
2021,Redbridge 006,E02000756,13626,3159,10467
2021,Redbridge 007,E02000757,11558,2168,9390
2021,Redbridge 008,E02000758,6508,1598,4910
2021,Redbridge 009,E02000759,12197,2809,9388
2021,Redbridge 010,E02000760,7082,1755,5327
2021,Redbridge 012,E02000762,6289,1421,4868
2021,Redbridge 013,E02000763,7500,1782,5718
2021,Redbridge 014,E02000764,11591,1879,9712
2021,Redbridge 015,E02000765,6995,1735,5260
2021,Redbridge 017,E02000767,8077,2008,6069
2021,Redbridge 018,E02000768,5440,1109,4331
2021,Redbridge 020,E02000770,7650,1984,5666
2021,Redbridge 022,E02000772,7852,2208,5644
2021,Redbridge 023,E02000773,9935,2990,6945
2021,Redbridge 024,E02000774,7451,1990,5461
2021,Redbridge 026,E02000776,6536,1762,4774
2021,Redbridge 027,E02000777,5574,1134,4440
2021,Redbridge 029,E02000779,7643,1857,5786
2021,Redbridge 031,E02000781,15123,4342,10781
2021,Redbridge 032,E02000782,10513,3098,7415
2021,Redbridge 033,E02000783,6823,2105,4718
2021,Richmond upon Thames 001,E02000784,9656,2113,7543
2021,Richmond upon Thames 002,E02000785,9223,1690,7533
2021,Richmond upon Thames 003,E02000786,10477,2030,8447
2021,Richmond upon Thames 004,E02000787,11285,2278,9007
2021,Richmond upon Thames 005,E02000788,8473,1904,6569
2021,Richmond upon Thames 006,E02000789,5987,1133,4854
2021,Richmond upon Thames 007,E02000790,6162,1352,4810
2021,Richmond upon Thames 008,E02000791,6091,1121,4970
2021,Richmond upon Thames 009,E02000792,6806,1386,5420
2021,Richmond upon Thames 010,E02000793,7684,1569,6115
2021,Richmond upon Thames 011,E02000794,6593,1421,5172
2021,Richmond upon Thames 012,E02000795,6557,1651,4906
2021,Richmond upon Thames 013,E02000796,10462,2413,8049
2021,Richmond upon Thames 014,E02000797,7353,1499,5854
2021,Richmond upon Thames 015,E02000798,10630,2577,8053
2021,Richmond upon Thames 016,E02000799,6330,1921,4409
2021,Richmond upon Thames 017,E02000800,5111,1272,3839
2021,Richmond upon Thames 018,E02000801,6680,1456,5224
2021,Richmond upon Thames 019,E02000802,6693,1341,5352
2021,Richmond upon Thames 020,E02000803,9192,1873,7319
2021,Richmond upon Thames 021,E02000804,6745,1316,5429
2021,Richmond upon Thames 022,E02000805,10225,2142,8083
2021,Richmond upon Thames 023,E02000806,9757,1891,7866
2021,Southwark 001,E02000807,7809,1078,6731
2021,Southwark 002,E02000808,9854,2847,7007
2021,Southwark 004,E02000810,11297,2304,8993
2021,Southwark 006,E02000812,10338,2792,7546
2021,Southwark 007,E02000813,9740,2150,7590
2021,Southwark 008,E02000814,9714,1504,8210
2021,Southwark 009,E02000815,7300,2219,5081
2021,Southwark 010,E02000816,9054,1894,7160
2021,Southwark 011,E02000817,6473,1384,5089
2021,Southwark 012,E02000818,9350,1916,7434
2021,Southwark 013,E02000819,8010,1976,6034
2021,Southwark 014,E02000820,8846,2119,6727
2021,Southwark 015,E02000821,8762,2313,6449
2021,Southwark 016,E02000822,6361,1599,4762
2021,Southwark 017,E02000823,8306,1819,6487
2021,Southwark 018,E02000824,9358,2489,6869
2021,Southwark 019,E02000825,9667,2561,7106
2021,Southwark 020,E02000826,9326,2123,7203
2021,Southwark 021,E02000827,10708,2303,8405
2021,Southwark 022,E02000828,8356,1926,6430
2021,Southwark 023,E02000829,10292,1963,8329
2021,Southwark 024,E02000830,8461,1500,6961
2021,Southwark 025,E02000831,8787,1557,7230
2021,Southwark 026,E02000832,9103,1757,7346
2021,Southwark 027,E02000833,7050,1654,5396
2021,Southwark 028,E02000834,8762,1550,7212
2021,Southwark 029,E02000835,7084,1575,5509
2021,Southwark 030,E02000836,7664,1409,6255
2021,Southwark 031,E02000837,8076,1984,6092
2021,Southwark 032,E02000838,8861,1799,7062
2021,Southwark 033,E02000839,7953,1916,6037
2021,Sutton 001,E02000840,8678,2140,6538
2021,Sutton 002,E02000841,8634,2088,6546
2021,Sutton 003,E02000842,7838,1618,6220
2021,Sutton 004,E02000843,8674,1694,6980
2021,Sutton 005,E02000844,8142,1880,6262
2021,Sutton 006,E02000845,8773,1909,6864
2021,Sutton 007,E02000846,7202,1573,5629
2021,Sutton 008,E02000847,8857,1693,7164
2021,Sutton 009,E02000848,7726,1791,5935
2021,Sutton 010,E02000849,7637,1607,6030
2021,Sutton 011,E02000850,10225,2155,8070
2021,Sutton 012,E02000851,10664,2207,8457
2021,Sutton 013,E02000852,7640,1573,6067
2021,Sutton 014,E02000853,7638,1727,5911
2021,Sutton 015,E02000854,7114,1429,5685
2021,Sutton 016,E02000855,7799,1583,6216
2021,Sutton 017,E02000856,8774,1845,6929
2021,Sutton 018,E02000857,8436,1517,6919
2021,Sutton 019,E02000858,8006,2057,5949
2021,Sutton 020,E02000859,8077,1667,6410
2021,Sutton 021,E02000860,8166,1494,6672
2021,Sutton 022,E02000861,7439,1507,5932
2021,Sutton 024,E02000863,6418,1347,5071
2021,Tower Hamlets 001,E02000864,10552,2260,8292
2021,Tower Hamlets 002,E02000865,7500,1681,5819
2021,Tower Hamlets 003,E02000866,9968,1957,8011
2021,Tower Hamlets 004,E02000867,10728,2004,8724
2021,Tower Hamlets 005,E02000868,6834,1485,5349
2021,Tower Hamlets 006,E02000869,5634,1195,4439
2021,Tower Hamlets 007,E02000870,6016,1454,4562
2021,Tower Hamlets 008,E02000871,10670,2819,7851
2021,Tower Hamlets 009,E02000872,7752,1739,6013
2021,Tower Hamlets 010,E02000873,9222,3652,5570
2021,Tower Hamlets 011,E02000874,7045,2074,4971
2021,Tower Hamlets 012,E02000875,12713,3403,9310
2021,Tower Hamlets 013,E02000876,6837,1608,5229
2021,Tower Hamlets 014,E02000877,12908,3485,9423
2021,Tower Hamlets 015,E02000878,9953,2681,7272
2021,Tower Hamlets 016,E02000879,7832,2093,5739
2021,Tower Hamlets 017,E02000880,6043,1667,4376
2021,Tower Hamlets 018,E02000881,10006,2729,7277
2021,Tower Hamlets 019,E02000882,10697,3035,7662
2021,Tower Hamlets 020,E02000883,8656,2643,6013
2021,Tower Hamlets 021,E02000884,12070,3568,8502
2021,Tower Hamlets 022,E02000885,6587,1794,4793
2021,Tower Hamlets 023,E02000886,9011,1821,7190
2021,Tower Hamlets 024,E02000887,10022,2671,7351
2021,Tower Hamlets 025,E02000888,8048,1864,6184
2021,Tower Hamlets 026,E02000889,8471,1723,6748
2021,Tower Hamlets 027,E02000890,5505,666,4839
2021,Tower Hamlets 030,E02000893,6924,1515,5409
2021,Tower Hamlets 031,E02000894,10224,2093,8131
2021,Waltham Forest 001,E02000895,7921,1587,6334
2021,Waltham Forest 002,E02000896,8777,1562,7215
2021,Waltham Forest 003,E02000897,8101,1703,6398
2021,Waltham Forest 004,E02000898,7559,1500,6059
2021,Waltham Forest 005,E02000899,8304,1737,6567
2021,Waltham Forest 006,E02000900,8386,1981,6405
2021,Waltham Forest 007,E02000901,9797,1976,7821
2021,Waltham Forest 008,E02000902,9170,2229,6941
2021,Waltham Forest 009,E02000903,9583,2455,7128
2021,Waltham Forest 010,E02000904,7877,1774,6103
2021,Waltham Forest 011,E02000905,9530,2217,7313
2021,Waltham Forest 012,E02000906,8989,2011,6978
2021,Waltham Forest 013,E02000907,9770,2454,7316
2021,Waltham Forest 014,E02000908,12067,2762,9305
2021,Waltham Forest 015,E02000909,8582,1842,6740
2021,Waltham Forest 016,E02000910,10635,2007,8628
2021,Waltham Forest 017,E02000911,12047,2478,9569
2021,Waltham Forest 018,E02000912,9034,1937,7097
2021,Waltham Forest 019,E02000913,8952,2125,6827
2021,Waltham Forest 020,E02000914,10952,2629,8323
2021,Waltham Forest 021,E02000915,7592,1359,6233
2021,Waltham Forest 022,E02000916,9798,2073,7725
2021,Waltham Forest 023,E02000917,8808,1692,7116
2021,Waltham Forest 024,E02000918,8682,1759,6923
2021,Waltham Forest 025,E02000919,8556,1565,6991
2021,Waltham Forest 026,E02000920,9674,2125,7549
2021,Waltham Forest 027,E02000921,10521,2311,8210
2021,Waltham Forest 028,E02000922,9779,2316,7463
2021,Wandsworth 001,E02000923,7159,1026,6133
2021,Wandsworth 003,E02000925,7428,1493,5935
2021,Wandsworth 004,E02000926,11023,1546,9477
2021,Wandsworth 005,E02000927,6734,975,5759
2021,Wandsworth 006,E02000928,7892,1309,6583
2021,Wandsworth 007,E02000929,7592,1663,5929
2021,Wandsworth 008,E02000930,9609,1535,8074
2021,Wandsworth 009,E02000931,8194,1457,6737
2021,Wandsworth 010,E02000932,12179,1590,10589
2021,Wandsworth 011,E02000933,8460,1399,7061
2021,Wandsworth 012,E02000934,8511,989,7522
2021,Wandsworth 013,E02000935,6905,2726,4179
2021,Wandsworth 014,E02000936,8956,1275,7681
2021,Wandsworth 015,E02000937,7623,1648,5975
2021,Wandsworth 016,E02000938,10076,2225,7851
2021,Wandsworth 017,E02000939,7272,1636,5636
2021,Wandsworth 018,E02000940,8839,1438,7401
2021,Wandsworth 019,E02000941,9438,1624,7814
2021,Wandsworth 020,E02000942,9091,1690,7401
2021,Wandsworth 021,E02000943,8265,1172,7093
2021,Wandsworth 022,E02000944,7166,1593,5573
2021,Wandsworth 023,E02000945,7395,2102,5293
2021,Wandsworth 024,E02000946,7938,1247,6691
2021,Wandsworth 025,E02000947,8539,1415,7124
2021,Wandsworth 026,E02000948,9515,1184,8331
2021,Wandsworth 027,E02000949,9492,1414,8078
2021,Wandsworth 028,E02000950,7176,1461,5715
2021,Wandsworth 029,E02000951,6133,861,5272
2021,Wandsworth 030,E02000952,5829,857,4972
2021,Wandsworth 031,E02000953,6942,1335,5607
2021,Wandsworth 032,E02000954,5749,997,4752
2021,Wandsworth 033,E02000955,6536,1263,5273
2021,Wandsworth 034,E02000956,7060,1560,5500
2021,Wandsworth 035,E02000957,10235,1878,8357
2021,Wandsworth 036,E02000958,7856,1948,5908
2021,Wandsworth 037,E02000959,7345,1493,5852
2021,Westminster 001,E02000960,5892,1238,4654
2021,Westminster 002,E02000961,9265,2081,7184
2021,Westminster 003,E02000962,7385,1520,5865
2021,Westminster 004,E02000963,9961,2258,7703
2021,Westminster 005,E02000964,11566,2287,9279
2021,Westminster 006,E02000965,7466,1224,6242
2021,Westminster 007,E02000966,8824,1486,7338
2021,Westminster 008,E02000967,5836,1423,4413
2021,Westminster 009,E02000968,13763,3482,10281
2021,Westminster 010,E02000969,9150,2337,6813
2021,Westminster 011,E02000970,6593,1145,5448
2021,Westminster 012,E02000971,7219,1602,5617
2021,Westminster 013,E02000972,7700,1876,5824
2021,Westminster 014,E02000973,9498,1507,7991
2021,Westminster 015,E02000974,8328,2107,6221
2021,Westminster 016,E02000975,7138,1398,5740
2021,Westminster 017,E02000976,8100,1650,6450
2021,Westminster 018,E02000977,6215,1275,4940
2021,Westminster 019,E02000978,6847,1951,4896
2021,Westminster 020,E02000979,7803,1637,6166
2021,Westminster 021,E02000980,8426,1612,6814
2021,Westminster 022,E02000981,8052,1147,6905
2021,Westminster 023,E02000982,7335,1501,5834
2021,Westminster 024,E02000983,7378,1443,5935
2021,Bolton 001,E02000984,7324,1302,6022
2021,Bolton 002,E02000985,7139,1264,5875
2021,Bolton 003,E02000986,7988,1506,6482
2021,Bolton 004,E02000987,6987,1151,5836
2021,Bolton 005,E02000988,8489,1954,6535
2021,Bolton 006,E02000989,8019,1258,6761
2021,Bolton 007,E02000990,7953,1358,6595
2021,Bolton 008,E02000991,7281,1409,5872
2021,Bolton 009,E02000992,5999,1024,4975
2021,Bolton 010,E02000993,7772,1989,5783
2021,Bolton 011,E02000994,8318,2360,5958
2021,Bolton 012,E02000995,7868,1763,6105
2021,Bolton 013,E02000996,8017,2143,5874
2021,Bolton 014,E02000997,6150,1111,5039
2021,Bolton 015,E02000998,9496,2536,6960
2021,Bolton 016,E02000999,7959,2050,5909
2021,Bolton 017,E02001000,8618,1620,6998
2021,Bolton 018,E02001001,8209,2136,6073
2021,Bolton 019,E02001002,9181,1996,7185
2021,Bolton 020,E02001003,7046,1475,5571
2021,Bolton 021,E02001004,8579,2715,5864
2021,Bolton 022,E02001005,8981,2532,6449
2021,Bolton 023,E02001006,7815,2266,5549
2021,Bolton 024,E02001007,9656,1684,7972
2021,Bolton 025,E02001008,8440,2888,5552
2021,Bolton 026,E02001009,6941,1685,5256
2021,Bolton 027,E02001010,6016,1480,4536
2021,Bolton 028,E02001011,9264,1561,7703
2021,Bolton 029,E02001012,8951,2660,6291
2021,Bolton 030,E02001013,5803,1083,4720
2021,Bolton 031,E02001014,8049,1480,6569
2021,Bolton 032,E02001015,7699,1316,6383
2021,Bolton 033,E02001016,8075,2129,5946
2021,Bolton 034,E02001017,10176,1938,8238
2021,Bolton 035,E02001018,7247,1347,5900
2021,Bury 001,E02001019,8631,1704,6927
2021,Bury 002,E02001020,5721,1006,4715
2021,Bury 003,E02001021,7190,1198,5992
2021,Bury 004,E02001022,7671,1447,6224
2021,Bury 005,E02001023,5410,1102,4308
2021,Bury 006,E02001024,7668,1437,6231
2021,Bury 007,E02001025,7608,1756,5852
2021,Bury 008,E02001026,10447,2574,7873
2021,Bury 009,E02001027,6812,1373,5439
2021,Bury 010,E02001028,7058,1196,5862
2021,Bury 011,E02001029,7239,1754,5485
2021,Bury 012,E02001030,5891,1069,4822
2021,Bury 013,E02001031,6496,1403,5093
2021,Bury 014,E02001032,7254,1352,5902
2021,Bury 015,E02001033,5734,1178,4556
2021,Bury 016,E02001034,8072,1678,6394
2021,Bury 017,E02001035,6902,1282,5620
2021,Bury 018,E02001036,7034,1541,5493
2021,Bury 019,E02001037,6869,1190,5679
2021,Bury 020,E02001038,5399,939,4460
2021,Bury 021,E02001039,8052,1968,6084
2021,Bury 022,E02001040,6035,1029,5006
2021,Bury 023,E02001041,7310,1344,5966
2021,Bury 024,E02001042,6173,1190,4983
2021,Bury 025,E02001043,5319,994,4325
2021,Bury 026,E02001044,8699,2928,5771
2021,Manchester 001,E02001045,7879,1943,5936
2021,Manchester 002,E02001046,10415,2715,7700
2021,Manchester 003,E02001047,9794,2374,7420
2021,Manchester 004,E02001048,8680,2329,6351
2021,Manchester 005,E02001049,9887,2331,7556
2021,Manchester 006,E02001050,7711,2319,5392
2021,Manchester 007,E02001051,8579,2542,6037
2021,Manchester 008,E02001052,13682,4553,9129
2021,Manchester 009,E02001053,10841,3428,7413
2021,Manchester 011,E02001055,8975,2353,6622
2021,Manchester 012,E02001056,8292,2634,5658
2021,Manchester 015,E02001059,10907,3076,7831
2021,Manchester 017,E02001061,10119,2896,7223
2021,Manchester 018,E02001062,9481,3854,5627
2021,Manchester 019,E02001063,10583,5716,4867
2021,Manchester 020,E02001064,9852,2959,6893
2021,Manchester 021,E02001065,8685,2261,6424
2021,Manchester 022,E02001066,10972,5249,5723
2021,Manchester 023,E02001067,10603,3484,7119
2021,Manchester 024,E02001068,10994,4095,6899
2021,Manchester 025,E02001069,11582,5013,6569
2021,Manchester 026,E02001070,11577,6162,5415
2021,Manchester 028,E02001072,8386,1708,6678
2021,Manchester 029,E02001073,8897,1515,7382
2021,Manchester 030,E02001074,11100,3098,8002
2021,Manchester 031,E02001075,8434,2243,6191
2021,Manchester 032,E02001076,10967,7469,3498
2021,Manchester 033,E02001077,7010,1326,5684
2021,Manchester 034,E02001078,10024,2639,7385
2021,Manchester 035,E02001079,8997,3184,5813
2021,Manchester 036,E02001080,9419,4931,4488
2021,Manchester 037,E02001081,5962,1118,4844
2021,Manchester 038,E02001082,6404,1558,4846
2021,Manchester 039,E02001083,7818,1230,6588
2021,Manchester 040,E02001084,8192,2552,5640
2021,Manchester 041,E02001085,8367,2442,5925
2021,Manchester 042,E02001086,6560,1374,5186
2021,Manchester 043,E02001087,8814,1540,7274
2021,Manchester 044,E02001088,8472,1986,6486
2021,Manchester 045,E02001089,7550,1513,6037
2021,Manchester 046,E02001090,6543,1057,5486
2021,Manchester 047,E02001091,7864,1399,6465
2021,Manchester 048,E02001092,8570,2019,6551
2021,Manchester 049,E02001093,9092,2244,6848
2021,Manchester 050,E02001094,9157,2578,6579
2021,Manchester 051,E02001095,8431,1911,6520
2021,Manchester 052,E02001096,7540,1533,6007
2021,Manchester 053,E02001097,7972,1775,6197
2021,Oldham 001,E02001098,5707,956,4751
2021,Oldham 002,E02001099,5370,908,4462
2021,Oldham 003,E02001100,5745,1013,4732
2021,Oldham 004,E02001101,5419,931,4488
2021,Oldham 005,E02001102,5708,1118,4590
2021,Oldham 006,E02001103,5297,900,4397
2021,Oldham 007,E02001104,6820,1482,5338
2021,Oldham 008,E02001105,5684,977,4707
2021,Oldham 009,E02001106,5701,983,4718
2021,Oldham 010,E02001107,6441,1700,4741
2021,Oldham 011,E02001108,5451,1420,4031
2021,Oldham 012,E02001109,7172,1488,5684
2021,Oldham 013,E02001110,6181,977,5204
2021,Oldham 014,E02001111,8421,2820,5601
2021,Oldham 015,E02001112,5751,1001,4750
2021,Oldham 016,E02001113,8695,3055,5640
2021,Oldham 017,E02001114,8307,2010,6297
2021,Oldham 018,E02001115,5614,1021,4593
2021,Oldham 019,E02001116,7132,2339,4793
2021,Oldham 020,E02001117,5772,1031,4741
2021,Oldham 021,E02001118,5791,989,4802
2021,Oldham 022,E02001119,11223,3708,7515
2021,Oldham 024,E02001121,7879,2767,5112
2021,Oldham 026,E02001123,6479,1727,4752
2021,Oldham 027,E02001124,6377,1609,4768
2021,Oldham 028,E02001125,7484,1463,6021
2021,Oldham 029,E02001126,8355,2266,6089
2021,Oldham 030,E02001127,7200,1888,5312
2021,Oldham 031,E02001128,7022,1381,5641
2021,Oldham 032,E02001129,6358,1227,5131
2021,Oldham 033,E02001130,5561,898,4663
2021,Oldham 034,E02001131,5161,996,4165
2021,Rochdale 001,E02001132,6279,1097,5182
2021,Rochdale 002,E02001133,6265,1260,5005
2021,Rochdale 003,E02001134,6025,1019,5006
2021,Rochdale 004,E02001135,7757,2199,5558
2021,Rochdale 005,E02001136,9020,1756,7264
2021,Rochdale 006,E02001137,5901,1012,4889
2021,Rochdale 007,E02001138,8245,1443,6802
2021,Rochdale 008,E02001139,9462,2833,6629
2021,Rochdale 009,E02001140,7536,1911,5625
2021,Rochdale 010,E02001141,11085,3037,8048
2021,Rochdale 011,E02001142,5735,1019,4716
2021,Rochdale 012,E02001143,10751,3135,7616
2021,Rochdale 013,E02001144,6008,1077,4931
2021,Rochdale 014,E02001145,6702,1250,5452
2021,Rochdale 015,E02001146,9493,2855,6638
2021,Rochdale 016,E02001147,9601,2410,7191
2021,Rochdale 017,E02001148,9775,1925,7850
2021,Rochdale 018,E02001149,9596,1885,7711
2021,Rochdale 019,E02001150,8305,1851,6454
2021,Rochdale 020,E02001151,9489,1836,7653
2021,Rochdale 021,E02001152,9117,1933,7184
2021,Rochdale 022,E02001153,11326,2881,8445
2021,Rochdale 023,E02001154,9490,1875,7615
2021,Rochdale 024,E02001155,6769,1188,5581
2021,Rochdale 025,E02001156,9401,1819,7582
2021,Salford 001,E02001157,8036,2305,5731
2021,Salford 002,E02001158,5652,1189,4463
2021,Salford 003,E02001159,6938,1407,5531
2021,Salford 004,E02001160,6674,1655,5019
2021,Salford 005,E02001161,5557,959,4598
2021,Salford 006,E02001162,5510,950,4560
2021,Salford 007,E02001163,9295,1532,7763
2021,Salford 008,E02001164,7156,1431,5725
2021,Salford 009,E02001165,5812,1172,4640
2021,Salford 010,E02001166,7357,2572,4785
2021,Salford 011,E02001167,6447,1609,4838
2021,Salford 012,E02001168,9218,1816,7402
2021,Salford 013,E02001169,10295,1884,8411
2021,Salford 014,E02001170,9291,1719,7572
2021,Salford 015,E02001171,5841,1002,4839
2021,Salford 017,E02001173,8941,3528,5413
2021,Salford 018,E02001174,5431,1016,4415
2021,Salford 019,E02001175,7060,1492,5568
2021,Salford 020,E02001176,11157,1835,9322
2021,Salford 021,E02001177,12541,2594,9947
2021,Salford 023,E02001179,6631,1549,5082
2021,Salford 024,E02001180,5207,1536,3671
2021,Salford 025,E02001181,5598,1231,4367
2021,Salford 026,E02001182,6764,1339,5425
2021,Salford 027,E02001183,6760,1215,5545
2021,Salford 029,E02001185,9166,1806,7360
2021,Salford 030,E02001186,9846,1991,7855
2021,Stockport 001,E02001187,6609,1180,5429
2021,Stockport 002,E02001188,8071,1696,6375
2021,Stockport 003,E02001189,7822,1343,6479
2021,Stockport 004,E02001190,7322,1674,5648
2021,Stockport 005,E02001191,5474,798,4676
2021,Stockport 006,E02001192,6221,1068,5153
2021,Stockport 007,E02001193,6017,1009,5008
2021,Stockport 008,E02001194,6042,1209,4833
2021,Stockport 009,E02001195,7062,1136,5926
2021,Stockport 010,E02001196,7453,1233,6220
2021,Stockport 011,E02001197,5938,1241,4697
2021,Stockport 012,E02001198,7106,1286,5820
2021,Stockport 013,E02001199,7449,1375,6074
2021,Stockport 014,E02001200,7369,1309,6060
2021,Stockport 015,E02001201,5437,1022,4415
2021,Stockport 016,E02001202,6019,973,5046
2021,Stockport 017,E02001203,5579,936,4643
2021,Stockport 018,E02001204,8365,1555,6810
2021,Stockport 019,E02001205,7859,1299,6560
2021,Stockport 020,E02001206,6887,1222,5665
2021,Stockport 021,E02001207,6504,1089,5415
2021,Stockport 022,E02001208,7125,1241,5884
2021,Stockport 023,E02001209,7263,1368,5895
2021,Stockport 024,E02001210,7014,1590,5424
2021,Stockport 025,E02001211,6216,1275,4941
2021,Stockport 026,E02001212,6506,1662,4844
2021,Stockport 027,E02001213,9343,1705,7638
2021,Stockport 028,E02001214,7635,1547,6088
2021,Stockport 029,E02001215,5708,948,4760
2021,Stockport 030,E02001216,7462,1491,5971
2021,Stockport 031,E02001217,6364,1090,5274
2021,Stockport 032,E02001218,5724,1156,4568
2021,Stockport 033,E02001219,5033,836,4197
2021,Stockport 034,E02001220,5389,1090,4299
2021,Stockport 035,E02001221,5623,984,4639
2021,Stockport 036,E02001222,6152,1230,4922
2021,Stockport 037,E02001223,6357,1117,5240
2021,Stockport 038,E02001224,5623,792,4831
2021,Stockport 039,E02001225,7044,1430,5614
2021,Stockport 040,E02001226,6713,1405,5308
2021,Stockport 041,E02001227,5393,1012,4381
2021,Stockport 042,E02001228,5910,1035,4875
2021,Tameside 001,E02001229,9735,1759,7976
2021,Tameside 002,E02001230,5600,998,4602
2021,Tameside 003,E02001231,6690,1437,5253
2021,Tameside 004,E02001232,8066,1778,6288
2021,Tameside 005,E02001233,7550,1576,5974
2021,Tameside 006,E02001234,7406,1707,5699
2021,Tameside 007,E02001235,6679,1213,5466
2021,Tameside 008,E02001236,5641,1237,4404
2021,Tameside 009,E02001237,6822,1460,5362
2021,Tameside 010,E02001238,7597,1386,6211
2021,Tameside 011,E02001239,8980,1826,7154
2021,Tameside 012,E02001240,6047,1190,4857
2021,Tameside 013,E02001241,10346,2626,7720
2021,Tameside 014,E02001242,6633,1245,5388
2021,Tameside 015,E02001243,7850,1247,6603
2021,Tameside 016,E02001244,5183,896,4287
2021,Tameside 017,E02001245,7534,1358,6176
2021,Tameside 018,E02001246,7053,1425,5628
2021,Tameside 019,E02001247,6997,1325,5672
2021,Tameside 020,E02001248,11128,2363,8765
2021,Tameside 021,E02001249,6003,1097,4906
2021,Tameside 022,E02001250,6188,1010,5178
2021,Tameside 023,E02001251,5789,886,4903
2021,Tameside 024,E02001252,7201,1225,5976
2021,Tameside 025,E02001253,4790,842,3948
2021,Tameside 026,E02001254,5315,915,4400
2021,Tameside 027,E02001255,7032,1639,5393
2021,Tameside 028,E02001256,9812,2313,7499
2021,Tameside 029,E02001257,8655,1507,7148
2021,Tameside 030,E02001258,7080,1232,5848
2021,Trafford 001,E02001259,10954,2968,7986
2021,Trafford 002,E02001260,7146,1349,5797
2021,Trafford 003,E02001261,8324,1904,6420
2021,Trafford 004,E02001262,8145,1918,6227
2021,Trafford 005,E02001263,7963,1432,6531
2021,Trafford 006,E02001264,8124,1833,6291
2021,Trafford 007,E02001265,7734,1482,6252
2021,Trafford 008,E02001266,6492,1264,5228
2021,Trafford 009,E02001267,6864,1097,5767
2021,Trafford 010,E02001268,6679,1150,5529
2021,Trafford 011,E02001269,7912,1680,6232
2021,Trafford 012,E02001270,7957,1558,6399
2021,Trafford 013,E02001271,6269,1333,4936
2021,Trafford 014,E02001272,7548,1487,6061
2021,Trafford 015,E02001273,8975,1759,7216
2021,Trafford 016,E02001274,7719,1594,6125
2021,Trafford 017,E02001275,7640,1816,5824
2021,Trafford 018,E02001276,7582,1697,5885
2021,Trafford 019,E02001277,8755,2135,6620
2021,Trafford 020,E02001278,8195,1849,6346
2021,Trafford 021,E02001279,7843,1686,6157
2021,Trafford 022,E02001280,7996,1830,6166
2021,Trafford 023,E02001281,7359,1550,5809
2021,Trafford 024,E02001282,9429,2052,7377
2021,Trafford 025,E02001283,9036,1775,7261
2021,Trafford 026,E02001284,7638,1805,5833
2021,Trafford 027,E02001285,7460,1569,5891
2021,Trafford 028,E02001286,7849,1850,5999
2021,Wigan 001,E02001287,6242,1054,5188
2021,Wigan 002,E02001288,7931,1319,6612
2021,Wigan 003,E02001289,9694,1605,8089
2021,Wigan 004,E02001290,5862,1003,4859
2021,Wigan 005,E02001291,7386,1417,5969
2021,Wigan 006,E02001292,7629,1192,6437
2021,Wigan 007,E02001293,5959,1003,4956
2021,Wigan 008,E02001294,7546,1271,6275
2021,Wigan 009,E02001295,6844,1208,5636
2021,Wigan 010,E02001296,8329,2129,6200
2021,Wigan 011,E02001297,6262,1139,5123
2021,Wigan 012,E02001298,7625,1682,5943
2021,Wigan 013,E02001299,8262,1438,6824
2021,Wigan 014,E02001300,7470,1306,6164
2021,Wigan 015,E02001301,8447,1581,6866
2021,Wigan 016,E02001302,7542,1479,6063
2021,Wigan 017,E02001303,8430,1838,6592
2021,Wigan 018,E02001304,12166,2174,9992
2021,Wigan 019,E02001305,8094,1327,6767
2021,Wigan 020,E02001306,6832,1102,5730
2021,Wigan 021,E02001307,11081,2071,9010
2021,Wigan 022,E02001308,5696,913,4783
2021,Wigan 023,E02001309,7918,1365,6553
2021,Wigan 024,E02001310,8617,1790,6827
2021,Wigan 025,E02001311,7752,1337,6415
2021,Wigan 026,E02001312,8151,1515,6636
2021,Wigan 027,E02001313,7694,1611,6083
2021,Wigan 028,E02001314,7559,1573,5986
2021,Wigan 029,E02001315,8867,1533,7334
2021,Wigan 030,E02001316,6858,1259,5599
2021,Wigan 031,E02001317,8516,1489,7027
2021,Wigan 032,E02001318,7486,1362,6124
2021,Wigan 033,E02001319,7765,1341,6424
2021,Wigan 034,E02001320,6993,1188,5805
2021,Wigan 035,E02001321,7636,1396,6240
2021,Wigan 036,E02001322,6913,1096,5817
2021,Wigan 037,E02001323,7346,1314,6032
2021,Wigan 038,E02001324,7844,1525,6319
2021,Wigan 039,E02001325,8536,1445,7091
2021,Wigan 040,E02001326,7771,1400,6371
2021,Knowsley 001,E02001327,8635,2147,6488
2021,Knowsley 002,E02001328,9872,1759,8113
2021,Knowsley 003,E02001329,6987,1322,5665
2021,Knowsley 004,E02001330,8483,1658,6825
2021,Knowsley 005,E02001331,9534,1863,7671
2021,Knowsley 006,E02001332,7045,1462,5583
2021,Knowsley 007,E02001333,8844,1541,7303
2021,Knowsley 008,E02001334,6103,1376,4727
2021,Knowsley 009,E02001335,7779,1403,6376
2021,Knowsley 010,E02001336,6440,1335,5105
2021,Knowsley 011,E02001337,5520,1072,4448
2021,Knowsley 012,E02001338,5720,1073,4647
2021,Knowsley 013,E02001339,6020,1292,4728
2021,Knowsley 014,E02001340,9111,1554,7557
2021,Knowsley 015,E02001341,7032,1354,5678
2021,Knowsley 016,E02001342,7446,1105,6341
2021,Knowsley 017,E02001343,6886,1126,5760
2021,Knowsley 018,E02001344,5213,870,4343
2021,Knowsley 019,E02001345,5124,796,4328
2021,Knowsley 020,E02001346,6984,1390,5594
2021,Liverpool 001,E02001347,7531,1487,6044
2021,Liverpool 002,E02001348,6336,1160,5176
2021,Liverpool 003,E02001349,7709,1302,6407
2021,Liverpool 004,E02001350,7588,1632,5956
2021,Liverpool 005,E02001351,8450,1689,6761
2021,Liverpool 006,E02001352,6040,1230,4810
2021,Liverpool 007,E02001353,6870,1317,5553
2021,Liverpool 008,E02001354,7403,1530,5873
2021,Liverpool 009,E02001355,5971,1140,4831
2021,Liverpool 010,E02001356,8279,2211,6068
2021,Liverpool 011,E02001357,6795,1646,5149
2021,Liverpool 012,E02001358,6528,1333,5195
2021,Liverpool 013,E02001359,5265,920,4345
2021,Liverpool 014,E02001360,8220,1706,6514
2021,Liverpool 015,E02001361,6870,1256,5614
2021,Liverpool 016,E02001362,7198,1400,5798
2021,Liverpool 017,E02001363,7371,1655,5716
2021,Liverpool 018,E02001364,5783,1237,4546
2021,Liverpool 019,E02001365,8613,1868,6745
2021,Liverpool 020,E02001366,8267,1561,6706
2021,Liverpool 021,E02001367,9236,1709,7527
2021,Liverpool 022,E02001368,6763,1371,5392
2021,Liverpool 023,E02001369,7633,1814,5819
2021,Liverpool 024,E02001370,6654,1573,5081
2021,Liverpool 025,E02001371,7133,1643,5490
2021,Liverpool 026,E02001372,5757,992,4765
2021,Liverpool 027,E02001373,8432,1710,6722
2021,Liverpool 028,E02001374,8113,1874,6239
2021,Liverpool 029,E02001375,6537,1308,5229
2021,Liverpool 030,E02001376,8767,3316,5451
2021,Liverpool 031,E02001377,12069,7235,4834
2021,Liverpool 032,E02001378,6994,1229,5765
2021,Liverpool 034,E02001380,7115,1293,5822
2021,Liverpool 035,E02001381,9182,2805,6377
2021,Liverpool 036,E02001382,6498,1200,5298
2021,Liverpool 037,E02001383,9268,4014,5254
2021,Liverpool 038,E02001384,10460,5955,4505
2021,Liverpool 039,E02001385,8364,2915,5449
2021,Liverpool 040,E02001386,7744,1394,6350
2021,Liverpool 041,E02001387,7509,1611,5898
2021,Liverpool 042,E02001388,7880,2931,4949
2021,Liverpool 043,E02001389,6238,1144,5094
2021,Liverpool 044,E02001390,9070,2134,6936
2021,Liverpool 045,E02001391,5615,1176,4439
2021,Liverpool 046,E02001392,5982,947,5035
2021,Liverpool 047,E02001393,7182,1647,5535
2021,Liverpool 048,E02001394,8330,1698,6632
2021,Liverpool 049,E02001395,5596,1031,4565
2021,Liverpool 050,E02001396,7248,1175,6073
2021,Liverpool 051,E02001397,6824,944,5880
2021,Liverpool 052,E02001398,7147,1354,5793
2021,Liverpool 053,E02001399,6611,1201,5410
2021,Liverpool 054,E02001400,6463,1134,5329
2021,Liverpool 055,E02001401,7512,1284,6228
2021,Liverpool 056,E02001402,8579,1661,6918
2021,Liverpool 057,E02001403,6018,1224,4794
2021,Liverpool 058,E02001404,7336,1532,5804
2021,Liverpool 059,E02001405,9135,2103,7032
2021,St. Helens 001,E02001406,7574,1175,6399
2021,St. Helens 002,E02001407,5658,809,4849
2021,St. Helens 003,E02001408,5226,791,4435
2021,St. Helens 004,E02001409,9746,1659,8087
2021,St. Helens 005,E02001410,5455,989,4466
2021,St. Helens 006,E02001411,5524,866,4658
2021,St. Helens 007,E02001412,8593,1640,6953
2021,St. Helens 008,E02001413,8847,1444,7403
2021,St. Helens 009,E02001414,5304,926,4378
2021,St. Helens 010,E02001415,6563,1398,5165
2021,St. Helens 011,E02001416,5981,1219,4762
2021,St. Helens 012,E02001417,6960,1101,5859
2021,St. Helens 013,E02001418,6108,990,5118
2021,St. Helens 014,E02001419,7128,1236,5892
2021,St. Helens 015,E02001420,11103,2046,9057
2021,St. Helens 016,E02001421,9983,1633,8350
2021,St. Helens 017,E02001422,6242,1313,4929
2021,St. Helens 018,E02001423,6279,1011,5268
2021,St. Helens 020,E02001425,10145,1654,8491
2021,St. Helens 021,E02001426,5190,843,4347
2021,St. Helens 022,E02001427,10261,2052,8209
2021,St. Helens 023,E02001428,5360,826,4534
2021,Sefton 001,E02001429,6399,943,5456
2021,Sefton 002,E02001430,6595,1054,5541
2021,Sefton 003,E02001431,7251,806,6445
2021,Sefton 004,E02001432,9176,1010,8166
2021,Sefton 005,E02001433,7010,1471,5539
2021,Sefton 006,E02001434,6983,1440,5543
2021,Sefton 007,E02001435,8367,1609,6758
2021,Sefton 008,E02001436,9163,1857,7306
2021,Sefton 009,E02001437,9012,1169,7843
2021,Sefton 010,E02001438,6864,1341,5523
2021,Sefton 011,E02001439,6294,1243,5051
2021,Sefton 012,E02001440,5845,863,4982
2021,Sefton 013,E02001441,6147,996,5151
2021,Sefton 014,E02001442,5814,954,4860
2021,Sefton 015,E02001443,5446,951,4495
2021,Sefton 016,E02001444,5359,931,4428
2021,Sefton 017,E02001445,6570,1025,5545
2021,Sefton 018,E02001446,6926,1080,5846
2021,Sefton 019,E02001447,5822,883,4939
2021,Sefton 020,E02001448,6453,1050,5403
2021,Sefton 021,E02001449,8875,1418,7457
2021,Sefton 022,E02001450,8064,1324,6740
2021,Sefton 023,E02001451,5651,1096,4555
2021,Sefton 024,E02001452,5939,1097,4842
2021,Sefton 025,E02001453,8336,1484,6852
2021,Sefton 026,E02001454,6931,1267,5664
2021,Sefton 027,E02001455,6743,1117,5626
2021,Sefton 028,E02001456,7036,1146,5890
2021,Sefton 029,E02001457,6422,1235,5187
2021,Sefton 030,E02001458,7247,1266,5981
2021,Sefton 031,E02001459,6492,1276,5216
2021,Sefton 032,E02001460,7557,1262,6295
2021,Sefton 033,E02001461,6526,1127,5399
2021,Sefton 034,E02001462,7097,1400,5697
2021,Sefton 035,E02001463,7004,1467,5537
2021,Sefton 036,E02001464,6578,1351,5227
2021,Sefton 037,E02001465,7251,1188,6063
2021,Sefton 038,E02001466,8481,1698,6783
2021,Wirral 001,E02001467,7295,995,6300
2021,Wirral 002,E02001468,7229,1278,5951
2021,Wirral 003,E02001469,7310,1216,6094
2021,Wirral 004,E02001470,7902,1471,6431
2021,Wirral 005,E02001471,6939,1538,5401
2021,Wirral 006,E02001472,6654,1363,5291
2021,Wirral 007,E02001473,7200,1313,5887
2021,Wirral 008,E02001474,6451,1567,4884
2021,Wirral 009,E02001475,6010,1410,4600
2021,Wirral 010,E02001476,7384,1627,5757
2021,Wirral 011,E02001477,7071,1752,5319
2021,Wirral 012,E02001478,7788,1391,6397
2021,Wirral 013,E02001479,5734,980,4754
2021,Wirral 014,E02001480,7312,1223,6089
2021,Wirral 015,E02001481,7737,1392,6345
2021,Wirral 016,E02001482,7575,1313,6262
2021,Wirral 017,E02001483,6866,1078,5788
2021,Wirral 018,E02001484,7659,1295,6364
2021,Wirral 019,E02001485,6405,1505,4900
2021,Wirral 020,E02001486,7712,940,6772
2021,Wirral 021,E02001487,8679,1917,6762
2021,Wirral 022,E02001488,7918,1532,6386
2021,Wirral 023,E02001489,7762,1194,6568
2021,Wirral 024,E02001490,7839,1390,6449
2021,Wirral 025,E02001491,6344,1338,5006
2021,Wirral 026,E02001492,7250,1310,5940
2021,Wirral 027,E02001493,8341,1842,6499
2021,Wirral 028,E02001494,6750,1192,5558
2021,Wirral 029,E02001495,7579,1521,6058
2021,Wirral 030,E02001496,5802,1069,4733
2021,Wirral 031,E02001497,7653,1588,6065
2021,Wirral 032,E02001498,6910,1362,5548
2021,Wirral 033,E02001499,6338,1038,5300
2021,Wirral 034,E02001500,6987,1142,5845
2021,Wirral 035,E02001501,7359,1388,5971
2021,Wirral 036,E02001502,9142,1600,7542
2021,Wirral 037,E02001503,7239,1189,6050
2021,Wirral 038,E02001504,6700,997,5703
2021,Wirral 039,E02001505,6155,1111,5044
2021,Wirral 040,E02001506,8525,1362,7163
2021,Wirral 041,E02001507,6694,1128,5566
2021,Wirral 042,E02001508,7685,1486,6199
2021,Barnsley 001,E02001509,6585,1202,5383
2021,Barnsley 002,E02001510,5592,1005,4587
2021,Barnsley 003,E02001511,5817,955,4862
2021,Barnsley 004,E02001512,8066,1270,6796
2021,Barnsley 005,E02001513,7253,1169,6084
2021,Barnsley 006,E02001514,7214,1367,5847
2021,Barnsley 007,E02001515,9032,1961,7071
2021,Barnsley 008,E02001516,5908,1163,4745
2021,Barnsley 009,E02001517,7621,1221,6400
2021,Barnsley 010,E02001518,9670,1667,8003
2021,Barnsley 011,E02001519,7417,1459,5958
2021,Barnsley 012,E02001520,11130,1746,9384
2021,Barnsley 013,E02001521,11392,1846,9546
2021,Barnsley 014,E02001522,8864,1649,7215
2021,Barnsley 015,E02001523,6431,976,5455
2021,Barnsley 016,E02001524,5891,916,4975
2021,Barnsley 017,E02001525,6390,1097,5293
2021,Barnsley 018,E02001526,5812,1294,4518
2021,Barnsley 019,E02001527,5725,928,4797
2021,Barnsley 020,E02001528,10113,1742,8371
2021,Barnsley 021,E02001529,8962,1565,7397
2021,Barnsley 022,E02001530,6675,1231,5444
2021,Barnsley 023,E02001531,7235,1108,6127
2021,Barnsley 024,E02001532,9997,1939,8058
2021,Barnsley 025,E02001533,7300,1381,5919
2021,Barnsley 026,E02001534,9036,1651,7385
2021,Barnsley 027,E02001535,6243,1047,5196
2021,Barnsley 028,E02001536,8234,1237,6997
2021,Barnsley 029,E02001537,7983,1389,6594
2021,Barnsley 030,E02001538,7520,1358,6162
2021,Doncaster 001,E02001539,6270,1388,4882
2021,Doncaster 002,E02001540,11347,2152,9195
2021,Doncaster 003,E02001541,10835,1745,9090
2021,Doncaster 004,E02001542,6981,1406,5575
2021,Doncaster 005,E02001543,7375,1323,6052
2021,Doncaster 006,E02001544,7876,1597,6279
2021,Doncaster 007,E02001545,8085,1269,6816
2021,Doncaster 008,E02001546,8550,978,7572
2021,Doncaster 009,E02001547,10210,2106,8104
2021,Doncaster 010,E02001548,7360,1429,5931
2021,Doncaster 011,E02001549,5960,1069,4891
2021,Doncaster 012,E02001550,7335,1383,5952
2021,Doncaster 013,E02001551,5582,942,4640
2021,Doncaster 014,E02001552,7198,1407,5791
2021,Doncaster 015,E02001553,9555,1849,7706
2021,Doncaster 016,E02001554,5759,970,4789
2021,Doncaster 017,E02001555,5021,636,4385
2021,Doncaster 018,E02001556,8617,1821,6796
2021,Doncaster 019,E02001557,9591,1612,7979
2021,Doncaster 020,E02001558,5766,776,4990
2021,Doncaster 021,E02001559,7208,1191,6017
2021,Doncaster 022,E02001560,11066,2017,9049
2021,Doncaster 023,E02001561,5849,1087,4762
2021,Doncaster 024,E02001562,5511,1024,4487
2021,Doncaster 025,E02001563,7699,1324,6375
2021,Doncaster 026,E02001564,7845,1311,6534
2021,Doncaster 027,E02001565,7438,1179,6259
2021,Doncaster 028,E02001566,8021,1611,6410
2021,Doncaster 029,E02001567,8171,1613,6558
2021,Doncaster 030,E02001568,6356,1109,5247
2021,Doncaster 031,E02001569,8107,1444,6663
2021,Doncaster 032,E02001570,6585,1213,5372
2021,Doncaster 033,E02001571,5642,892,4750
2021,Doncaster 034,E02001572,7296,1340,5956
2021,Doncaster 035,E02001573,7224,1408,5816
2021,Doncaster 036,E02001574,5746,941,4805
2021,Doncaster 037,E02001575,7350,1490,5860
2021,Doncaster 038,E02001576,6573,1222,5351
2021,Doncaster 039,E02001577,6209,795,5414
2021,Rotherham 001,E02001578,10992,2365,8627
2021,Rotherham 002,E02001579,9461,1825,7636
2021,Rotherham 003,E02001580,8103,1281,6822
2021,Rotherham 004,E02001581,5888,1049,4839
2021,Rotherham 005,E02001582,7309,1343,5966
2021,Rotherham 006,E02001583,5239,1020,4219
2021,Rotherham 007,E02001584,6432,946,5486
2021,Rotherham 008,E02001585,5907,1091,4816
2021,Rotherham 009,E02001586,7436,995,6441
2021,Rotherham 010,E02001587,5482,889,4593
2021,Rotherham 011,E02001588,6788,1418,5370
2021,Rotherham 012,E02001589,7625,1415,6210
2021,Rotherham 013,E02001590,6985,1711,5274
2021,Rotherham 014,E02001591,7690,1835,5855
2021,Rotherham 015,E02001592,8137,1330,6807
2021,Rotherham 016,E02001593,6703,1556,5147
2021,Rotherham 017,E02001594,6885,1553,5332
2021,Rotherham 018,E02001595,7904,1203,6701
2021,Rotherham 019,E02001596,7942,1348,6594
2021,Rotherham 020,E02001597,8877,1747,7130
2021,Rotherham 021,E02001598,9118,1706,7412
2021,Rotherham 023,E02001600,10499,2288,8211
2021,Rotherham 025,E02001602,8533,1408,7125
2021,Rotherham 026,E02001603,6989,1264,5725
2021,Rotherham 027,E02001604,10921,2122,8799
2021,Rotherham 028,E02001605,7100,1146,5954
2021,Rotherham 029,E02001606,7619,1429,6190
2021,Rotherham 030,E02001607,8429,1577,6852
2021,Rotherham 031,E02001608,6693,1229,5464
2021,Rotherham 032,E02001609,8169,1347,6822
2021,Rotherham 033,E02001610,8263,1432,6831
2021,Sheffield 001,E02001611,7291,1208,6083
2021,Sheffield 002,E02001612,5380,863,4517
2021,Sheffield 003,E02001613,9685,1638,8047
2021,Sheffield 004,E02001614,10584,1665,8919
2021,Sheffield 005,E02001615,6901,916,5985
2021,Sheffield 006,E02001616,6917,1232,5685
2021,Sheffield 007,E02001617,5447,1407,4040
2021,Sheffield 008,E02001618,9347,1851,7496
2021,Sheffield 009,E02001619,9499,2102,7397
2021,Sheffield 010,E02001620,6544,1700,4844
2021,Sheffield 011,E02001621,5609,1389,4220
2021,Sheffield 012,E02001622,8428,1741,6687
2021,Sheffield 013,E02001623,7676,2129,5547
2021,Sheffield 014,E02001624,8799,1692,7107
2021,Sheffield 015,E02001625,7340,1777,5563
2021,Sheffield 016,E02001626,5525,988,4537
2021,Sheffield 017,E02001627,5695,980,4715
2021,Sheffield 018,E02001628,6010,1747,4263
2021,Sheffield 019,E02001629,6088,1451,4637
2021,Sheffield 020,E02001630,8547,2546,6001
2021,Sheffield 021,E02001631,7191,1255,5936
2021,Sheffield 022,E02001632,11310,3564,7746
2021,Sheffield 023,E02001633,7250,1175,6075
2021,Sheffield 024,E02001634,8520,1409,7111
2021,Sheffield 025,E02001635,5734,988,4746
2021,Sheffield 026,E02001636,8835,2670,6165
2021,Sheffield 027,E02001637,7838,2546,5292
2021,Sheffield 028,E02001638,5516,2611,2905
2021,Sheffield 029,E02001639,5708,1386,4322
2021,Sheffield 030,E02001640,8078,4381,3697
2021,Sheffield 032,E02001642,9694,1931,7763
2021,Sheffield 033,E02001643,5927,1179,4748
2021,Sheffield 036,E02001646,7515,4076,3439
2021,Sheffield 037,E02001647,5884,1089,4795
2021,Sheffield 038,E02001648,8012,3618,4394
2021,Sheffield 039,E02001649,10219,2523,7696
2021,Sheffield 040,E02001650,9210,4446,4764
2021,Sheffield 041,E02001651,7700,1620,6080
2021,Sheffield 042,E02001652,12437,6670,5767
2021,Sheffield 043,E02001653,6934,1602,5332
2021,Sheffield 044,E02001654,5989,1062,4927
2021,Sheffield 045,E02001655,7132,1346,5786
2021,Sheffield 046,E02001656,7383,1840,5543
2021,Sheffield 047,E02001657,8549,1964,6585
2021,Sheffield 048,E02001658,4898,1219,3679
2021,Sheffield 049,E02001659,5522,897,4625
2021,Sheffield 050,E02001660,9313,1926,7387
2021,Sheffield 051,E02001661,7155,1452,5703
2021,Sheffield 052,E02001662,7064,1131,5933
2021,Sheffield 053,E02001663,6941,1260,5681
2021,Sheffield 054,E02001664,5871,990,4881
2021,Sheffield 055,E02001665,9355,1951,7404
2021,Sheffield 056,E02001666,5617,1023,4594
2021,Sheffield 059,E02001669,7371,1254,6117
2021,Sheffield 060,E02001670,5599,1254,4345
2021,Sheffield 061,E02001671,5422,699,4723
2021,Sheffield 062,E02001672,5706,966,4740
2021,Sheffield 063,E02001673,4947,824,4123
2021,Sheffield 064,E02001674,8629,1373,7256
2021,Sheffield 065,E02001675,8016,1194,6822
2021,Sheffield 066,E02001676,5616,949,4667
2021,Sheffield 068,E02001678,9985,1906,8079
2021,Sheffield 069,E02001679,5878,1222,4656
2021,Sheffield 070,E02001680,5795,1235,4560
2021,Sheffield 071,E02001681,7244,1364,5880
2021,Gateshead 001,E02001682,8090,1385,6705
2021,Gateshead 002,E02001683,8873,1318,7555
2021,Gateshead 003,E02001684,6269,1180,5089
2021,Gateshead 004,E02001685,7582,1478,6104
2021,Gateshead 005,E02001686,6464,958,5506
2021,Gateshead 007,E02001688,7212,1298,5914
2021,Gateshead 008,E02001689,6952,1573,5379
2021,Gateshead 009,E02001690,6688,1089,5599
2021,Gateshead 010,E02001691,7905,1662,6243
2021,Gateshead 011,E02001692,5909,1369,4540
2021,Gateshead 012,E02001693,5000,868,4132
2021,Gateshead 013,E02001694,5905,951,4954
2021,Gateshead 014,E02001695,5557,906,4651
2021,Gateshead 015,E02001696,8639,1662,6977
2021,Gateshead 016,E02001697,7052,1148,5904
2021,Gateshead 017,E02001698,6700,979,5721
2021,Gateshead 018,E02001699,6239,1046,5193
2021,Gateshead 019,E02001700,9730,1759,7971
2021,Gateshead 020,E02001701,5975,976,4999
2021,Gateshead 021,E02001702,7418,1624,5794
2021,Gateshead 022,E02001703,5355,876,4479
2021,Gateshead 023,E02001704,6477,1083,5394
2021,Gateshead 025,E02001706,7424,1453,5971
2021,Gateshead 026,E02001707,7917,1316,6601
2021,Newcastle upon Tyne 002,E02001709,9872,1946,7926
2021,Newcastle upon Tyne 003,E02001710,9609,2059,7550
2021,Newcastle upon Tyne 004,E02001711,9276,1783,7493
2021,Newcastle upon Tyne 005,E02001712,8828,1841,6987
2021,Newcastle upon Tyne 006,E02001713,9527,1936,7591
2021,Newcastle upon Tyne 007,E02001714,9174,1807,7367
2021,Newcastle upon Tyne 008,E02001715,11072,2762,8310
2021,Newcastle upon Tyne 011,E02001718,6150,1169,4981
2021,Newcastle upon Tyne 012,E02001719,8205,1533,6672
2021,Newcastle upon Tyne 013,E02001720,9371,5767,3604
2021,Newcastle upon Tyne 014,E02001721,10151,1769,8382
2021,Newcastle upon Tyne 015,E02001722,8903,1810,7093
2021,Newcastle upon Tyne 016,E02001723,6678,1666,5012
2021,Newcastle upon Tyne 017,E02001724,8832,4586,4246
2021,Newcastle upon Tyne 018,E02001725,8877,2223,6654
2021,Newcastle upon Tyne 019,E02001726,11091,2549,8542
2021,Newcastle upon Tyne 020,E02001727,8290,1398,6892
2021,Newcastle upon Tyne 021,E02001728,8963,1704,7259
2021,Newcastle upon Tyne 022,E02001729,11418,4483,6935
2021,Newcastle upon Tyne 025,E02001732,5336,1162,4174
2021,Newcastle upon Tyne 027,E02001734,7621,1835,5786
2021,Newcastle upon Tyne 028,E02001735,6196,1502,4694
2021,Newcastle upon Tyne 030,E02001737,5739,1186,4553
2021,North Tyneside 001,E02001738,5912,1093,4819
2021,North Tyneside 002,E02001739,6918,1034,5884
2021,North Tyneside 003,E02001740,5626,1285,4341
2021,North Tyneside 004,E02001741,7348,1105,6243
2021,North Tyneside 005,E02001742,5535,920,4615
2021,North Tyneside 006,E02001743,7189,1348,5841
2021,North Tyneside 007,E02001744,7691,1433,6258
2021,North Tyneside 008,E02001745,6339,1216,5123
2021,North Tyneside 009,E02001746,7802,1547,6255
2021,North Tyneside 010,E02001747,5938,875,5063
2021,North Tyneside 011,E02001748,8133,1678,6455
2021,North Tyneside 012,E02001749,6054,1010,5044
2021,North Tyneside 013,E02001750,6451,1121,5330
2021,North Tyneside 014,E02001751,6283,1087,5196
2021,North Tyneside 015,E02001752,6044,1349,4695
2021,North Tyneside 016,E02001753,5914,893,5021
2021,North Tyneside 017,E02001754,5545,842,4703
2021,North Tyneside 018,E02001755,9272,1618,7654
2021,North Tyneside 019,E02001756,8716,1533,7183
2021,North Tyneside 020,E02001757,5554,832,4722
2021,North Tyneside 021,E02001758,5313,938,4375
2021,North Tyneside 022,E02001759,5869,754,5115
2021,North Tyneside 023,E02001760,7207,1623,5584
2021,North Tyneside 024,E02001761,5269,845,4424
2021,North Tyneside 025,E02001762,6326,1010,5316
2021,North Tyneside 026,E02001763,6060,1047,5013
2021,North Tyneside 027,E02001764,7154,1207,5947
2021,North Tyneside 028,E02001765,7161,1465,5696
2021,North Tyneside 029,E02001766,6799,1269,5530
2021,North Tyneside 030,E02001767,6555,1091,5464
2021,South Tyneside 001,E02001768,7712,1521,6191
2021,South Tyneside 002,E02001769,6981,1155,5826
2021,South Tyneside 003,E02001770,5716,856,4860
2021,South Tyneside 004,E02001771,5854,1146,4708
2021,South Tyneside 005,E02001772,4794,785,4009
2021,South Tyneside 006,E02001773,5043,785,4258
2021,South Tyneside 007,E02001774,4977,885,4092
2021,South Tyneside 008,E02001775,5167,1087,4080
2021,South Tyneside 009,E02001776,8512,1601,6911
2021,South Tyneside 010,E02001777,6392,1027,5365
2021,South Tyneside 011,E02001778,5326,851,4475
2021,South Tyneside 012,E02001779,5077,897,4180
2021,South Tyneside 013,E02001780,5698,1086,4612
2021,South Tyneside 014,E02001781,5026,1018,4008
2021,South Tyneside 015,E02001782,9529,1848,7681
2021,South Tyneside 016,E02001783,6578,1458,5120
2021,South Tyneside 017,E02001784,6260,1223,5037
2021,South Tyneside 018,E02001785,7281,1237,6044
2021,South Tyneside 019,E02001786,6257,1085,5172
2021,South Tyneside 020,E02001787,5138,977,4161
2021,South Tyneside 021,E02001788,5445,904,4541
2021,South Tyneside 022,E02001789,5554,933,4621
2021,South Tyneside 023,E02001790,5637,1037,4600
2021,Sunderland 001,E02001791,5235,727,4508
2021,Sunderland 002,E02001792,6591,905,5686
2021,Sunderland 003,E02001793,7755,1585,6170
2021,Sunderland 004,E02001794,8313,1659,6654
2021,Sunderland 005,E02001795,6887,1168,5719
2021,Sunderland 006,E02001796,8225,1378,6847
2021,Sunderland 007,E02001797,5646,932,4714
2021,Sunderland 008,E02001798,7773,1467,6306
2021,Sunderland 009,E02001799,8759,1783,6976
2021,Sunderland 010,E02001800,6436,1194,5242
2021,Sunderland 011,E02001801,5506,1547,3959
2021,Sunderland 012,E02001802,6828,1505,5323
2021,Sunderland 013,E02001803,8179,2633,5546
2021,Sunderland 014,E02001804,5901,1041,4860
2021,Sunderland 015,E02001805,5241,752,4489
2021,Sunderland 016,E02001806,7286,1470,5816
2021,Sunderland 017,E02001807,8098,1674,6424
2021,Sunderland 018,E02001808,5249,1211,4038
2021,Sunderland 019,E02001809,6203,1035,5168
2021,Sunderland 020,E02001810,7869,1341,6528
2021,Sunderland 021,E02001811,8240,1579,6661
2021,Sunderland 022,E02001812,9614,1547,8067
2021,Sunderland 023,E02001813,9093,1971,7122
2021,Sunderland 024,E02001814,5893,1120,4773
2021,Sunderland 025,E02001815,9460,1596,7864
2021,Sunderland 026,E02001816,6481,1035,5446
2021,Sunderland 027,E02001817,6285,1134,5151
2021,Sunderland 028,E02001818,8979,1848,7131
2021,Sunderland 029,E02001819,6640,928,5712
2021,Sunderland 030,E02001820,9147,1768,7379
2021,Sunderland 031,E02001821,5366,892,4474
2021,Sunderland 032,E02001822,7318,1191,6127
2021,Sunderland 033,E02001823,7537,1369,6168
2021,Sunderland 034,E02001824,8109,1451,6658
2021,Sunderland 035,E02001825,7281,1047,6234
2021,Sunderland 036,E02001826,6901,1382,5519
2021,Birmingham 001,E02001827,6161,1308,4853
2021,Birmingham 002,E02001828,6797,1287,5510
2021,Birmingham 003,E02001829,8642,1923,6719
2021,Birmingham 004,E02001830,9310,1672,7638
2021,Birmingham 005,E02001831,9978,2130,7848
2021,Birmingham 006,E02001832,7550,1328,6222
2021,Birmingham 007,E02001833,5610,1089,4521
2021,Birmingham 008,E02001834,5719,1428,4291
2021,Birmingham 009,E02001835,8080,1499,6581
2021,Birmingham 010,E02001836,8601,1615,6986
2021,Birmingham 011,E02001837,9953,2655,7298
2021,Birmingham 012,E02001838,7208,1190,6018
2021,Birmingham 013,E02001839,6043,1188,4855
2021,Birmingham 014,E02001840,8949,2334,6615
2021,Birmingham 015,E02001841,5719,988,4731
2021,Birmingham 016,E02001842,7550,1615,5935
2021,Birmingham 017,E02001843,6184,1219,4965
2021,Birmingham 018,E02001844,9222,1406,7816
2021,Birmingham 019,E02001845,6180,1356,4824
2021,Birmingham 020,E02001846,7562,1758,5804
2021,Birmingham 021,E02001847,5316,960,4356
2021,Birmingham 022,E02001848,6786,2036,4750
2021,Birmingham 023,E02001849,7997,2059,5938
2021,Birmingham 024,E02001850,8009,2111,5898
2021,Birmingham 025,E02001851,8546,1793,6753
2021,Birmingham 026,E02001852,6568,1465,5103
2021,Birmingham 029,E02001855,9287,2089,7198
2021,Birmingham 030,E02001856,8910,2295,6615
2021,Birmingham 031,E02001857,12960,2907,10053
2021,Birmingham 032,E02001858,8593,2546,6047
2021,Birmingham 033,E02001859,9613,3000,6613
2021,Birmingham 034,E02001860,7905,2372,5533
2021,Birmingham 035,E02001861,10322,3211,7111
2021,Birmingham 036,E02001862,9243,2665,6578
2021,Birmingham 037,E02001863,7784,2528,5256
2021,Birmingham 039,E02001865,10614,3243,7371
2021,Birmingham 040,E02001866,8802,2625,6177
2021,Birmingham 041,E02001867,8028,2805,5223
2021,Birmingham 042,E02001868,9042,2844,6198
2021,Birmingham 043,E02001869,6341,2401,3940
2021,Birmingham 044,E02001870,11946,4086,7860
2021,Birmingham 045,E02001871,7721,1774,5947
2021,Birmingham 046,E02001872,6867,1586,5281
2021,Birmingham 047,E02001873,10482,3323,7159
2021,Birmingham 048,E02001874,9123,3156,5967
2021,Birmingham 049,E02001875,8224,2733,5491
2021,Birmingham 050,E02001876,15281,9843,5438
2021,Birmingham 051,E02001877,11371,4081,7290
2021,Birmingham 052,E02001878,8735,3076,5659
2021,Birmingham 053,E02001879,9300,2713,6587
2021,Birmingham 054,E02001880,9183,2827,6356
2021,Birmingham 055,E02001881,9630,3406,6224
2021,Birmingham 056,E02001882,8167,2173,5994
2021,Birmingham 057,E02001883,7862,1894,5968
2021,Birmingham 058,E02001884,9313,3542,5771
2021,Birmingham 060,E02001886,9387,2317,7070
2021,Birmingham 062,E02001888,6661,1884,4777
2021,Birmingham 063,E02001889,8432,2980,5452
2021,Birmingham 064,E02001890,9517,2396,7121
2021,Birmingham 066,E02001892,10564,3696,6868
2021,Birmingham 067,E02001893,8271,2038,6233
2021,Birmingham 069,E02001895,8395,2075,6320
2021,Birmingham 070,E02001896,9288,3177,6111
2021,Birmingham 071,E02001897,7913,2674,5239
2021,Birmingham 072,E02001898,6163,1176,4987
2021,Birmingham 073,E02001899,8040,1537,6503
2021,Birmingham 074,E02001900,6302,1776,4526
2021,Birmingham 075,E02001901,7672,1544,6128
2021,Birmingham 076,E02001902,5834,1302,4532
2021,Birmingham 077,E02001903,7430,2487,4943
2021,Birmingham 078,E02001904,7096,2052,5044
2021,Birmingham 079,E02001905,9943,5424,4519
2021,Birmingham 080,E02001906,9020,1964,7056
2021,Birmingham 081,E02001907,9791,1873,7918
2021,Birmingham 082,E02001908,8228,2723,5505
2021,Birmingham 083,E02001909,7601,2468,5133
2021,Birmingham 084,E02001910,6722,2049,4673
2021,Birmingham 085,E02001911,8047,2357,5690
2021,Birmingham 087,E02001913,7065,2309,4756
2021,Birmingham 088,E02001914,6614,1685,4929
2021,Birmingham 089,E02001915,11196,2360,8836
2021,Birmingham 090,E02001916,9108,2704,6404
2021,Birmingham 092,E02001918,8258,1560,6698
2021,Birmingham 093,E02001919,6592,1411,5181
2021,Birmingham 094,E02001920,7129,1709,5420
2021,Birmingham 095,E02001921,7234,1797,5437
2021,Birmingham 096,E02001922,15775,12958,2817
2021,Birmingham 097,E02001923,10421,2926,7495
2021,Birmingham 098,E02001924,6585,1691,4894
2021,Birmingham 099,E02001925,6393,1700,4693
2021,Birmingham 100,E02001926,7441,2044,5397
2021,Birmingham 101,E02001927,7210,1889,5321
2021,Birmingham 102,E02001928,6394,1370,5024
2021,Birmingham 103,E02001929,9635,2807,6828
2021,Birmingham 104,E02001930,7305,1522,5783
2021,Birmingham 105,E02001931,8056,1798,6258
2021,Birmingham 106,E02001932,6917,1924,4993
2021,Birmingham 107,E02001933,7208,1662,5546
2021,Birmingham 108,E02001934,6701,1728,4973
2021,Birmingham 109,E02001935,7647,1764,5883
2021,Birmingham 110,E02001936,6036,1278,4758
2021,Birmingham 111,E02001937,7794,2005,5789
2021,Birmingham 112,E02001938,7436,1440,5996
2021,Birmingham 113,E02001939,5947,1064,4883
2021,Birmingham 115,E02001941,6055,1568,4487
2021,Birmingham 116,E02001942,6389,1340,5049
2021,Birmingham 117,E02001943,6078,1293,4785
2021,Birmingham 118,E02001944,7621,1570,6051
2021,Birmingham 119,E02001945,7351,1935,5416
2021,Birmingham 120,E02001946,7223,1409,5814
2021,Birmingham 121,E02001947,5740,1440,4300
2021,Birmingham 122,E02001948,6906,1314,5592
2021,Birmingham 123,E02001949,5697,1238,4459
2021,Birmingham 124,E02001950,8063,1503,6560
2021,Birmingham 125,E02001951,8739,2183,6556
2021,Birmingham 126,E02001952,8462,2083,6379
2021,Birmingham 127,E02001953,6734,1325,5409
2021,Birmingham 128,E02001954,7078,1829,5249
2021,Birmingham 129,E02001955,7560,1614,5946
2021,Birmingham 130,E02001956,6428,1335,5093
2021,Birmingham 131,E02001957,7407,1454,5953
2021,Coventry 001,E02001958,7544,1595,5949
2021,Coventry 002,E02001959,6498,1420,5078
2021,Coventry 004,E02001961,7403,1812,5591
2021,Coventry 005,E02001962,6648,1764,4884
2021,Coventry 006,E02001963,5880,1147,4733
2021,Coventry 007,E02001964,10066,3004,7062
2021,Coventry 008,E02001965,7651,1489,6162
2021,Coventry 009,E02001966,6806,2151,4655
2021,Coventry 010,E02001967,6615,1159,5456
2021,Coventry 011,E02001968,7463,1989,5474
2021,Coventry 012,E02001969,6344,1458,4886
2021,Coventry 013,E02001970,5392,953,4439
2021,Coventry 014,E02001971,5920,1333,4587
2021,Coventry 015,E02001972,10686,3329,7357
2021,Coventry 016,E02001973,7964,1999,5965
2021,Coventry 017,E02001974,8967,1788,7179
2021,Coventry 018,E02001975,7223,1677,5546
2021,Coventry 019,E02001976,7135,1567,5568
2021,Coventry 020,E02001977,9372,2568,6804
2021,Coventry 021,E02001978,6291,1370,4921
2021,Coventry 022,E02001979,5321,951,4370
2021,Coventry 023,E02001980,5516,804,4712
2021,Coventry 024,E02001981,12313,5400,6913
2021,Coventry 025,E02001982,7910,1521,6389
2021,Coventry 026,E02001983,7191,1433,5758
2021,Coventry 027,E02001984,9782,2331,7451
2021,Coventry 028,E02001985,8944,5016,3928
2021,Coventry 029,E02001986,7469,1536,5933
2021,Coventry 030,E02001987,5661,1748,3913
2021,Coventry 031,E02001988,10847,6476,4371
2021,Coventry 032,E02001989,5909,1526,4383
2021,Coventry 033,E02001990,8779,1645,7134
2021,Coventry 034,E02001991,8160,1768,6392
2021,Coventry 035,E02001992,10056,2708,7348
2021,Coventry 036,E02001993,8574,3189,5385
2021,Coventry 037,E02001994,7521,1628,5893
2021,Coventry 038,E02001995,8743,2030,6713
2021,Coventry 039,E02001996,7059,1808,5251
2021,Coventry 040,E02001997,8121,1542,6579
2021,Coventry 041,E02001998,5754,1226,4528
2021,Coventry 042,E02001999,8910,4971,3939
2021,Dudley 001,E02002000,7949,1542,6407
2021,Dudley 002,E02002001,5820,1059,4761
2021,Dudley 003,E02002002,6635,936,5699
2021,Dudley 004,E02002003,8553,1440,7113
2021,Dudley 005,E02002004,7166,1444,5722
2021,Dudley 006,E02002005,9159,2467,6692
2021,Dudley 007,E02002006,6062,1134,4928
2021,Dudley 008,E02002007,8527,1340,7187
2021,Dudley 009,E02002008,7761,1408,6353
2021,Dudley 010,E02002009,6551,1729,4822
2021,Dudley 011,E02002010,7736,1646,6090
2021,Dudley 012,E02002011,5651,899,4752
2021,Dudley 013,E02002012,7853,1574,6279
2021,Dudley 014,E02002013,6336,1013,5323
2021,Dudley 015,E02002014,7666,1895,5771
2021,Dudley 016,E02002015,6616,1173,5443
2021,Dudley 017,E02002016,7494,1654,5840
2021,Dudley 018,E02002017,7569,1497,6072
2021,Dudley 019,E02002018,8582,1481,7101
2021,Dudley 020,E02002019,7283,1608,5675
2021,Dudley 021,E02002020,9030,1422,7608
2021,Dudley 022,E02002021,7210,1324,5886
2021,Dudley 023,E02002022,8196,1628,6568
2021,Dudley 024,E02002023,5089,811,4278
2021,Dudley 025,E02002024,8210,1518,6692
2021,Dudley 026,E02002025,8287,1696,6591
2021,Dudley 027,E02002026,6475,1079,5396
2021,Dudley 028,E02002027,5171,818,4353
2021,Dudley 029,E02002028,5471,807,4664
2021,Dudley 030,E02002029,5904,1068,4836
2021,Dudley 031,E02002030,6395,1229,5166
2021,Dudley 032,E02002031,5910,1134,4776
2021,Dudley 033,E02002032,9591,1992,7599
2021,Dudley 034,E02002033,7427,1402,6025
2021,Dudley 035,E02002034,7795,1317,6478
2021,Dudley 036,E02002035,5845,1018,4827
2021,Dudley 037,E02002036,6227,1265,4962
2021,Dudley 038,E02002037,5639,982,4657
2021,Dudley 039,E02002038,9126,1647,7479
2021,Dudley 040,E02002039,5952,1135,4817
2021,Dudley 041,E02002040,5709,904,4805
2021,Dudley 042,E02002041,5993,1063,4930
2021,Dudley 043,E02002042,7692,1387,6305
2021,Sandwell 001,E02002043,8185,1879,6306
2021,Sandwell 002,E02002044,7471,1809,5662
2021,Sandwell 003,E02002045,7337,1602,5735
2021,Sandwell 004,E02002046,5341,1470,3871
2021,Sandwell 005,E02002047,7104,1301,5803
2021,Sandwell 006,E02002048,6503,1138,5365
2021,Sandwell 007,E02002049,5878,1170,4708
2021,Sandwell 009,E02002051,5710,1537,4173
2021,Sandwell 010,E02002052,10633,2561,8072
2021,Sandwell 011,E02002053,5959,1329,4630
2021,Sandwell 012,E02002054,5499,1169,4330
2021,Sandwell 013,E02002055,10429,2520,7909
2021,Sandwell 014,E02002056,9190,2261,6929
2021,Sandwell 015,E02002057,10071,2329,7742
2021,Sandwell 016,E02002058,12587,2919,9668
2021,Sandwell 017,E02002059,11103,2477,8626
2021,Sandwell 018,E02002060,6856,1900,4956
2021,Sandwell 019,E02002061,6651,1811,4840
2021,Sandwell 020,E02002062,8365,2019,6346
2021,Sandwell 021,E02002063,9616,2290,7326
2021,Sandwell 022,E02002064,11647,2693,8954
2021,Sandwell 023,E02002065,13119,3977,9142
2021,Sandwell 024,E02002066,7672,2047,5625
2021,Sandwell 025,E02002067,5964,1239,4725
2021,Sandwell 027,E02002069,6669,1450,5219
2021,Sandwell 028,E02002070,9572,2749,6823
2021,Sandwell 029,E02002071,6280,1341,4939
2021,Sandwell 030,E02002072,8423,1781,6642
2021,Sandwell 031,E02002073,7903,2079,5824
2021,Sandwell 032,E02002074,7794,1780,6014
2021,Sandwell 033,E02002075,8270,1657,6613
2021,Sandwell 034,E02002076,10022,2113,7909
2021,Sandwell 035,E02002077,10151,2067,8084
2021,Sandwell 036,E02002078,6202,1295,4907
2021,Sandwell 037,E02002079,8154,1793,6361
2021,Sandwell 038,E02002080,6941,1483,5458
2021,Solihull 001,E02002081,5188,828,4360
2021,Solihull 002,E02002082,5444,1350,4094
2021,Solihull 003,E02002083,5736,946,4790
2021,Solihull 004,E02002084,6222,1418,4804
2021,Solihull 005,E02002085,6183,1462,4721
2021,Solihull 006,E02002086,5436,1086,4350
2021,Solihull 007,E02002087,5802,1325,4477
2021,Solihull 008,E02002088,8869,1961,6908
2021,Solihull 009,E02002089,7682,1389,6293
2021,Solihull 010,E02002090,5589,1089,4500
2021,Solihull 011,E02002091,7242,1324,5918
2021,Solihull 012,E02002092,6880,1315,5565
2021,Solihull 013,E02002093,6384,1135,5249
2021,Solihull 014,E02002094,5732,1069,4663
2021,Solihull 015,E02002095,8173,1498,6675
2021,Solihull 016,E02002096,9869,1893,7976
2021,Solihull 017,E02002097,7037,1224,5813
2021,Solihull 018,E02002098,9261,1971,7290
2021,Solihull 019,E02002099,6642,1262,5380
2021,Solihull 021,E02002101,5935,951,4984
2021,Solihull 022,E02002102,8333,1708,6625
2021,Solihull 023,E02002103,5793,895,4898
2021,Solihull 024,E02002104,5653,1066,4587
2021,Solihull 025,E02002105,7905,1521,6384
2021,Solihull 026,E02002106,9338,1790,7548
2021,Solihull 027,E02002107,5167,904,4263
2021,Solihull 028,E02002108,9403,2040,7363
2021,Solihull 029,E02002109,11352,2244,9108
2021,Walsall 001,E02002110,6641,1321,5320
2021,Walsall 002,E02002111,6064,1215,4849
2021,Walsall 003,E02002112,5039,913,4126
2021,Walsall 004,E02002113,6041,1155,4886
2021,Walsall 005,E02002114,5769,882,4887
2021,Walsall 006,E02002115,6392,1230,5162
2021,Walsall 007,E02002116,6455,1012,5443
2021,Walsall 008,E02002117,5977,1020,4957
2021,Walsall 009,E02002118,6919,1516,5403
2021,Walsall 010,E02002119,5685,1029,4656
2021,Walsall 011,E02002120,5795,1153,4642
2021,Walsall 012,E02002121,6202,1492,4710
2021,Walsall 013,E02002122,6549,1986,4563
2021,Walsall 014,E02002123,6118,1177,4941
2021,Walsall 015,E02002124,6585,1034,5551
2021,Walsall 016,E02002125,6063,1208,4855
2021,Walsall 017,E02002126,6067,1379,4688
2021,Walsall 018,E02002127,8997,2589,6408
2021,Walsall 019,E02002128,5333,917,4416
2021,Walsall 020,E02002129,5740,999,4741
2021,Walsall 021,E02002130,6344,1626,4718
2021,Walsall 022,E02002131,7455,1276,6179
2021,Walsall 023,E02002132,6081,1475,4606
2021,Walsall 024,E02002133,6530,1174,5356
2021,Walsall 025,E02002134,8592,1999,6593
2021,Walsall 026,E02002135,7363,2011,5352
2021,Walsall 027,E02002136,7487,1676,5811
2021,Walsall 028,E02002137,5860,1001,4859
2021,Walsall 029,E02002138,5997,1429,4568
2021,Walsall 030,E02002139,9915,2618,7297
2021,Walsall 031,E02002140,7853,2155,5698
2021,Walsall 032,E02002141,6108,1077,5031
2021,Walsall 033,E02002142,7013,2022,4991
2021,Walsall 034,E02002143,9372,2929,6443
2021,Walsall 035,E02002144,6539,1269,5270
2021,Walsall 036,E02002145,7788,2070,5718
2021,Walsall 037,E02002146,6049,1654,4395
2021,Walsall 038,E02002147,8349,2030,6319
2021,Walsall 039,E02002148,10803,2059,8744
2021,Wolverhampton 001,E02002149,9576,1918,7658
2021,Wolverhampton 002,E02002150,5440,1203,4237
2021,Wolverhampton 003,E02002151,5255,1103,4152
2021,Wolverhampton 004,E02002152,5896,1595,4301
2021,Wolverhampton 005,E02002153,6999,1229,5770
2021,Wolverhampton 006,E02002154,6888,1595,5293
2021,Wolverhampton 007,E02002155,6003,1922,4081
2021,Wolverhampton 008,E02002156,7866,1606,6260
2021,Wolverhampton 009,E02002157,7388,1434,5954
2021,Wolverhampton 010,E02002158,7072,1232,5840
2021,Wolverhampton 011,E02002159,5774,1717,4057
2021,Wolverhampton 012,E02002160,7150,1437,5713
2021,Wolverhampton 013,E02002161,6493,1823,4670
2021,Wolverhampton 014,E02002162,7480,1282,6198
2021,Wolverhampton 015,E02002163,10900,2698,8202
2021,Wolverhampton 016,E02002164,6245,2155,4090
2021,Wolverhampton 017,E02002165,7438,1431,6007
2021,Wolverhampton 018,E02002166,8874,2223,6651
2021,Wolverhampton 019,E02002167,6334,1090,5244
2021,Wolverhampton 020,E02002168,10797,3285,7512
2021,Wolverhampton 021,E02002169,8430,1555,6875
2021,Wolverhampton 022,E02002170,5904,1291,4613
2021,Wolverhampton 023,E02002171,7206,1568,5638
2021,Wolverhampton 026,E02002174,7275,1346,5929
2021,Wolverhampton 027,E02002175,7320,1712,5608
2021,Wolverhampton 028,E02002176,7303,1439,5864
2021,Wolverhampton 029,E02002177,10610,2476,8134
2021,Wolverhampton 030,E02002178,7749,1444,6305
2021,Wolverhampton 031,E02002179,6232,1215,5017
2021,Wolverhampton 032,E02002180,6146,1284,4862
2021,Wolverhampton 033,E02002181,7856,1837,6019
2021,Wolverhampton 034,E02002182,6251,1286,4965
2021,Bradford 001,E02002183,5539,774,4765
2021,Bradford 002,E02002184,12658,2340,10318
2021,Bradford 003,E02002185,5571,1049,4522
2021,Bradford 005,E02002187,5911,1140,4771
2021,Bradford 006,E02002188,7410,1473,5937
2021,Bradford 007,E02002189,6731,1827,4904
2021,Bradford 008,E02002190,11018,2856,8162
2021,Bradford 009,E02002191,8976,2453,6523
2021,Bradford 010,E02002192,8763,1452,7311
2021,Bradford 011,E02002193,6077,1284,4793
2021,Bradford 012,E02002194,6976,1386,5590
2021,Bradford 013,E02002195,6120,995,5125
2021,Bradford 014,E02002196,6075,1183,4892
2021,Bradford 015,E02002197,8302,1462,6840
2021,Bradford 016,E02002198,7928,1249,6679
2021,Bradford 017,E02002199,6826,1072,5754
2021,Bradford 018,E02002200,8644,1597,7047
2021,Bradford 019,E02002201,11504,2063,9441
2021,Bradford 020,E02002202,7079,1204,5875
2021,Bradford 021,E02002203,7224,1398,5826
2021,Bradford 022,E02002204,10927,1932,8995
2021,Bradford 023,E02002205,9373,1435,7938
2021,Bradford 024,E02002206,8261,1700,6561
2021,Bradford 025,E02002207,7005,2005,5000
2021,Bradford 026,E02002208,7598,1658,5940
2021,Bradford 027,E02002209,6466,1955,4511
2021,Bradford 028,E02002210,7185,1702,5483
2021,Bradford 029,E02002211,7165,2016,5149
2021,Bradford 030,E02002212,8597,2992,5605
2021,Bradford 031,E02002213,7277,1330,5947
2021,Bradford 032,E02002214,6120,1534,4586
2021,Bradford 033,E02002215,9960,3060,6900
2021,Bradford 034,E02002216,9421,2681,6740
2021,Bradford 035,E02002217,9606,3201,6405
2021,Bradford 036,E02002218,9461,2511,6950
2021,Bradford 037,E02002219,7578,2484,5094
2021,Bradford 038,E02002220,8832,2934,5898
2021,Bradford 040,E02002222,8504,2542,5962
2021,Bradford 041,E02002223,7225,2412,4813
2021,Bradford 042,E02002224,10034,3405,6629
2021,Bradford 043,E02002225,8089,1633,6456
2021,Bradford 044,E02002226,12996,5108,7888
2021,Bradford 045,E02002227,5691,1521,4170
2021,Bradford 046,E02002228,6969,1870,5099
2021,Bradford 047,E02002229,7856,1926,5930
2021,Bradford 048,E02002230,7836,2554,5282
2021,Bradford 049,E02002231,12412,3445,8967
2021,Bradford 050,E02002232,6624,1904,4720
2021,Bradford 051,E02002233,9011,3254,5757
2021,Bradford 052,E02002234,6988,2033,4955
2021,Bradford 053,E02002235,6546,2031,4515
2021,Bradford 054,E02002236,6036,1411,4625
2021,Bradford 055,E02002237,8162,2027,6135
2021,Bradford 056,E02002238,6007,1555,4452
2021,Bradford 057,E02002239,10073,2276,7797
2021,Bradford 058,E02002240,10875,1998,8877
2021,Bradford 059,E02002241,11409,2621,8788
2021,Bradford 060,E02002242,7478,1252,6226
2021,Bradford 061,E02002243,9038,1839,7199
2021,Calderdale 001,E02002244,5786,1019,4767
2021,Calderdale 002,E02002245,4984,1206,3778
2021,Calderdale 003,E02002246,9144,1475,7669
2021,Calderdale 004,E02002247,8599,1428,7171
2021,Calderdale 005,E02002248,7277,1525,5752
2021,Calderdale 006,E02002249,5173,1179,3994
2021,Calderdale 007,E02002250,7884,1314,6570
2021,Calderdale 008,E02002251,7507,1075,6432
2021,Calderdale 009,E02002252,6361,1255,5106
2021,Calderdale 010,E02002253,7867,2333,5534
2021,Calderdale 011,E02002254,5920,1051,4869
2021,Calderdale 012,E02002255,7137,2110,5027
2021,Calderdale 013,E02002256,8963,1760,7203
2021,Calderdale 014,E02002257,5974,1804,4170
2021,Calderdale 015,E02002258,8465,1535,6930
2021,Calderdale 016,E02002259,6740,1292,5448
2021,Calderdale 017,E02002260,8612,1393,7219
2021,Calderdale 018,E02002261,7500,1334,6166
2021,Calderdale 019,E02002262,7312,1162,6150
2021,Calderdale 020,E02002263,6186,1213,4973
2021,Calderdale 021,E02002264,6724,1311,5413
2021,Calderdale 022,E02002265,5349,928,4421
2021,Calderdale 023,E02002266,5473,888,4585
2021,Calderdale 024,E02002267,7593,1427,6166
2021,Calderdale 025,E02002268,9743,1907,7836
2021,Calderdale 026,E02002269,8907,1644,7263
2021,Calderdale 027,E02002270,8131,1590,6541
2021,Kirklees 001,E02002271,7121,1308,5813
2021,Kirklees 002,E02002272,9089,1718,7371
2021,Kirklees 003,E02002273,6215,1065,5150
2021,Kirklees 004,E02002274,6553,1286,5267
2021,Kirklees 005,E02002275,8085,1392,6693
2021,Kirklees 006,E02002276,7314,1641,5673
2021,Kirklees 007,E02002277,6447,1499,4948
2021,Kirklees 008,E02002278,6348,1340,5008
2021,Kirklees 009,E02002279,5885,1153,4732
2021,Kirklees 010,E02002280,6374,1565,4809
2021,Kirklees 011,E02002281,10901,2510,8391
2021,Kirklees 012,E02002282,6852,1826,5026
2021,Kirklees 013,E02002283,6731,1639,5092
2021,Kirklees 014,E02002284,5869,1075,4794
2021,Kirklees 015,E02002285,7585,1376,6209
2021,Kirklees 016,E02002286,5788,1443,4345
2021,Kirklees 017,E02002287,6740,1611,5129
2021,Kirklees 018,E02002288,9493,2081,7412
2021,Kirklees 019,E02002289,6510,2046,4464
2021,Kirklees 020,E02002290,6019,1047,4972
2021,Kirklees 021,E02002291,6217,1217,5000
2021,Kirklees 022,E02002292,5370,1021,4349
2021,Kirklees 023,E02002293,8103,2579,5524
2021,Kirklees 024,E02002294,10362,2998,7364
2021,Kirklees 025,E02002295,6718,1795,4923
2021,Kirklees 026,E02002296,6587,1028,5559
2021,Kirklees 027,E02002297,6614,1322,5292
2021,Kirklees 028,E02002298,6282,1140,5142
2021,Kirklees 029,E02002299,6715,2182,4533
2021,Kirklees 030,E02002300,8045,1544,6501
2021,Kirklees 031,E02002301,7616,2191,5425
2021,Kirklees 032,E02002302,5890,1135,4755
2021,Kirklees 033,E02002303,6286,1278,5008
2021,Kirklees 034,E02002304,6227,1492,4735
2021,Kirklees 035,E02002305,5800,1466,4334
2021,Kirklees 036,E02002306,5929,981,4948
2021,Kirklees 037,E02002307,5579,1096,4483
2021,Kirklees 038,E02002308,6426,1221,5205
2021,Kirklees 039,E02002309,6394,1812,4582
2021,Kirklees 040,E02002310,5432,1057,4375
2021,Kirklees 041,E02002311,6168,1169,4999
2021,Kirklees 042,E02002312,7700,3323,4377
2021,Kirklees 043,E02002313,7192,2217,4975
2021,Kirklees 044,E02002314,5613,1038,4575
2021,Kirklees 045,E02002315,6310,1206,5104
2021,Kirklees 046,E02002316,6375,1029,5346
2021,Kirklees 047,E02002317,6937,1742,5195
2021,Kirklees 048,E02002318,5821,1086,4735
2021,Kirklees 049,E02002319,6571,1243,5328
2021,Kirklees 050,E02002320,5757,892,4865
2021,Kirklees 051,E02002321,6528,1674,4854
2021,Kirklees 052,E02002322,6072,1050,5022
2021,Kirklees 053,E02002323,7852,1406,6446
2021,Kirklees 054,E02002324,6290,1063,5227
2021,Kirklees 055,E02002325,8632,1596,7036
2021,Kirklees 056,E02002326,5720,1108,4612
2021,Kirklees 057,E02002327,9600,1681,7919
2021,Kirklees 058,E02002328,6737,1185,5552
2021,Kirklees 059,E02002329,11684,2197,9487
2021,Leeds 001,E02002330,6670,1080,5590
2021,Leeds 002,E02002331,7040,904,6136
2021,Leeds 003,E02002332,6171,1119,5052
2021,Leeds 004,E02002333,7499,1194,6305
2021,Leeds 005,E02002334,7204,1309,5895
2021,Leeds 006,E02002335,7143,1257,5886
2021,Leeds 007,E02002336,6634,1267,5367
2021,Leeds 008,E02002337,7338,1391,5947
2021,Leeds 009,E02002338,6921,1401,5520
2021,Leeds 010,E02002339,5303,964,4339
2021,Leeds 011,E02002340,5599,831,4768
2021,Leeds 012,E02002341,7059,1412,5647
2021,Leeds 013,E02002342,5737,989,4748
2021,Leeds 014,E02002343,5604,1055,4549
2021,Leeds 015,E02002344,7361,1342,6019
2021,Leeds 016,E02002345,5868,1079,4789
2021,Leeds 017,E02002346,5744,1109,4635
2021,Leeds 018,E02002347,6014,1446,4568
2021,Leeds 019,E02002348,6141,1251,4890
2021,Leeds 020,E02002349,5501,1027,4474
2021,Leeds 021,E02002350,6352,1714,4638
2021,Leeds 022,E02002351,5354,927,4427
2021,Leeds 023,E02002352,7314,1354,5960
2021,Leeds 024,E02002353,5611,1176,4435
2021,Leeds 025,E02002354,7667,1560,6107
2021,Leeds 027,E02002356,8657,1788,6869
2021,Leeds 028,E02002357,7853,1510,6343
2021,Leeds 029,E02002358,8034,1548,6486
2021,Leeds 030,E02002359,6197,1024,5173
2021,Leeds 031,E02002360,6486,1223,5263
2021,Leeds 032,E02002361,5690,1311,4379
2021,Leeds 033,E02002362,7559,1546,6013
2021,Leeds 034,E02002363,6721,910,5811
2021,Leeds 035,E02002364,5562,1099,4463
2021,Leeds 037,E02002366,7906,1883,6023
2021,Leeds 038,E02002367,6055,1521,4534
2021,Leeds 039,E02002368,8105,1470,6635
2021,Leeds 040,E02002369,7368,1789,5579
2021,Leeds 041,E02002370,6689,1494,5195
2021,Leeds 042,E02002371,9940,2424,7516
2021,Leeds 044,E02002373,8381,4887,3494
2021,Leeds 045,E02002374,6526,1410,5116
2021,Leeds 046,E02002375,6136,1841,4295
2021,Leeds 047,E02002376,7249,2295,4954
2021,Leeds 048,E02002377,6942,2162,4780
2021,Leeds 050,E02002379,5513,1507,4006
2021,Leeds 051,E02002380,5250,881,4369
2021,Leeds 052,E02002381,5904,926,4978
2021,Leeds 053,E02002382,6447,2064,4383
2021,Leeds 054,E02002383,7979,5894,2085
2021,Leeds 055,E02002384,11710,5970,5740
2021,Leeds 056,E02002385,8226,3040,5186
2021,Leeds 057,E02002386,8713,1257,7456
2021,Leeds 058,E02002387,5695,1203,4492
2021,Leeds 059,E02002388,7543,1680,5863
2021,Leeds 060,E02002389,7149,2071,5078
2021,Leeds 061,E02002390,6643,1246,5397
2021,Leeds 062,E02002391,7479,1334,6145
2021,Leeds 063,E02002392,9821,7205,2616
2021,Leeds 064,E02002393,8046,2148,5898
2021,Leeds 065,E02002394,6938,2013,4925
2021,Leeds 066,E02002395,6897,1474,5423
2021,Leeds 067,E02002396,8484,1419,7065
2021,Leeds 068,E02002397,7256,1357,5899
2021,Leeds 069,E02002398,7154,1163,5991
2021,Leeds 070,E02002399,6011,1517,4494
2021,Leeds 071,E02002400,9063,1984,7079
2021,Leeds 072,E02002401,6099,1705,4394
2021,Leeds 073,E02002402,5512,822,4690
2021,Leeds 074,E02002403,6045,1090,4955
2021,Leeds 075,E02002404,10290,2477,7813
2021,Leeds 076,E02002405,8618,1763,6855
2021,Leeds 077,E02002406,6889,1186,5703
2021,Leeds 078,E02002407,6006,1439,4567
2021,Leeds 079,E02002408,7169,1269,5900
2021,Leeds 080,E02002409,5754,1104,4650
2021,Leeds 081,E02002410,6531,1102,5429
2021,Leeds 082,E02002411,8473,1950,6523
2021,Leeds 083,E02002412,6829,1236,5593
2021,Leeds 085,E02002414,6293,1739,4554
2021,Leeds 086,E02002415,7195,2315,4880
2021,Leeds 087,E02002416,6601,1103,5498
2021,Leeds 088,E02002417,6887,1237,5650
2021,Leeds 089,E02002418,6722,1179,5543
2021,Leeds 090,E02002419,7573,1671,5902
2021,Leeds 091,E02002420,7780,1845,5935
2021,Leeds 092,E02002421,5897,1476,4421
2021,Leeds 093,E02002422,6129,1006,5123
2021,Leeds 094,E02002423,5425,1139,4286
2021,Leeds 095,E02002424,7216,1294,5922
2021,Leeds 096,E02002425,8247,1381,6866
2021,Leeds 097,E02002426,7352,1280,6072
2021,Leeds 098,E02002427,6333,1067,5266
2021,Leeds 099,E02002428,7503,1531,5972
2021,Leeds 100,E02002429,8037,1456,6581
2021,Leeds 101,E02002430,7509,2055,5454
2021,Leeds 102,E02002431,8305,1523,6782
2021,Leeds 103,E02002432,7278,1433,5845
2021,Leeds 104,E02002433,6433,912,5521
2021,Leeds 105,E02002434,9548,2100,7448
2021,Leeds 106,E02002435,7796,1433,6363
2021,Leeds 107,E02002436,6497,1198,5299
2021,Leeds 108,E02002437,5886,1050,4836
2021,Wakefield 001,E02002438,8275,1717,6558
2021,Wakefield 002,E02002439,8189,1211,6978
2021,Wakefield 003,E02002440,7467,1407,6060
2021,Wakefield 004,E02002441,9165,1600,7565
2021,Wakefield 005,E02002442,6872,1038,5834
2021,Wakefield 006,E02002443,5825,990,4835
2021,Wakefield 007,E02002444,6526,1104,5422
2021,Wakefield 008,E02002445,8026,1387,6639
2021,Wakefield 009,E02002446,5664,825,4839
2021,Wakefield 010,E02002447,5785,999,4786
2021,Wakefield 011,E02002448,7555,1321,6234
2021,Wakefield 012,E02002449,9203,1607,7596
2021,Wakefield 013,E02002450,7463,1295,6168
2021,Wakefield 014,E02002451,7571,1190,6381
2021,Wakefield 015,E02002452,8649,1409,7240
2021,Wakefield 016,E02002453,9120,1633,7487
2021,Wakefield 017,E02002454,8626,1588,7038
2021,Wakefield 018,E02002455,6097,1315,4782
2021,Wakefield 019,E02002456,7635,1350,6285
2021,Wakefield 020,E02002457,7421,1653,5768
2021,Wakefield 021,E02002458,8589,1536,7053
2021,Wakefield 022,E02002459,9402,1925,7477
2021,Wakefield 023,E02002460,7159,1155,6004
2021,Wakefield 024,E02002461,11192,2062,9130
2021,Wakefield 025,E02002462,7085,1240,5845
2021,Wakefield 026,E02002463,9654,2379,7275
2021,Wakefield 027,E02002464,8442,1478,6964
2021,Wakefield 028,E02002465,5831,767,5064
2021,Wakefield 029,E02002466,8613,1505,7108
2021,Wakefield 030,E02002467,8363,1648,6715
2021,Wakefield 031,E02002468,5869,986,4883
2021,Wakefield 032,E02002469,6174,1066,5108
2021,Wakefield 033,E02002470,5767,813,4954
2021,Wakefield 034,E02002471,10883,1739,9144
2021,Wakefield 035,E02002472,5537,841,4696
2021,Wakefield 036,E02002473,6376,899,5477
2021,Wakefield 037,E02002474,6535,1286,5249
2021,Wakefield 038,E02002475,6006,979,5027
2021,Wakefield 039,E02002476,6227,1226,5001
2021,Wakefield 040,E02002477,5946,1056,4890
2021,Wakefield 041,E02002478,5877,1090,4787
2021,Wakefield 042,E02002479,7764,1226,6538
2021,Wakefield 043,E02002480,5218,747,4471
2021,Wakefield 044,E02002481,6947,1304,5643
2021,Wakefield 045,E02002482,6712,1449,5263
2021,Hartlepool 001,E02002483,9672,1987,7685
2021,Hartlepool 002,E02002484,9618,1967,7651
2021,Hartlepool 003,E02002485,7520,1681,5839
2021,Hartlepool 007,E02002489,6763,1564,5199
2021,Hartlepool 008,E02002490,5445,1070,4375
2021,Hartlepool 009,E02002491,6132,1334,4798
2021,Hartlepool 010,E02002492,6390,1224,5166
2021,Hartlepool 011,E02002493,6442,1042,5400
2021,Hartlepool 012,E02002494,7080,1618,5462
2021,Middlesbrough 001,E02002496,11207,4625,6582
2021,Middlesbrough 002,E02002497,5675,1464,4211
2021,Middlesbrough 003,E02002498,7891,2622,5269
2021,Middlesbrough 004,E02002499,7055,1873,5182
2021,Middlesbrough 005,E02002500,5543,1360,4183
2021,Middlesbrough 006,E02002501,5834,1436,4398
2021,Middlesbrough 007,E02002502,9109,2121,6988
2021,Middlesbrough 008,E02002503,6340,1644,4696
2021,Middlesbrough 009,E02002504,9152,2154,6998
2021,Middlesbrough 010,E02002505,5864,1521,4343
2021,Middlesbrough 011,E02002506,5283,1330,3953
2021,Middlesbrough 012,E02002507,5868,1158,4710
2021,Middlesbrough 013,E02002508,5134,950,4184
2021,Middlesbrough 014,E02002509,4835,957,3878
2021,Middlesbrough 015,E02002510,6672,1095,5577
2021,Middlesbrough 017,E02002512,5102,875,4227
2021,Middlesbrough 018,E02002513,9634,1846,7788
2021,Middlesbrough 019,E02002514,8015,1497,6518
2021,Redcar and Cleveland 001,E02002515,6173,1009,5164
2021,Redcar and Cleveland 002,E02002516,5490,1104,4386
2021,Redcar and Cleveland 003,E02002517,4998,989,4009
2021,Redcar and Cleveland 004,E02002518,10378,1746,8632
2021,Redcar and Cleveland 005,E02002519,7064,1417,5647
2021,Redcar and Cleveland 006,E02002520,12590,2115,10475
2021,Redcar and Cleveland 007,E02002521,5708,825,4883
2021,Redcar and Cleveland 009,E02002523,5819,1543,4276
2021,Redcar and Cleveland 010,E02002524,5155,945,4210
2021,Redcar and Cleveland 011,E02002525,7636,1218,6418
2021,Redcar and Cleveland 012,E02002526,7323,1341,5982
2021,Redcar and Cleveland 013,E02002527,4753,978,3775
2021,Redcar and Cleveland 015,E02002529,5448,981,4467
2021,Redcar and Cleveland 016,E02002530,5913,914,4999
2021,Redcar and Cleveland 018,E02002532,6383,1106,5277
2021,Redcar and Cleveland 019,E02002533,6269,1105,5164
2021,Redcar and Cleveland 020,E02002534,5392,728,4664
2021,Stockton-on-Tees 001,E02002535,8778,1426,7352
2021,Stockton-on-Tees 002,E02002536,8847,1721,7126
2021,Stockton-on-Tees 003,E02002537,7780,1710,6070
2021,Stockton-on-Tees 004,E02002538,5354,1010,4344
2021,Stockton-on-Tees 005,E02002539,10026,1827,8199
2021,Stockton-on-Tees 006,E02002540,5809,859,4950
2021,Stockton-on-Tees 007,E02002541,5730,941,4789
2021,Stockton-on-Tees 008,E02002542,7550,1663,5887
2021,Stockton-on-Tees 009,E02002543,8578,2007,6571
2021,Stockton-on-Tees 010,E02002544,8475,1425,7050
2021,Stockton-on-Tees 011,E02002545,4812,723,4089
2021,Stockton-on-Tees 012,E02002546,6992,1598,5394
2021,Stockton-on-Tees 013,E02002547,5848,942,4906
2021,Stockton-on-Tees 015,E02002549,7154,1151,6003
2021,Stockton-on-Tees 016,E02002550,5731,1051,4680
2021,Stockton-on-Tees 017,E02002551,5042,1011,4031
2021,Stockton-on-Tees 018,E02002552,6733,1546,5187
2021,Stockton-on-Tees 019,E02002553,5487,1114,4373
2021,Stockton-on-Tees 020,E02002554,4790,901,3889
2021,Stockton-on-Tees 021,E02002555,9837,2064,7773
2021,Stockton-on-Tees 022,E02002556,6941,1314,5627
2021,Stockton-on-Tees 024,E02002558,10516,1774,8742
2021,Darlington 001,E02002559,9197,1718,7479
2021,Darlington 002,E02002560,5941,1181,4760
2021,Darlington 003,E02002561,5216,817,4399
2021,Darlington 004,E02002562,5319,896,4423
2021,Darlington 005,E02002563,5318,908,4410
2021,Darlington 006,E02002564,9197,1840,7357
2021,Darlington 009,E02002567,8721,1864,6857
2021,Darlington 010,E02002568,5817,1085,4732
2021,Darlington 011,E02002569,8822,1441,7381
2021,Darlington 012,E02002570,7126,1181,5945
2021,Darlington 013,E02002571,5927,1222,4705
2021,Darlington 014,E02002572,5891,1281,4610
2021,Darlington 015,E02002573,8944,1638,7306
2021,Halton 001,E02002574,8217,1448,6769
2021,Halton 002,E02002575,9082,1773,7309
2021,Halton 003,E02002576,7070,1179,5891
2021,Halton 004,E02002577,6848,1460,5388
2021,Halton 005,E02002578,7973,1652,6321
2021,Halton 006,E02002579,7398,1517,5881
2021,Halton 007,E02002580,7337,1456,5881
2021,Halton 008,E02002581,6768,1057,5711
2021,Halton 009,E02002582,8855,1627,7228
2021,Halton 010,E02002583,7143,1630,5513
2021,Halton 011,E02002584,6940,1353,5587
2021,Halton 012,E02002585,10075,1645,8430
2021,Halton 013,E02002586,8933,1911,7022
2021,Halton 014,E02002587,6094,1222,4872
2021,Halton 015,E02002588,6777,1346,5431
2021,Halton 016,E02002589,6014,884,5130
2021,Warrington 001,E02002590,7046,1102,5944
2021,Warrington 002,E02002591,6218,1072,5146
2021,Warrington 003,E02002592,5966,982,4984
2021,Warrington 004,E02002593,4848,804,4044
2021,Warrington 005,E02002594,5241,926,4315
2021,Warrington 006,E02002595,7532,1668,5864
2021,Warrington 007,E02002596,7703,1303,6400
2021,Warrington 008,E02002597,8629,1949,6680
2021,Warrington 009,E02002598,10488,2312,8176
2021,Warrington 010,E02002599,10569,2089,8480
2021,Warrington 011,E02002600,8663,1456,7207
2021,Warrington 012,E02002601,8568,1473,7095
2021,Warrington 013,E02002602,7581,1681,5900
2021,Warrington 014,E02002603,6664,1105,5559
2021,Warrington 015,E02002604,7403,1225,6178
2021,Warrington 016,E02002605,8526,1670,6856
2021,Warrington 017,E02002606,10619,1764,8855
2021,Warrington 018,E02002607,10640,1545,9095
2021,Warrington 019,E02002608,7912,1209,6703
2021,Warrington 020,E02002609,9028,1804,7224
2021,Warrington 021,E02002610,12098,2546,9552
2021,Warrington 022,E02002611,7446,1389,6057
2021,Warrington 023,E02002612,8756,1601,7155
2021,Warrington 024,E02002613,6573,1124,5449
2021,Warrington 025,E02002614,5628,992,4636
2021,Blackburn with Darwen 001,E02002615,9992,2439,7553
2021,Blackburn with Darwen 002,E02002616,8878,2526,6352
2021,Blackburn with Darwen 003,E02002617,8992,2853,6139
2021,Blackburn with Darwen 004,E02002618,7440,2272,5168
2021,Blackburn with Darwen 005,E02002619,8707,2426,6281
2021,Blackburn with Darwen 006,E02002620,8451,2282,6169
2021,Blackburn with Darwen 007,E02002621,7990,2456,5534
2021,Blackburn with Darwen 008,E02002622,10213,3109,7104
2021,Blackburn with Darwen 009,E02002623,9652,2216,7436
2021,Blackburn with Darwen 010,E02002624,8334,1448,6886
2021,Blackburn with Darwen 011,E02002625,9387,2310,7077
2021,Blackburn with Darwen 012,E02002626,6890,1452,5438
2021,Blackburn with Darwen 013,E02002627,7134,1572,5562
2021,Blackburn with Darwen 014,E02002628,6484,1164,5320
2021,Blackburn with Darwen 015,E02002629,5577,1197,4380
2021,Blackburn with Darwen 016,E02002630,5985,1172,4813
2021,Blackburn with Darwen 017,E02002631,8496,1407,7089
2021,Blackburn with Darwen 018,E02002632,6078,989,5089
2021,Blackpool 001,E02002633,7333,1153,6180
2021,Blackpool 002,E02002634,7678,1113,6565
2021,Blackpool 003,E02002635,7478,1122,6356
2021,Blackpool 004,E02002636,7576,1354,6222
2021,Blackpool 005,E02002637,5906,1025,4881
2021,Blackpool 006,E02002638,6223,996,5227
2021,Blackpool 007,E02002639,5707,1358,4349
2021,Blackpool 008,E02002640,6595,1423,5172
2021,Blackpool 009,E02002641,7540,1276,6264
2021,Blackpool 010,E02002642,6706,1164,5542
2021,Blackpool 011,E02002643,7258,1554,5704
2021,Blackpool 012,E02002644,7433,1299,6134
2021,Blackpool 013,E02002645,5982,1042,4940
2021,Blackpool 014,E02002646,6711,1157,5554
2021,Blackpool 015,E02002647,7523,1474,6049
2021,Blackpool 016,E02002648,6665,1327,5338
2021,Blackpool 017,E02002649,7956,1321,6635
2021,Blackpool 018,E02002650,7884,1156,6728
2021,Blackpool 019,E02002651,7515,1260,6255
2021,Kingston upon Hull 002,E02002653,7615,1883,5732
2021,Kingston upon Hull 003,E02002654,7519,2234,5285
2021,Kingston upon Hull 004,E02002655,8161,1963,6198
2021,Kingston upon Hull 005,E02002656,4912,569,4343
2021,Kingston upon Hull 006,E02002657,7133,1278,5855
2021,Kingston upon Hull 007,E02002658,6283,936,5347
2021,Kingston upon Hull 008,E02002659,10505,2626,7879
2021,Kingston upon Hull 009,E02002660,6589,1360,5229
2021,Kingston upon Hull 010,E02002661,7968,1786,6182
2021,Kingston upon Hull 011,E02002662,6992,1298,5694
2021,Kingston upon Hull 012,E02002663,7861,4270,3591
2021,Kingston upon Hull 013,E02002664,6884,1228,5656
2021,Kingston upon Hull 014,E02002665,7561,1478,6083
2021,Kingston upon Hull 015,E02002666,7727,2041,5686
2021,Kingston upon Hull 016,E02002667,6900,1161,5739
2021,Kingston upon Hull 017,E02002668,7801,1895,5906
2021,Kingston upon Hull 018,E02002669,7625,1865,5760
2021,Kingston upon Hull 019,E02002670,7481,1458,6023
2021,Kingston upon Hull 020,E02002671,8494,1587,6907
2021,Kingston upon Hull 021,E02002672,6717,1790,4927
2021,Kingston upon Hull 022,E02002673,7056,1223,5833
2021,Kingston upon Hull 023,E02002674,6226,989,5237
2021,Kingston upon Hull 024,E02002675,8026,1738,6288
2021,Kingston upon Hull 025,E02002676,6872,1257,5615
2021,Kingston upon Hull 026,E02002677,7834,1326,6508
2021,Kingston upon Hull 027,E02002678,7988,1560,6428
2021,Kingston upon Hull 028,E02002679,7339,1299,6040
2021,Kingston upon Hull 029,E02002680,9244,1564,7680
2021,Kingston upon Hull 030,E02002681,8466,1788,6678
2021,Kingston upon Hull 031,E02002682,9953,2139,7814
2021,East Riding of Yorkshire 001,E02002684,9794,1129,8665
2021,East Riding of Yorkshire 002,E02002685,7564,963,6601
2021,East Riding of Yorkshire 003,E02002686,7315,1453,5862
2021,East Riding of Yorkshire 004,E02002687,5642,830,4812
2021,East Riding of Yorkshire 005,E02002688,5189,809,4380
2021,East Riding of Yorkshire 006,E02002689,5527,784,4743
2021,East Riding of Yorkshire 008,E02002691,7967,1248,6719
2021,East Riding of Yorkshire 009,E02002692,9234,1364,7870
2021,East Riding of Yorkshire 010,E02002693,6771,923,5848
2021,East Riding of Yorkshire 011,E02002694,12203,1943,10260
2021,East Riding of Yorkshire 012,E02002695,7934,1143,6791
2021,East Riding of Yorkshire 013,E02002696,6043,981,5062
2021,East Riding of Yorkshire 014,E02002697,7275,1165,6110
2021,East Riding of Yorkshire 015,E02002698,8104,1377,6727
2021,East Riding of Yorkshire 016,E02002699,9437,1595,7842
2021,East Riding of Yorkshire 017,E02002700,5709,1178,4531
2021,East Riding of Yorkshire 018,E02002701,8302,1321,6981
2021,East Riding of Yorkshire 019,E02002702,9397,1184,8213
2021,East Riding of Yorkshire 020,E02002703,8952,1687,7265
2021,East Riding of Yorkshire 021,E02002704,6910,976,5934
2021,East Riding of Yorkshire 022,E02002705,6753,1054,5699
2021,East Riding of Yorkshire 023,E02002706,6933,1097,5836
2021,East Riding of Yorkshire 024,E02002707,6517,1061,5456
2021,East Riding of Yorkshire 025,E02002708,5597,749,4848
2021,East Riding of Yorkshire 026,E02002709,8014,1142,6872
2021,East Riding of Yorkshire 027,E02002710,6922,1173,5749
2021,East Riding of Yorkshire 028,E02002711,7558,1229,6329
2021,East Riding of Yorkshire 029,E02002712,7055,1005,6050
2021,East Riding of Yorkshire 031,E02002714,7559,1133,6426
2021,East Riding of Yorkshire 032,E02002715,12895,2666,10229
2021,East Riding of Yorkshire 033,E02002716,8091,1391,6700
2021,East Riding of Yorkshire 034,E02002717,7508,1303,6205
2021,East Riding of Yorkshire 035,E02002718,7735,1380,6355
2021,East Riding of Yorkshire 036,E02002719,6404,1016,5388
2021,East Riding of Yorkshire 037,E02002720,7283,1131,6152
2021,East Riding of Yorkshire 038,E02002721,6371,976,5395
2021,East Riding of Yorkshire 039,E02002722,8116,1298,6818
2021,East Riding of Yorkshire 040,E02002723,8027,1280,6747
2021,East Riding of Yorkshire 041,E02002724,8993,1880,7113
2021,East Riding of Yorkshire 042,E02002725,6599,1103,5496
2021,North East Lincolnshire 001,E02002726,9870,1834,8036
2021,North East Lincolnshire 002,E02002727,4640,871,3769
2021,North East Lincolnshire 003,E02002728,7026,1348,5678
2021,North East Lincolnshire 004,E02002729,5354,955,4399
2021,North East Lincolnshire 005,E02002730,6580,1619,4961
2021,North East Lincolnshire 006,E02002731,5179,1265,3914
2021,North East Lincolnshire 007,E02002732,7587,1348,6239
2021,North East Lincolnshire 008,E02002733,5466,885,4581
2021,North East Lincolnshire 009,E02002734,5227,982,4245
2021,North East Lincolnshire 011,E02002736,5175,1198,3977
2021,North East Lincolnshire 012,E02002737,6732,1187,5545
2021,North East Lincolnshire 013,E02002738,6526,1202,5324
2021,North East Lincolnshire 014,E02002739,5453,946,4507
2021,North East Lincolnshire 015,E02002740,5139,1053,4086
2021,North East Lincolnshire 016,E02002741,8465,1729,6736
2021,North East Lincolnshire 018,E02002743,5221,776,4445
2021,North East Lincolnshire 019,E02002744,6431,1687,4744
2021,North East Lincolnshire 020,E02002745,6963,901,6062
2021,North East Lincolnshire 021,E02002746,9334,1759,7575
2021,North East Lincolnshire 022,E02002747,8822,1477,7345
2021,North East Lincolnshire 023,E02002748,7655,1064,6591
2021,North Lincolnshire 001,E02002749,11309,1834,9475
2021,North Lincolnshire 002,E02002750,6122,1026,5096
2021,North Lincolnshire 003,E02002751,6087,1079,5008
2021,North Lincolnshire 004,E02002752,6761,1185,5576
2021,North Lincolnshire 005,E02002753,8111,1081,7030
2021,North Lincolnshire 006,E02002754,7875,1371,6504
2021,North Lincolnshire 007,E02002755,7047,1280,5767
2021,North Lincolnshire 008,E02002756,8422,1854,6568
2021,North Lincolnshire 009,E02002757,5947,1221,4726
2021,North Lincolnshire 010,E02002758,6013,1190,4823
2021,North Lincolnshire 011,E02002759,9203,1431,7772
2021,North Lincolnshire 012,E02002760,5496,959,4537
2021,North Lincolnshire 013,E02002761,6186,961,5225
2021,North Lincolnshire 014,E02002762,6086,1180,4906
2021,North Lincolnshire 015,E02002763,8191,1808,6383
2021,North Lincolnshire 016,E02002764,5559,1444,4115
2021,North Lincolnshire 017,E02002765,5803,1105,4698
2021,North Lincolnshire 018,E02002766,8476,1704,6772
2021,North Lincolnshire 019,E02002767,6367,923,5444
2021,North Lincolnshire 020,E02002768,7180,1218,5962
2021,North Lincolnshire 021,E02002769,5414,776,4638
2021,North Lincolnshire 022,E02002770,6744,1058,5686
2021,North Lincolnshire 023,E02002771,6836,1019,5817
2021,York 001,E02002772,6632,1361,5271
2021,York 002,E02002773,5452,809,4643
2021,York 003,E02002774,5847,959,4888
2021,York 004,E02002775,5509,891,4618
2021,York 005,E02002776,6370,1006,5364
2021,York 006,E02002777,8469,1457,7012
2021,York 007,E02002778,7580,1316,6264
2021,York 008,E02002779,9170,1812,7358
2021,York 009,E02002780,7694,2050,5644
2021,York 010,E02002781,9686,3292,6394
2021,York 011,E02002782,6193,1288,4905
2021,York 012,E02002783,9768,1845,7923
2021,York 013,E02002784,11028,3335,7693
2021,York 014,E02002785,7734,2150,5584
2021,York 015,E02002786,9786,4412,5374
2021,York 016,E02002787,8433,1360,7073
2021,York 017,E02002788,7894,1401,6493
2021,York 018,E02002789,8654,1857,6797
2021,York 019,E02002790,11394,4274,7120
2021,York 020,E02002791,6361,1246,5115
2021,York 021,E02002792,7420,1391,6029
2021,York 022,E02002793,8825,1423,7402
2021,York 023,E02002794,10320,6380,3940
2021,York 024,E02002795,7993,1467,6526
2021,Derby 001,E02002796,5907,1128,4779
2021,Derby 002,E02002797,7089,1163,5926
2021,Derby 003,E02002798,9879,1678,8201
2021,Derby 004,E02002799,5943,1444,4499
2021,Derby 005,E02002800,6711,1437,5274
2021,Derby 006,E02002801,7095,1314,5781
2021,Derby 007,E02002802,7456,1733,5723
2021,Derby 008,E02002803,7975,3058,4917
2021,Derby 009,E02002804,8530,1924,6606
2021,Derby 010,E02002805,5382,827,4555
2021,Derby 011,E02002806,6099,2043,4056
2021,Derby 012,E02002807,8526,1623,6903
2021,Derby 013,E02002808,11582,3121,8461
2021,Derby 014,E02002809,6679,1254,5425
2021,Derby 015,E02002810,8632,1483,7149
2021,Derby 016,E02002811,10098,2649,7449
2021,Derby 017,E02002812,7437,1482,5955
2021,Derby 018,E02002813,10606,2795,7811
2021,Derby 019,E02002814,6896,1090,5806
2021,Derby 020,E02002815,8154,2447,5707
2021,Derby 021,E02002816,8895,2102,6793
2021,Derby 022,E02002817,5956,1148,4808
2021,Derby 023,E02002818,7935,2218,5717
2021,Derby 024,E02002819,7136,1255,5881
2021,Derby 025,E02002820,9157,1933,7224
2021,Derby 026,E02002821,11548,3127,8421
2021,Derby 027,E02002822,6490,1325,5165
2021,Derby 028,E02002823,7271,1342,5929
2021,Derby 029,E02002824,10069,2437,7632
2021,Derby 030,E02002825,8289,1695,6594
2021,Derby 031,E02002826,6721,1425,5296
2021,Leicester 001,E02002827,6401,1502,4899
2021,Leicester 002,E02002828,7818,1513,6305
2021,Leicester 003,E02002829,10951,2937,8014
2021,Leicester 004,E02002830,10172,2739,7433
2021,Leicester 005,E02002831,6891,1550,5341
2021,Leicester 006,E02002832,9779,2098,7681
2021,Leicester 007,E02002833,8489,1829,6660
2021,Leicester 008,E02002834,11191,2550,8641
2021,Leicester 010,E02002836,10654,2250,8404
2021,Leicester 011,E02002837,9288,2692,6596
2021,Leicester 012,E02002838,8004,2440,5564
2021,Leicester 013,E02002839,7969,1887,6082
2021,Leicester 016,E02002842,8087,2174,5913
2021,Leicester 017,E02002843,14714,3829,10885
2021,Leicester 018,E02002844,11551,3711,7840
2021,Leicester 019,E02002845,10420,2672,7748
2021,Leicester 020,E02002846,7143,1299,5844
2021,Leicester 021,E02002847,9997,2772,7225
2021,Leicester 022,E02002848,10353,3204,7149
2021,Leicester 023,E02002849,13115,4940,8175
2021,Leicester 025,E02002851,8309,1862,6447
2021,Leicester 026,E02002852,6925,2147,4778
2021,Leicester 027,E02002853,12590,3958,8632
2021,Leicester 028,E02002854,7940,2057,5883
2021,Leicester 029,E02002855,7647,2070,5577
2021,Leicester 030,E02002856,10878,3581,7297
2021,Leicester 031,E02002857,6737,1539,5198
2021,Leicester 032,E02002858,6990,1431,5559
2021,Leicester 034,E02002860,7905,1537,6368
2021,Leicester 035,E02002861,7701,2303,5398
2021,Leicester 036,E02002862,8069,2011,6058
2021,Rutland 001,E02002863,8558,1188,7370
2021,Rutland 002,E02002864,7860,1401,6459
2021,Rutland 003,E02002865,7600,1486,6114
2021,Rutland 004,E02002866,7201,1250,5951
2021,Rutland 005,E02002867,8187,1778,6409
2021,Nottingham 001,E02002868,5674,1050,4624
2021,Nottingham 002,E02002869,6978,1544,5434
2021,Nottingham 004,E02002871,7484,1447,6037
2021,Nottingham 005,E02002872,8136,1811,6325
2021,Nottingham 006,E02002873,8756,2141,6615
2021,Nottingham 007,E02002874,7655,1608,6047
2021,Nottingham 008,E02002875,7896,1872,6024
2021,Nottingham 009,E02002876,7534,1709,5825
2021,Nottingham 010,E02002877,7352,1278,6074
2021,Nottingham 011,E02002878,8576,2920,5656
2021,Nottingham 012,E02002879,9262,2239,7023
2021,Nottingham 013,E02002880,8116,2437,5679
2021,Nottingham 014,E02002881,6382,1611,4771
2021,Nottingham 015,E02002882,8378,2024,6354
2021,Nottingham 016,E02002883,7172,1446,5726
2021,Nottingham 017,E02002884,6845,1813,5032
2021,Nottingham 018,E02002885,7974,2735,5239
2021,Nottingham 019,E02002886,9478,2567,6911
2021,Nottingham 020,E02002887,6329,1415,4914
2021,Nottingham 021,E02002888,7090,1732,5358
2021,Nottingham 022,E02002889,11158,8341,2817
2021,Nottingham 023,E02002890,11193,6134,5059
2021,Nottingham 024,E02002891,7978,1819,6159
2021,Nottingham 025,E02002892,5835,1356,4479
2021,Nottingham 026,E02002893,13278,8018,5260
2021,Nottingham 028,E02002895,9456,5512,3944
2021,Nottingham 029,E02002896,9418,2422,6996
2021,Nottingham 030,E02002897,7523,1636,5887
2021,Nottingham 031,E02002898,10738,7771,2967
2021,Nottingham 034,E02002901,5845,1087,4758
2021,Nottingham 035,E02002902,8922,2925,5997
2021,Nottingham 036,E02002903,5582,1087,4495
2021,Nottingham 037,E02002904,6008,1313,4695
2021,Herefordshire 001,E02002905,6060,845,5215
2021,Herefordshire 002,E02002906,5317,883,4434
2021,Herefordshire 003,E02002907,5961,915,5046
2021,Herefordshire 004,E02002908,8502,1206,7296
2021,Herefordshire 005,E02002909,10290,1422,8868
2021,Herefordshire 006,E02002910,7542,1028,6514
2021,Herefordshire 007,E02002911,9130,1473,7657
2021,Herefordshire 008,E02002912,7238,1219,6019
2021,Herefordshire 009,E02002913,5626,748,4878
2021,Herefordshire 010,E02002914,8546,1440,7106
2021,Herefordshire 011,E02002915,7563,1211,6352
2021,Herefordshire 012,E02002916,9279,1567,7712
2021,Herefordshire 013,E02002917,6545,1047,5498
2021,Herefordshire 014,E02002918,5546,1019,4527
2021,Herefordshire 015,E02002919,8486,1600,6886
2021,Herefordshire 016,E02002920,6199,982,5217
2021,Herefordshire 017,E02002921,7282,1609,5673
2021,Herefordshire 018,E02002922,6347,998,5349
2021,Herefordshire 019,E02002923,9082,1341,7741
2021,Herefordshire 020,E02002924,5826,957,4869
2021,Herefordshire 021,E02002925,10346,1688,8658
2021,Herefordshire 022,E02002926,10514,1577,8937
2021,Herefordshire 023,E02002927,11377,1592,9785
2021,Telford and Wrekin 001,E02002928,5831,1363,4468
2021,Telford and Wrekin 002,E02002929,6436,1662,4774
2021,Telford and Wrekin 003,E02002930,6660,1608,5052
2021,Telford and Wrekin 004,E02002931,6325,1160,5165
2021,Telford and Wrekin 005,E02002932,8417,1884,6533
2021,Telford and Wrekin 006,E02002933,7654,1268,6386
2021,Telford and Wrekin 007,E02002934,5864,1114,4750
2021,Telford and Wrekin 008,E02002935,6373,1062,5311
2021,Telford and Wrekin 009,E02002936,10332,2435,7897
2021,Telford and Wrekin 010,E02002937,10301,1589,8712
2021,Telford and Wrekin 011,E02002938,6867,1522,5345
2021,Telford and Wrekin 012,E02002939,7168,1155,6013
2021,Telford and Wrekin 013,E02002940,5569,866,4703
2021,Telford and Wrekin 014,E02002941,9905,1705,8200
2021,Telford and Wrekin 015,E02002942,7579,1750,5829
2021,Telford and Wrekin 017,E02002944,7792,1696,6096
2021,Telford and Wrekin 018,E02002945,8949,1907,7042
2021,Telford and Wrekin 019,E02002946,7163,1127,6036
2021,Telford and Wrekin 020,E02002947,6625,1591,5034
2021,Telford and Wrekin 021,E02002948,7006,1945,5061
2021,Telford and Wrekin 022,E02002949,5113,732,4381
2021,Telford and Wrekin 023,E02002950,5490,1237,4253
2021,Stoke-on-Trent 001,E02002951,7462,1357,6105
2021,Stoke-on-Trent 002,E02002952,7051,1514,5537
2021,Stoke-on-Trent 003,E02002953,6931,1381,5550
2021,Stoke-on-Trent 004,E02002954,7789,1566,6223
2021,Stoke-on-Trent 005,E02002955,6826,1624,5202
2021,Stoke-on-Trent 006,E02002956,8699,1932,6767
2021,Stoke-on-Trent 007,E02002957,9119,1543,7576
2021,Stoke-on-Trent 008,E02002958,7988,1627,6361
2021,Stoke-on-Trent 009,E02002959,8386,1919,6467
2021,Stoke-on-Trent 010,E02002960,5467,936,4531
2021,Stoke-on-Trent 011,E02002961,6755,1608,5147
2021,Stoke-on-Trent 012,E02002962,7325,1708,5617
2021,Stoke-on-Trent 013,E02002963,6672,1220,5452
2021,Stoke-on-Trent 014,E02002964,8192,1447,6745
2021,Stoke-on-Trent 015,E02002965,7737,2397,5340
2021,Stoke-on-Trent 016,E02002966,9629,3614,6015
2021,Stoke-on-Trent 017,E02002967,9674,2547,7127
2021,Stoke-on-Trent 018,E02002968,8954,1902,7052
2021,Stoke-on-Trent 019,E02002969,8869,2086,6783
2021,Stoke-on-Trent 020,E02002970,7400,1432,5968
2021,Stoke-on-Trent 023,E02002973,7667,1718,5949
2021,Stoke-on-Trent 024,E02002974,5823,1002,4821
2021,Stoke-on-Trent 025,E02002975,6790,1050,5740
2021,Stoke-on-Trent 026,E02002976,5657,1211,4446
2021,Stoke-on-Trent 027,E02002977,5350,871,4479
2021,Stoke-on-Trent 028,E02002978,6312,1462,4850
2021,Stoke-on-Trent 029,E02002979,5582,1461,4121
2021,Stoke-on-Trent 030,E02002980,5758,993,4765
2021,Stoke-on-Trent 031,E02002981,8038,2024,6014
2021,Stoke-on-Trent 032,E02002982,8135,2007,6128
2021,Stoke-on-Trent 033,E02002983,5079,885,4194
2021,Stoke-on-Trent 034,E02002984,5258,826,4432
2021,Bath and North East Somerset 001,E02002985,6368,1134,5234
2021,Bath and North East Somerset 002,E02002986,6514,1115,5399
2021,Bath and North East Somerset 003,E02002987,5504,920,4584
2021,Bath and North East Somerset 004,E02002988,5317,1062,4255
2021,Bath and North East Somerset 005,E02002989,5288,1119,4169
2021,Bath and North East Somerset 006,E02002990,5599,1166,4433
2021,Bath and North East Somerset 007,E02002991,10697,2692,8005
2021,Bath and North East Somerset 008,E02002992,5496,1334,4162
2021,Bath and North East Somerset 009,E02002993,5855,2059,3796
2021,Bath and North East Somerset 010,E02002994,10152,2165,7987
2021,Bath and North East Somerset 011,E02002995,5400,1335,4065
2021,Bath and North East Somerset 012,E02002996,11494,5830,5664
2021,Bath and North East Somerset 013,E02002997,8063,3888,4175
2021,Bath and North East Somerset 014,E02002998,5747,2432,3315
2021,Bath and North East Somerset 015,E02002999,5356,1225,4131
2021,Bath and North East Somerset 016,E02003000,9193,1529,7664
2021,Bath and North East Somerset 017,E02003001,5342,1240,4102
2021,Bath and North East Somerset 018,E02003002,5934,1521,4413
2021,Bath and North East Somerset 019,E02003003,5576,1350,4226
2021,Bath and North East Somerset 020,E02003004,6978,1239,5739
2021,Bath and North East Somerset 021,E02003005,6437,1224,5213
2021,Bath and North East Somerset 022,E02003006,9584,2792,6792
2021,Bath and North East Somerset 023,E02003007,9015,1645,7370
2021,Bath and North East Somerset 024,E02003008,5732,1152,4580
2021,Bath and North East Somerset 025,E02003009,5887,996,4891
2021,Bath and North East Somerset 026,E02003010,6188,1211,4977
2021,Bath and North East Somerset 027,E02003011,5672,1034,4638
2021,Bristol 001,E02003012,11291,2328,8963
2021,Bristol 002,E02003013,12014,2783,9231
2021,Bristol 003,E02003014,7806,1933,5873
2021,Bristol 004,E02003015,6431,1354,5077
2021,Bristol 005,E02003016,7642,2229,5413
2021,Bristol 006,E02003017,5980,1143,4837
2021,Bristol 007,E02003018,5829,1178,4651
2021,Bristol 008,E02003019,9644,1711,7933
2021,Bristol 009,E02003020,6177,1402,4775
2021,Bristol 010,E02003021,7044,2108,4936
2021,Bristol 011,E02003022,5873,1298,4575
2021,Bristol 012,E02003023,6372,1737,4635
2021,Bristol 013,E02003024,9457,2263,7194
2021,Bristol 014,E02003025,7293,1813,5480
2021,Bristol 015,E02003026,9919,3830,6089
2021,Bristol 016,E02003027,12429,3363,9066
2021,Bristol 017,E02003028,8421,2150,6271
2021,Bristol 018,E02003029,6281,1556,4725
2021,Bristol 019,E02003030,7465,1654,5811
2021,Bristol 020,E02003031,10095,2948,7147
2021,Bristol 021,E02003032,7888,1718,6170
2021,Bristol 022,E02003033,8583,3494,5089
2021,Bristol 025,E02003036,8431,3070,5361
2021,Bristol 026,E02003037,8922,3074,5848
2021,Bristol 027,E02003038,6456,1104,5352
2021,Bristol 028,E02003039,8304,1548,6756
2021,Bristol 029,E02003040,9257,1235,8022
2021,Bristol 030,E02003041,6054,1633,4421
2021,Bristol 033,E02003044,5799,929,4870
2021,Bristol 034,E02003045,6770,2531,4239
2021,Bristol 035,E02003046,9329,1558,7771
2021,Bristol 036,E02003047,10531,1848,8683
2021,Bristol 037,E02003048,6454,961,5493
2021,Bristol 038,E02003049,7389,1275,6114
2021,Bristol 039,E02003050,9678,1182,8496
2021,Bristol 040,E02003051,7042,1419,5623
2021,Bristol 041,E02003052,6778,1084,5694
2021,Bristol 042,E02003053,8121,1523,6598
2021,Bristol 043,E02003054,6483,1133,5350
2021,Bristol 044,E02003055,8582,2194,6388
2021,Bristol 045,E02003056,7204,1705,5499
2021,Bristol 046,E02003057,5850,1005,4845
2021,Bristol 047,E02003058,9253,1764,7489
2021,Bristol 048,E02003059,6301,1180,5121
2021,Bristol 049,E02003060,10493,1769,8724
2021,Bristol 050,E02003061,5820,1348,4472
2021,Bristol 051,E02003062,5552,1217,4335
2021,Bristol 052,E02003063,6885,1092,5793
2021,Bristol 053,E02003064,6735,1719,5016
2021,North Somerset 001,E02003065,9324,1551,7773
2021,North Somerset 002,E02003066,5886,952,4934
2021,North Somerset 003,E02003067,7748,1662,6086
2021,North Somerset 004,E02003068,6078,1060,5018
2021,North Somerset 005,E02003069,5462,828,4634
2021,North Somerset 006,E02003070,12633,2590,10043
2021,North Somerset 007,E02003071,7668,1248,6420
2021,North Somerset 008,E02003072,8869,1361,7508
2021,North Somerset 009,E02003073,6054,1031,5023
2021,North Somerset 010,E02003074,7307,1183,6124
2021,North Somerset 011,E02003075,5916,1270,4646
2021,North Somerset 012,E02003076,9406,1707,7699
2021,North Somerset 013,E02003077,6064,1081,4983
2021,North Somerset 014,E02003078,7069,1338,5731
2021,North Somerset 015,E02003079,8812,1679,7133
2021,North Somerset 016,E02003080,8328,1356,6972
2021,North Somerset 017,E02003081,9017,1442,7575
2021,North Somerset 018,E02003082,8724,921,7803
2021,North Somerset 020,E02003084,10060,1514,8546
2021,North Somerset 021,E02003085,7262,1564,5698
2021,North Somerset 022,E02003086,5898,800,5098
2021,North Somerset 023,E02003087,10308,1730,8578
2021,North Somerset 024,E02003088,8654,1633,7021
2021,North Somerset 025,E02003089,5657,999,4658
2021,South Gloucestershire 001,E02003090,8826,1556,7270
2021,South Gloucestershire 002,E02003091,6404,1081,5323
2021,South Gloucestershire 003,E02003092,8368,1483,6885
2021,South Gloucestershire 004,E02003093,6406,1001,5405
2021,South Gloucestershire 005,E02003094,8423,1506,6917
2021,South Gloucestershire 006,E02003095,8123,1431,6692
2021,South Gloucestershire 007,E02003096,5944,991,4953
2021,South Gloucestershire 008,E02003097,6217,945,5272
2021,South Gloucestershire 009,E02003098,9443,1953,7490
2021,South Gloucestershire 010,E02003099,7209,1295,5914
2021,South Gloucestershire 012,E02003101,10081,2092,7989
2021,South Gloucestershire 013,E02003102,6797,1342,5455
2021,South Gloucestershire 014,E02003103,6695,1292,5403
2021,South Gloucestershire 015,E02003104,7151,1249,5902
2021,South Gloucestershire 016,E02003105,6122,1081,5041
2021,South Gloucestershire 018,E02003107,10733,2729,8004
2021,South Gloucestershire 019,E02003108,11868,2045,9823
2021,South Gloucestershire 020,E02003109,5857,1118,4739
2021,South Gloucestershire 021,E02003110,11580,2621,8959
2021,South Gloucestershire 022,E02003111,6359,1142,5217
2021,South Gloucestershire 023,E02003112,6160,1242,4918
2021,South Gloucestershire 024,E02003113,10006,1690,8316
2021,South Gloucestershire 025,E02003114,6794,1074,5720
2021,South Gloucestershire 026,E02003115,9155,1613,7542
2021,South Gloucestershire 027,E02003116,7316,1246,6070
2021,South Gloucestershire 028,E02003117,8833,1528,7305
2021,South Gloucestershire 029,E02003118,9400,1540,7860
2021,South Gloucestershire 030,E02003119,9798,1832,7966
2021,South Gloucestershire 031,E02003120,8730,1441,7289
2021,South Gloucestershire 032,E02003121,9670,1439,8231
2021,Plymouth 001,E02003122,6990,1127,5863
2021,Plymouth 002,E02003123,8169,1699,6470
2021,Plymouth 003,E02003124,7750,1623,6127
2021,Plymouth 004,E02003125,5715,971,4744
2021,Plymouth 005,E02003126,8038,1843,6195
2021,Plymouth 006,E02003127,7132,1499,5633
2021,Plymouth 007,E02003128,8615,1593,7022
2021,Plymouth 008,E02003129,6076,1109,4967
2021,Plymouth 009,E02003130,9978,2065,7913
2021,Plymouth 010,E02003131,6933,1273,5660
2021,Plymouth 011,E02003132,8352,1675,6677
2021,Plymouth 012,E02003133,6797,1200,5597
2021,Plymouth 013,E02003134,6502,1357,5145
2021,Plymouth 014,E02003135,6608,1392,5216
2021,Plymouth 015,E02003136,7480,1226,6254
2021,Plymouth 016,E02003137,7534,1385,6149
2021,Plymouth 017,E02003138,7130,1525,5605
2021,Plymouth 018,E02003139,6311,1249,5062
2021,Plymouth 019,E02003140,7448,1456,5992
2021,Plymouth 020,E02003141,7537,1283,6254
2021,Plymouth 021,E02003142,8705,1723,6982
2021,Plymouth 022,E02003143,6957,1222,5735
2021,Plymouth 023,E02003144,8289,3610,4679
2021,Plymouth 024,E02003145,6384,1290,5094
2021,Plymouth 025,E02003146,8178,2348,5830
2021,Plymouth 026,E02003147,8528,1796,6732
2021,Plymouth 027,E02003148,10989,5106,5883
2021,Plymouth 028,E02003149,8895,2344,6551
2021,Plymouth 030,E02003151,8052,1414,6638
2021,Plymouth 031,E02003152,10747,1961,8786
2021,Plymouth 032,E02003153,7074,1246,5828
2021,Torbay 001,E02003154,6899,1384,5515
2021,Torbay 002,E02003155,5658,845,4813
2021,Torbay 003,E02003156,10031,2021,8010
2021,Torbay 004,E02003157,6454,1218,5236
2021,Torbay 005,E02003158,5527,913,4614
2021,Torbay 006,E02003159,5666,1093,4573
2021,Torbay 008,E02003161,7404,1054,6350
2021,Torbay 010,E02003163,7950,611,7339
2021,Torbay 011,E02003164,8682,1331,7351
2021,Torbay 012,E02003165,6961,1228,5733
2021,Torbay 013,E02003166,12161,2599,9562
2021,Torbay 014,E02003167,9493,1148,8345
2021,Torbay 015,E02003168,6866,988,5878
2021,Torbay 016,E02003169,6450,794,5656
2021,Torbay 017,E02003170,9172,1129,8043
2021,Torbay 018,E02003171,7095,1069,6026
2021,"Bournemouth, Christchurch and Poole 003",E02003172,6168,1106,5062
2021,"Bournemouth, Christchurch and Poole 005",E02003173,6518,967,5551
2021,"Bournemouth, Christchurch and Poole 006",E02003174,7919,1386,6533
2021,"Bournemouth, Christchurch and Poole 007",E02003175,8880,1903,6977
2021,"Bournemouth, Christchurch and Poole 010",E02003176,7035,1557,5478
2021,"Bournemouth, Christchurch and Poole 009",E02003177,7964,1781,6183
2021,"Bournemouth, Christchurch and Poole 011",E02003178,8320,2067,6253
2021,"Bournemouth, Christchurch and Poole 012",E02003179,6165,1232,4933
2021,"Bournemouth, Christchurch and Poole 015",E02003180,9623,3809,5814
2021,"Bournemouth, Christchurch and Poole 017",E02003181,8414,2162,6252
2021,"Bournemouth, Christchurch and Poole 020",E02003182,6268,1254,5014
2021,"Bournemouth, Christchurch and Poole 028",E02003183,7103,2048,5055
2021,"Bournemouth, Christchurch and Poole 027",E02003184,7655,2219,5436
2021,"Bournemouth, Christchurch and Poole 026",E02003185,7190,1428,5762
2021,"Bournemouth, Christchurch and Poole 025",E02003186,8863,2040,6823
2021,"Bournemouth, Christchurch and Poole 035",E02003187,8983,2013,6970
2021,"Bournemouth, Christchurch and Poole 038",E02003188,12765,3838,8927
2021,"Bournemouth, Christchurch and Poole 036",E02003189,8186,1267,6919
2021,"Bournemouth, Christchurch and Poole 037",E02003190,9829,1454,8375
2021,"Bournemouth, Christchurch and Poole 039",E02003191,8054,1151,6903
2021,"Bournemouth, Christchurch and Poole 041",E02003192,12703,4342,8361
2021,"Bournemouth, Christchurch and Poole 001",E02003194,6112,1277,4835
2021,"Bournemouth, Christchurch and Poole 008",E02003195,5602,1041,4561
2021,"Bournemouth, Christchurch and Poole 004",E02003196,9998,1614,8384
2021,"Bournemouth, Christchurch and Poole 013",E02003197,6477,1206,5271
2021,"Bournemouth, Christchurch and Poole 016",E02003198,7121,1352,5769
2021,"Bournemouth, Christchurch and Poole 021",E02003199,8967,1451,7516
2021,"Bournemouth, Christchurch and Poole 022",E02003200,9802,1981,7821
2021,"Bournemouth, Christchurch and Poole 023",E02003201,10466,1890,8576
2021,"Bournemouth, Christchurch and Poole 029",E02003202,5827,1157,4670
2021,"Bournemouth, Christchurch and Poole 032",E02003203,7165,1223,5942
2021,"Bournemouth, Christchurch and Poole 030",E02003204,8843,1468,7375
2021,"Bournemouth, Christchurch and Poole 034",E02003205,8049,1415,6634
2021,"Bournemouth, Christchurch and Poole 043",E02003206,9568,1816,7752
2021,"Bournemouth, Christchurch and Poole 042",E02003207,6956,1357,5599
2021,"Bournemouth, Christchurch and Poole 044",E02003208,10769,1712,9057
2021,"Bournemouth, Christchurch and Poole 046",E02003209,6424,1037,5387
2021,"Bournemouth, Christchurch and Poole 047",E02003210,9363,1512,7851
2021,"Bournemouth, Christchurch and Poole 048",E02003211,8284,817,7467
2021,Swindon 001,E02003212,8052,1257,6795
2021,Swindon 003,E02003214,6222,1497,4725
2021,Swindon 004,E02003215,6452,865,5587
2021,Swindon 005,E02003216,9439,1514,7925
2021,Swindon 006,E02003217,6950,1441,5509
2021,Swindon 007,E02003218,6199,1339,4860
2021,Swindon 008,E02003219,12029,2506,9523
2021,Swindon 009,E02003220,9786,1512,8274
2021,Swindon 010,E02003221,6857,1276,5581
2021,Swindon 011,E02003222,5677,1055,4622
2021,Swindon 012,E02003223,10232,1863,8369
2021,Swindon 013,E02003224,8169,1210,6959
2021,Swindon 014,E02003225,6082,1025,5057
2021,Swindon 015,E02003226,9973,1981,7992
2021,Swindon 016,E02003227,6540,1655,4885
2021,Swindon 017,E02003228,7323,1461,5862
2021,Swindon 018,E02003229,5346,992,4354
2021,Swindon 019,E02003230,8236,1247,6989
2021,Swindon 020,E02003231,7987,1833,6154
2021,Swindon 021,E02003232,8158,1524,6634
2021,Swindon 022,E02003233,8233,1584,6649
2021,Swindon 023,E02003234,7974,1305,6669
2021,Swindon 024,E02003235,8830,1517,7313
2021,Swindon 025,E02003236,12115,2164,9951
2021,Peterborough 001,E02003237,5955,992,4963
2021,Peterborough 002,E02003238,5469,1026,4443
2021,Peterborough 003,E02003239,7917,1277,6640
2021,Peterborough 004,E02003240,6527,1344,5183
2021,Peterborough 005,E02003241,6789,1224,5565
2021,Peterborough 006,E02003242,8011,1275,6736
2021,Peterborough 007,E02003243,11132,2761,8371
2021,Peterborough 008,E02003244,9287,2367,6920
2021,Peterborough 009,E02003245,7655,1992,5663
2021,Peterborough 010,E02003246,9326,2157,7169
2021,Peterborough 011,E02003247,8320,1875,6445
2021,Peterborough 012,E02003248,10758,2924,7834
2021,Peterborough 013,E02003249,11862,2777,9085
2021,Peterborough 014,E02003250,11199,2350,8849
2021,Peterborough 015,E02003251,7558,1446,6112
2021,Peterborough 016,E02003252,11607,2714,8893
2021,Peterborough 017,E02003253,9614,1812,7802
2021,Peterborough 018,E02003254,8788,1418,7370
2021,Peterborough 019,E02003255,12705,2593,10112
2021,Peterborough 021,E02003257,8982,2230,6752
2021,Luton 001,E02003258,8160,1427,6733
2021,Luton 002,E02003259,6320,1459,4861
2021,Luton 003,E02003260,8201,2295,5906
2021,Luton 004,E02003261,6107,1221,4886
2021,Luton 005,E02003262,10449,2708,7741
2021,Luton 006,E02003263,12022,2935,9087
2021,Luton 007,E02003264,9254,2364,6890
2021,Luton 008,E02003265,7773,1302,6471
2021,Luton 009,E02003266,9449,2598,6851
2021,Luton 010,E02003267,13482,4341,9141
2021,Luton 011,E02003268,11902,3737,8165
2021,Luton 012,E02003269,10048,2186,7862
2021,Luton 013,E02003270,8243,1954,6289
2021,Luton 014,E02003271,9591,1904,7687
2021,Luton 015,E02003272,10398,3273,7125
2021,Luton 016,E02003273,11256,2782,8474
2021,Luton 017,E02003274,10561,3278,7283
2021,Luton 019,E02003276,8368,2569,5799
2021,Luton 020,E02003277,10829,3138,7691
2021,Luton 021,E02003278,12302,3261,9041
2021,Southend-on-Sea 001,E02003279,9005,1384,7621
2021,Southend-on-Sea 002,E02003280,9975,1807,8168
2021,Southend-on-Sea 003,E02003281,9044,1455,7589
2021,Southend-on-Sea 004,E02003282,10092,1984,8108
2021,Southend-on-Sea 005,E02003283,10368,2084,8284
2021,Southend-on-Sea 006,E02003284,10506,2127,8379
2021,Southend-on-Sea 007,E02003285,10489,2216,8273
2021,Southend-on-Sea 008,E02003286,8825,1650,7175
2021,Southend-on-Sea 009,E02003287,9626,1909,7717
2021,Southend-on-Sea 010,E02003288,12075,2492,9583
2021,Southend-on-Sea 011,E02003289,9367,1545,7822
2021,Southend-on-Sea 012,E02003290,9431,1454,7977
2021,Southend-on-Sea 013,E02003291,11078,2100,8978
2021,Southend-on-Sea 014,E02003292,11215,2255,8960
2021,Southend-on-Sea 015,E02003293,11040,2020,9020
2021,Southend-on-Sea 016,E02003294,8727,1328,7399
2021,Southend-on-Sea 017,E02003295,9582,1957,7625
2021,Thurrock 001,E02003296,6760,1146,5614
2021,Thurrock 002,E02003297,6914,1405,5509
2021,Thurrock 003,E02003298,6718,1167,5551
2021,Thurrock 004,E02003299,6122,1014,5108
2021,Thurrock 005,E02003300,8321,1612,6709
2021,Thurrock 006,E02003301,11101,2470,8631
2021,Thurrock 007,E02003302,9672,2271,7401
2021,Thurrock 008,E02003303,8839,1995,6844
2021,Thurrock 009,E02003304,9179,1987,7192
2021,Thurrock 010,E02003305,6637,1382,5255
2021,Thurrock 012,E02003307,9883,2234,7649
2021,Thurrock 013,E02003308,7076,1561,5515
2021,Thurrock 014,E02003309,7342,1395,5947
2021,Thurrock 016,E02003311,8657,1780,6877
2021,Thurrock 017,E02003312,8469,2058,6411
2021,Thurrock 018,E02003313,13598,3855,9743
2021,Medway 001,E02003314,6404,993,5411
2021,Medway 002,E02003315,5435,964,4471
2021,Medway 003,E02003316,11388,2362,9026
2021,Medway 004,E02003317,6632,1320,5312
2021,Medway 005,E02003318,5659,959,4700
2021,Medway 006,E02003319,7672,1582,6090
2021,Medway 007,E02003320,8767,1980,6787
2021,Medway 008,E02003321,6072,1358,4714
2021,Medway 009,E02003322,7522,2279,5243
2021,Medway 010,E02003323,6895,1650,5245
2021,Medway 011,E02003324,9345,2149,7196
2021,Medway 012,E02003325,6783,1655,5128
2021,Medway 013,E02003326,7270,1584,5686
2021,Medway 014,E02003327,6998,1156,5842
2021,Medway 015,E02003328,9093,2005,7088
2021,Medway 016,E02003329,6407,1473,4934
2021,Medway 017,E02003330,6337,1324,5013
2021,Medway 018,E02003331,8368,1614,6754
2021,Medway 019,E02003332,5982,1178,4804
2021,Medway 020,E02003333,6214,1389,4825
2021,Medway 021,E02003334,5775,1383,4392
2021,Medway 022,E02003335,6769,1906,4863
2021,Medway 023,E02003336,6032,1019,5013
2021,Medway 024,E02003337,7016,1300,5716
2021,Medway 025,E02003338,6865,1278,5587
2021,Medway 026,E02003339,6133,1195,4938
2021,Medway 027,E02003340,7617,1624,5993
2021,Medway 028,E02003341,6210,1111,5099
2021,Medway 029,E02003342,6099,1157,4942
2021,Medway 030,E02003343,5769,970,4799
2021,Medway 031,E02003344,6421,1312,5109
2021,Medway 032,E02003345,5845,1160,4685
2021,Medway 033,E02003346,6682,1238,5444
2021,Medway 034,E02003347,5684,1099,4585
2021,Medway 035,E02003348,7725,1292,6433
2021,Medway 036,E02003349,7005,1278,5727
2021,Medway 037,E02003350,6137,1275,4862
2021,Medway 038,E02003351,7432,1424,6008
2021,Bracknell Forest 001,E02003352,5576,975,4601
2021,Bracknell Forest 002,E02003353,11262,2064,9198
2021,Bracknell Forest 003,E02003354,9705,1834,7871
2021,Bracknell Forest 004,E02003355,6537,1357,5180
2021,Bracknell Forest 005,E02003356,6808,1389,5419
2021,Bracknell Forest 006,E02003357,9508,1791,7717
2021,Bracknell Forest 007,E02003358,11151,2139,9012
2021,Bracknell Forest 008,E02003359,5908,892,5016
2021,Bracknell Forest 009,E02003360,10856,2425,8431
2021,Bracknell Forest 010,E02003361,7007,1255,5752
2021,Bracknell Forest 011,E02003362,6290,1206,5084
2021,Bracknell Forest 012,E02003363,6836,1821,5015
2021,Bracknell Forest 013,E02003364,6658,1253,5405
2021,Bracknell Forest 014,E02003365,6610,1309,5301
2021,Bracknell Forest 015,E02003366,6776,1172,5604
2021,West Berkshire 001,E02003367,6290,1527,4763
2021,West Berkshire 002,E02003368,5440,864,4576
2021,West Berkshire 003,E02003369,6121,1255,4866
2021,West Berkshire 004,E02003370,6407,1109,5298
2021,West Berkshire 005,E02003371,5679,1007,4672
2021,West Berkshire 006,E02003372,7434,1398,6036
2021,West Berkshire 007,E02003373,8280,2128,6152
2021,West Berkshire 008,E02003374,5518,923,4595
2021,West Berkshire 009,E02003375,5875,1039,4836
2021,West Berkshire 010,E02003376,5546,857,4689
2021,West Berkshire 011,E02003377,9929,2254,7675
2021,West Berkshire 012,E02003378,7634,1240,6394
2021,West Berkshire 013,E02003379,6540,1169,5371
2021,West Berkshire 014,E02003380,7686,1236,6450
2021,West Berkshire 015,E02003381,5774,1237,4537
2021,West Berkshire 016,E02003382,7101,1324,5777
2021,West Berkshire 017,E02003383,6548,1390,5158
2021,West Berkshire 018,E02003384,6212,1055,5157
2021,West Berkshire 019,E02003385,10376,1448,8928
2021,West Berkshire 020,E02003386,7856,1428,6428
2021,West Berkshire 021,E02003387,9129,1905,7224
2021,West Berkshire 022,E02003388,5762,1160,4602
2021,Reading 001,E02003389,7619,1477,6142
2021,Reading 002,E02003390,7422,1702,5720
2021,Reading 003,E02003391,8118,1757,6361
2021,Reading 004,E02003392,8132,1473,6659
2021,Reading 005,E02003393,7694,1409,6285
2021,Reading 006,E02003394,8039,1808,6231
2021,Reading 007,E02003395,10482,1994,8488
2021,Reading 008,E02003396,9194,1700,7494
2021,Reading 009,E02003397,7704,1668,6036
2021,Reading 010,E02003398,10798,2853,7945
2021,Reading 012,E02003400,8627,3641,4986
2021,Reading 013,E02003401,8594,1596,6998
2021,Reading 014,E02003402,10152,2606,7546
2021,Reading 015,E02003403,8830,1789,7041
2021,Reading 016,E02003404,8245,3822,4423
2021,Reading 017,E02003405,12177,2750,9427
2021,Reading 018,E02003406,7745,1632,6113
2021,Slough 001,E02003407,10172,2977,7195
2021,Slough 002,E02003408,10425,2685,7740
2021,Slough 003,E02003409,9745,2190,7555
2021,Slough 004,E02003410,11369,3239,8130
2021,Slough 005,E02003411,11534,3071,8463
2021,Slough 006,E02003412,9739,2424,7315
2021,Slough 008,E02003414,12559,3329,9230
2021,Slough 009,E02003415,12337,3229,9108
2021,Slough 010,E02003416,9102,2351,6751
2021,Slough 011,E02003417,11788,2786,9002
2021,Slough 012,E02003418,9718,2557,7161
2021,Slough 013,E02003419,8342,2130,6212
2021,Slough 014,E02003420,5931,1350,4581
2021,Windsor and Maidenhead 001,E02003421,5410,1093,4317
2021,Windsor and Maidenhead 002,E02003422,11268,1996,9272
2021,Windsor and Maidenhead 003,E02003423,6216,1424,4792
2021,Windsor and Maidenhead 004,E02003424,8788,1377,7411
2021,Windsor and Maidenhead 005,E02003425,12152,2241,9911
2021,Windsor and Maidenhead 006,E02003426,9323,1911,7412
2021,Windsor and Maidenhead 007,E02003427,7617,1636,5981
2021,Windsor and Maidenhead 008,E02003428,8637,1774,6863
2021,Windsor and Maidenhead 009,E02003429,7414,1532,5882
2021,Windsor and Maidenhead 010,E02003430,7222,2129,5093
2021,Windsor and Maidenhead 011,E02003431,6630,1186,5444
2021,Windsor and Maidenhead 012,E02003432,6696,1133,5563
2021,Windsor and Maidenhead 013,E02003433,6051,1085,4966
2021,Windsor and Maidenhead 014,E02003434,8677,1751,6926
2021,Windsor and Maidenhead 015,E02003435,6771,1304,5467
2021,Windsor and Maidenhead 016,E02003436,8654,1471,7183
2021,Windsor and Maidenhead 017,E02003437,7138,1596,5542
2021,Windsor and Maidenhead 018,E02003438,10813,2497,8316
2021,Wokingham 001,E02003439,5296,956,4340
2021,Wokingham 002,E02003440,8801,1851,6950
2021,Wokingham 003,E02003441,7343,1404,5939
2021,Wokingham 004,E02003442,7875,1587,6288
2021,Wokingham 005,E02003443,6576,1418,5158
2021,Wokingham 006,E02003444,8901,2033,6868
2021,Wokingham 007,E02003445,8250,1614,6636
2021,Wokingham 008,E02003446,9484,3322,6162
2021,Wokingham 009,E02003447,10079,2214,7865
2021,Wokingham 010,E02003448,7661,1609,6052
2021,Wokingham 011,E02003449,7087,1466,5621
2021,Wokingham 012,E02003450,12294,2612,9682
2021,Wokingham 013,E02003451,9181,1545,7636
2021,Wokingham 014,E02003452,8882,1980,6902
2021,Wokingham 015,E02003453,6677,1445,5232
2021,Wokingham 016,E02003454,8281,1621,6660
2021,Wokingham 017,E02003455,9812,1893,7919
2021,Wokingham 018,E02003456,7688,1766,5922
2021,Wokingham 019,E02003457,9440,1871,7569
2021,Wokingham 020,E02003458,8040,1705,6335
2021,Milton Keynes 001,E02003459,8625,1584,7041
2021,Milton Keynes 002,E02003460,11046,2062,8984
2021,Milton Keynes 003,E02003461,7140,1388,5752
2021,Milton Keynes 004,E02003462,7631,1375,6256
2021,Milton Keynes 005,E02003463,6477,1166,5311
2021,Milton Keynes 006,E02003464,6639,1602,5037
2021,Milton Keynes 007,E02003465,5828,825,5003
2021,Milton Keynes 008,E02003466,7268,1542,5726
2021,Milton Keynes 009,E02003467,6204,1298,4906
2021,Milton Keynes 010,E02003468,8114,1494,6620
2021,Milton Keynes 011,E02003469,5425,947,4478
2021,Milton Keynes 012,E02003470,5762,1719,4043
2021,Milton Keynes 013,E02003471,6288,1343,4945
2021,Milton Keynes 014,E02003472,9615,2037,7578
2021,Milton Keynes 015,E02003473,5314,1025,4289
2021,Milton Keynes 016,E02003474,8512,2055,6457
2021,Milton Keynes 018,E02003476,8221,2132,6089
2021,Milton Keynes 020,E02003478,6466,1373,5093
2021,Milton Keynes 021,E02003479,7210,1831,5379
2021,Milton Keynes 022,E02003480,7662,1555,6107
2021,Milton Keynes 023,E02003481,7795,2011,5784
2021,Milton Keynes 024,E02003482,8168,1549,6619
2021,Milton Keynes 025,E02003483,10622,2793,7829
2021,Milton Keynes 026,E02003484,6759,1415,5344
2021,Milton Keynes 027,E02003485,7750,1588,6162
2021,Milton Keynes 028,E02003486,9594,2452,7142
2021,Milton Keynes 029,E02003487,7014,1408,5606
2021,Milton Keynes 030,E02003488,7917,1615,6302
2021,Milton Keynes 031,E02003489,7186,1292,5894
2021,Milton Keynes 032,E02003490,10280,2929,7351
2021,Brighton and Hove 001,E02003491,7413,1562,5851
2021,Brighton and Hove 002,E02003492,9903,6108,3795
2021,Brighton and Hove 003,E02003493,7718,1528,6190
2021,Brighton and Hove 004,E02003494,6369,1454,4915
2021,Brighton and Hove 005,E02003495,6734,1304,5430
2021,Brighton and Hove 006,E02003496,7325,1569,5756
2021,Brighton and Hove 007,E02003497,7249,1592,5657
2021,Brighton and Hove 008,E02003498,8140,2768,5372
2021,Brighton and Hove 009,E02003499,7489,2453,5036
2021,Brighton and Hove 010,E02003500,7672,2175,5497
2021,Brighton and Hove 011,E02003501,8045,1628,6417
2021,Brighton and Hove 012,E02003502,7357,1474,5883
2021,Brighton and Hove 013,E02003503,8614,1913,6701
2021,Brighton and Hove 014,E02003504,8205,1833,6372
2021,Brighton and Hove 015,E02003505,8663,3179,5484
2021,Brighton and Hove 016,E02003506,6690,1408,5282
2021,Brighton and Hove 017,E02003507,9293,1731,7562
2021,Brighton and Hove 018,E02003508,8332,3074,5258
2021,Brighton and Hove 019,E02003509,8483,1188,7295
2021,Brighton and Hove 020,E02003510,8289,1408,6881
2021,Brighton and Hove 021,E02003511,8116,1729,6387
2021,Brighton and Hove 022,E02003512,8537,2944,5593
2021,Brighton and Hove 023,E02003513,6203,1230,4973
2021,Brighton and Hove 024,E02003514,8164,1318,6846
2021,Brighton and Hove 025,E02003515,8616,1958,6658
2021,Brighton and Hove 026,E02003516,7944,1076,6868
2021,Brighton and Hove 027,E02003517,10446,2747,7699
2021,Brighton and Hove 028,E02003518,7336,928,6408
2021,Brighton and Hove 029,E02003519,8020,1100,6920
2021,Brighton and Hove 030,E02003520,8847,2019,6828
2021,Brighton and Hove 031,E02003521,7882,1448,6434
2021,Brighton and Hove 032,E02003522,7461,1412,6049
2021,Brighton and Hove 033,E02003523,9799,1438,8361
2021,Portsmouth 001,E02003524,7684,1846,5838
2021,Portsmouth 002,E02003525,6025,1355,4670
2021,Portsmouth 003,E02003526,6567,1151,5416
2021,Portsmouth 004,E02003527,5978,1069,4909
2021,Portsmouth 006,E02003529,7870,1651,6219
2021,Portsmouth 007,E02003530,7406,1482,5924
2021,Portsmouth 008,E02003531,7362,1237,6125
2021,Portsmouth 009,E02003532,7417,1447,5970
2021,Portsmouth 010,E02003533,5385,1009,4376
2021,Portsmouth 011,E02003534,8339,1738,6601
2021,Portsmouth 012,E02003535,8986,1954,7032
2021,Portsmouth 013,E02003536,7393,1880,5513
2021,Portsmouth 014,E02003537,9697,1886,7811
2021,Portsmouth 015,E02003538,9633,2324,7309
2021,Portsmouth 017,E02003540,8908,1727,7181
2021,Portsmouth 018,E02003541,10358,4442,5916
2021,Portsmouth 019,E02003542,8372,2526,5846
2021,Portsmouth 020,E02003543,8395,3179,5216
2021,Portsmouth 021,E02003544,5937,1137,4800
2021,Portsmouth 022,E02003545,6536,1291,5245
2021,Portsmouth 023,E02003546,7510,1167,6343
2021,Portsmouth 024,E02003547,7822,1553,6269
2021,Portsmouth 025,E02003548,5895,1195,4700
2021,Southampton 001,E02003549,8188,3385,4803
2021,Southampton 002,E02003550,7437,1441,5996
2021,Southampton 003,E02003551,6221,2391,3830
2021,Southampton 004,E02003552,5843,1106,4737
2021,Southampton 005,E02003553,6932,3088,3844
2021,Southampton 006,E02003554,5766,1053,4713
2021,Southampton 007,E02003555,8136,1676,6460
2021,Southampton 008,E02003556,5433,1077,4356
2021,Southampton 009,E02003557,6550,2509,4041
2021,Southampton 010,E02003558,6769,1516,5253
2021,Southampton 011,E02003559,7418,1555,5863
2021,Southampton 012,E02003560,6928,1633,5295
2021,Southampton 013,E02003561,7544,2715,4829
2021,Southampton 014,E02003562,7830,1469,6361
2021,Southampton 015,E02003563,7503,1434,6069
2021,Southampton 016,E02003564,7579,1530,6049
2021,Southampton 017,E02003565,6474,2478,3996
2021,Southampton 018,E02003566,6043,1131,4912
2021,Southampton 019,E02003567,7569,1747,5822
2021,Southampton 020,E02003568,7870,1671,6199
2021,Southampton 021,E02003569,7372,1248,6124
2021,Southampton 022,E02003570,10837,3750,7087
2021,Southampton 023,E02003571,8677,3957,4720
2021,Southampton 024,E02003572,5826,1107,4719
2021,Southampton 025,E02003573,7416,1575,5841
2021,Southampton 026,E02003574,7251,1152,6099
2021,Southampton 027,E02003575,6055,1409,4646
2021,Southampton 028,E02003576,7635,1521,6114
2021,Southampton 030,E02003578,6008,1025,4983
2021,Southampton 031,E02003579,8994,1488,7506
2021,Southampton 032,E02003580,5698,1246,4452
2021,Isle of Wight 001,E02003581,7388,1174,6214
2021,Isle of Wight 002,E02003582,8242,1430,6812
2021,Isle of Wight 003,E02003583,7365,1215,6150
2021,Isle of Wight 004,E02003584,5878,722,5156
2021,Isle of Wight 005,E02003585,6398,849,5549
2021,Isle of Wight 006,E02003586,7383,1293,6090
2021,Isle of Wight 007,E02003587,8095,1506,6589
2021,Isle of Wight 008,E02003588,8798,1493,7305
2021,Isle of Wight 009,E02003589,6974,1253,5721
2021,Isle of Wight 010,E02003590,7145,840,6305
2021,Isle of Wight 011,E02003591,9012,1662,7350
2021,Isle of Wight 012,E02003592,9402,983,8419
2021,Isle of Wight 013,E02003593,5140,669,4471
2021,Isle of Wight 014,E02003594,8945,1305,7640
2021,Isle of Wight 015,E02003595,7746,919,6827
2021,Isle of Wight 016,E02003596,8405,1105,7300
2021,Isle of Wight 017,E02003597,5515,733,4782
2021,Isle of Wight 018,E02003598,7075,967,6108
2021,Central Bedfordshire 001,E02003599,5399,1099,4300
2021,Central Bedfordshire 002,E02003600,6131,1089,5042
2021,Central Bedfordshire 003,E02003601,7704,1283,6421
2021,Central Bedfordshire 004,E02003602,6265,1027,5238
2021,Central Bedfordshire 005,E02003603,10535,1759,8776
2021,Central Bedfordshire 006,E02003604,10376,1892,8484
2021,Central Bedfordshire 007,E02003605,9658,2631,7027
2021,Central Bedfordshire 008,E02003606,8854,1596,7258
2021,Central Bedfordshire 009,E02003607,10408,2004,8404
2021,Central Bedfordshire 010,E02003608,11471,1986,9485
2021,Central Bedfordshire 011,E02003609,11114,2173,8941
2021,Central Bedfordshire 012,E02003610,8506,1731,6775
2021,Central Bedfordshire 013,E02003611,9276,1690,7586
2021,Central Bedfordshire 014,E02003612,11583,2424,9159
2021,Central Bedfordshire 015,E02003613,5465,954,4511
2021,Central Bedfordshire 016,E02003614,7646,1307,6339
2021,Central Bedfordshire 017,E02003615,9950,1886,8064
2021,Bedford 001,E02003616,5465,974,4491
2021,Bedford 002,E02003617,8673,1515,7158
2021,Bedford 003,E02003618,8347,1725,6622
2021,Bedford 004,E02003619,11265,2160,9105
2021,Bedford 005,E02003620,7766,1379,6387
2021,Bedford 006,E02003621,7757,1386,6371
2021,Bedford 007,E02003622,8687,1902,6785
2021,Bedford 008,E02003623,11923,2376,9547
2021,Bedford 009,E02003624,5693,1351,4342
2021,Bedford 010,E02003625,8418,1289,7129
2021,Bedford 011,E02003626,5331,1013,4318
2021,Bedford 012,E02003627,10011,1679,8332
2021,Bedford 013,E02003628,8970,2440,6530
2021,Bedford 014,E02003629,9990,2210,7780
2021,Bedford 015,E02003630,10623,2402,8221
2021,Bedford 016,E02003631,5239,945,4294
2021,Bedford 017,E02003632,5817,1080,4737
2021,Bedford 018,E02003633,9834,2072,7762
2021,Bedford 020,E02003635,9413,2039,7374
2021,Central Bedfordshire 018,E02003636,6968,1284,5684
2021,Central Bedfordshire 019,E02003637,10140,1683,8457
2021,Central Bedfordshire 020,E02003638,7257,1234,6023
2021,Central Bedfordshire 021,E02003639,8993,1554,7439
2021,Central Bedfordshire 022,E02003640,5736,870,4866
2021,Central Bedfordshire 023,E02003641,5067,931,4136
2021,Central Bedfordshire 025,E02003642,8916,2213,6703
2021,Central Bedfordshire 024,E02003643,12546,2605,9941
2021,Central Bedfordshire 026,E02003644,9349,1840,7509
2021,Central Bedfordshire 027,E02003645,6638,1240,5398
2021,Central Bedfordshire 028,E02003646,9941,2101,7840
2021,Central Bedfordshire 029,E02003647,9818,1692,8126
2021,Central Bedfordshire 030,E02003648,5150,1077,4073
2021,Central Bedfordshire 031,E02003649,6290,1014,5276
2021,Central Bedfordshire 032,E02003650,6698,991,5707
2021,Central Bedfordshire 033,E02003651,6604,1036,5568
2021,Buckinghamshire 001,E02003652,10033,2681,7352
2021,Buckinghamshire 002,E02003653,6435,1398,5037
2021,Buckinghamshire 003,E02003654,5551,967,4584
2021,Buckinghamshire 004,E02003655,9840,1885,7955
2021,Buckinghamshire 005,E02003656,6326,1039,5287
2021,Buckinghamshire 006,E02003657,7116,1355,5761
2021,Buckinghamshire 007,E02003658,9329,1713,7616
2021,Buckinghamshire 009,E02003659,9282,2061,7221
2021,Buckinghamshire 008,E02003660,10266,1974,8292
2021,Buckinghamshire 010,E02003661,5640,976,4664
2021,Buckinghamshire 012,E02003662,5812,1025,4787
2021,Buckinghamshire 011,E02003663,12641,3025,9616
2021,Buckinghamshire 013,E02003664,7495,1672,5823
2021,Buckinghamshire 014,E02003665,5780,1111,4669
2021,Buckinghamshire 015,E02003666,7094,1177,5917
2021,Buckinghamshire 016,E02003667,8723,1617,7106
2021,Buckinghamshire 018,E02003668,8372,1653,6719
2021,Buckinghamshire 017,E02003669,6906,1633,5273
2021,Buckinghamshire 019,E02003670,8630,1590,7040
2021,Buckinghamshire 020,E02003671,5555,1129,4426
2021,Buckinghamshire 021,E02003672,11735,2218,9517
2021,Buckinghamshire 022,E02003673,8923,1521,7402
2021,Buckinghamshire 023,E02003674,5305,1006,4299
2021,Buckinghamshire 024,E02003675,9140,1685,7455
2021,Buckinghamshire 029,E02003676,7845,1469,6376
2021,Buckinghamshire 027,E02003677,9753,2108,7645
2021,Buckinghamshire 028,E02003678,5502,1105,4397
2021,Buckinghamshire 030,E02003679,6415,1089,5326
2021,Buckinghamshire 031,E02003680,9418,1800,7618
2021,Buckinghamshire 032,E02003681,10007,2223,7784
2021,Buckinghamshire 034,E02003682,7200,1501,5699
2021,Buckinghamshire 035,E02003683,6779,1541,5238
2021,Buckinghamshire 047,E02003685,7590,1558,6032
2021,Buckinghamshire 050,E02003686,7215,1347,5868
2021,Buckinghamshire 054,E02003687,5470,1150,4320
2021,Buckinghamshire 053,E02003688,11612,2595,9017
2021,Buckinghamshire 058,E02003689,8829,1888,6941
2021,Buckinghamshire 059,E02003690,7014,1075,5939
2021,Buckinghamshire 063,E02003691,6923,1395,5528
2021,Buckinghamshire 064,E02003692,8465,1536,6929
2021,Buckinghamshire 065,E02003693,6874,1106,5768
2021,Buckinghamshire 066,E02003694,7962,1485,6477
2021,Buckinghamshire 067,E02003695,10193,1811,8382
2021,Buckinghamshire 026,E02003696,8162,1310,6852
2021,Buckinghamshire 025,E02003697,5999,1082,4917
2021,Buckinghamshire 033,E02003698,7922,1368,6554
2021,Buckinghamshire 037,E02003699,5549,948,4601
2021,Buckinghamshire 038,E02003701,11626,2845,8781
2021,Buckinghamshire 040,E02003702,7824,1243,6581
2021,Buckinghamshire 041,E02003703,8424,1852,6572
2021,Buckinghamshire 045,E02003704,5482,1044,4438
2021,Buckinghamshire 042,E02003705,6595,1517,5078
2021,Buckinghamshire 043,E02003706,6370,1366,5004
2021,Buckinghamshire 044,E02003707,6278,1283,4995
2021,Buckinghamshire 046,E02003708,9063,2215,6848
2021,Buckinghamshire 048,E02003709,5368,1275,4093
2021,Buckinghamshire 049,E02003710,12115,3366,8749
2021,Buckinghamshire 051,E02003711,9064,1677,7387
2021,Buckinghamshire 052,E02003712,7712,1435,6277
2021,Buckinghamshire 055,E02003713,5629,1068,4561
2021,Buckinghamshire 056,E02003714,6346,1178,5168
2021,Buckinghamshire 057,E02003715,6314,1303,5011
2021,Buckinghamshire 060,E02003716,5573,838,4735
2021,Buckinghamshire 062,E02003717,8748,1831,6917
2021,Buckinghamshire 061,E02003718,5373,1105,4268
2021,Cambridge 001,E02003719,9711,1795,7916
2021,Cambridge 002,E02003720,9160,2185,6975
2021,Cambridge 003,E02003721,9212,1795,7417
2021,Cambridge 004,E02003722,8170,1850,6320
2021,Cambridge 005,E02003723,12629,7693,4936
2021,Cambridge 006,E02003724,9820,2241,7579
2021,Cambridge 007,E02003725,15975,10489,5486
2021,Cambridge 008,E02003726,7979,2676,5303
2021,Cambridge 009,E02003727,9733,2432,7301
2021,Cambridge 010,E02003728,10429,2505,7924
2021,Cambridge 011,E02003729,8792,1857,6935
2021,Cambridge 013,E02003731,11519,3778,7741
2021,East Cambridgeshire 001,E02003732,9293,1624,7669
2021,East Cambridgeshire 002,E02003733,8038,1387,6651
2021,East Cambridgeshire 003,E02003734,11362,2150,9212
2021,East Cambridgeshire 004,E02003735,8229,1537,6692
2021,East Cambridgeshire 005,E02003736,9773,1705,8068
2021,East Cambridgeshire 006,E02003737,12438,2324,10114
2021,East Cambridgeshire 007,E02003738,6072,1075,4997
2021,East Cambridgeshire 008,E02003739,6131,1102,5029
2021,East Cambridgeshire 009,E02003740,6016,1125,4891
2021,Fenland 001,E02003742,6517,918,5599
2021,Fenland 002,E02003743,10454,1937,8517
2021,Fenland 003,E02003744,12941,1967,10974
2021,Fenland 004,E02003745,9875,1554,8321
2021,Fenland 005,E02003746,7481,1311,6170
2021,Fenland 006,E02003747,12044,2050,9994
2021,Fenland 007,E02003748,7258,1158,6100
2021,Fenland 008,E02003749,5845,916,4929
2021,Fenland 009,E02003750,7155,1078,6077
2021,Fenland 010,E02003751,7151,1154,5997
2021,Fenland 011,E02003752,10566,1737,8829
2021,Huntingdonshire 001,E02003753,10539,1954,8585
2021,Huntingdonshire 002,E02003754,5422,879,4543
2021,Huntingdonshire 003,E02003755,8141,1350,6791
2021,Huntingdonshire 004,E02003756,6730,1098,5632
2021,Huntingdonshire 005,E02003757,6523,1034,5489
2021,Huntingdonshire 006,E02003758,9117,1441,7676
2021,Huntingdonshire 007,E02003759,5629,857,4772
2021,Huntingdonshire 008,E02003760,8467,1962,6505
2021,Huntingdonshire 009,E02003761,5722,867,4855
2021,Huntingdonshire 010,E02003762,10734,2025,8709
2021,Huntingdonshire 011,E02003763,9134,1591,7543
2021,Huntingdonshire 012,E02003764,9789,1695,8094
2021,Huntingdonshire 013,E02003765,6914,1125,5789
2021,Huntingdonshire 014,E02003766,7384,1393,5991
2021,Huntingdonshire 015,E02003767,6135,1036,5099
2021,Huntingdonshire 016,E02003768,9574,1579,7995
2021,Huntingdonshire 017,E02003769,7183,919,6264
2021,Huntingdonshire 018,E02003770,10205,2167,8038
2021,Huntingdonshire 019,E02003771,5986,927,5059
2021,Huntingdonshire 020,E02003772,6417,963,5454
2021,Huntingdonshire 021,E02003773,9964,1673,8291
2021,Huntingdonshire 022,E02003774,5461,893,4568
2021,South Cambridgeshire 001,E02003775,6847,1307,5540
2021,South Cambridgeshire 002,E02003776,6465,1172,5293
2021,South Cambridgeshire 003,E02003777,9245,1997,7248
2021,South Cambridgeshire 004,E02003778,6074,1000,5074
2021,South Cambridgeshire 006,E02003780,10878,2187,8691
2021,South Cambridgeshire 007,E02003781,5782,882,4900
2021,South Cambridgeshire 010,E02003784,8546,1734,6812
2021,South Cambridgeshire 011,E02003785,8392,1516,6876
2021,South Cambridgeshire 012,E02003786,6198,1114,5084
2021,South Cambridgeshire 013,E02003787,7268,1161,6107
2021,South Cambridgeshire 014,E02003788,7649,1553,6096
2021,South Cambridgeshire 015,E02003789,6853,1258,5595
2021,South Cambridgeshire 016,E02003790,8923,1587,7336
2021,South Cambridgeshire 017,E02003791,7861,1482,6379
2021,South Cambridgeshire 018,E02003792,9351,1709,7642
2021,South Cambridgeshire 019,E02003793,6864,1296,5568
2021,Cheshire West and Chester 022,E02003794,8263,1493,6770
2021,Cheshire West and Chester 025,E02003795,6064,956,5108
2021,Cheshire West and Chester 027,E02003796,6906,1212,5694
2021,Cheshire West and Chester 028,E02003797,9534,1751,7783
2021,Cheshire West and Chester 029,E02003798,5902,1326,4576
2021,Cheshire West and Chester 031,E02003799,6866,1358,5508
2021,Cheshire West and Chester 030,E02003800,6812,1217,5595
2021,Cheshire West and Chester 032,E02003801,6752,1287,5465
2021,Cheshire West and Chester 033,E02003802,8312,1437,6875
2021,Cheshire West and Chester 034,E02003803,9995,3841,6154
2021,Cheshire West and Chester 036,E02003804,6539,1021,5518
2021,Cheshire West and Chester 039,E02003805,6080,1121,4959
2021,Cheshire West and Chester 041,E02003806,7818,1633,6185
2021,Cheshire West and Chester 043,E02003807,8496,1472,7024
2021,Cheshire West and Chester 044,E02003808,6121,1246,4875
2021,Cheshire West and Chester 046,E02003809,7861,1297,6564
2021,Cheshire West and Chester 047,E02003810,9334,1672,7662
2021,Cheshire East 022,E02003811,7236,1265,5971
2021,Cheshire East 023,E02003812,6338,1162,5176
2021,Cheshire East 024,E02003813,5818,794,5024
2021,Cheshire East 025,E02003814,7882,1525,6357
2021,Cheshire East 026,E02003815,7078,1370,5708
2021,Cheshire East 027,E02003816,7162,1067,6095
2021,Cheshire East 028,E02003817,7336,1188,6148
2021,Cheshire East 029,E02003818,5451,766,4685
2021,Cheshire East 030,E02003819,6263,925,5338
2021,Cheshire East 031,E02003820,9082,1725,7357
2021,Cheshire East 032,E02003821,5331,755,4576
2021,Cheshire East 033,E02003822,11019,1588,9431
2021,Cheshire East 040,E02003823,6571,1108,5463
2021,Cheshire East 042,E02003824,6143,1180,4963
2021,Cheshire East 034,E02003825,6029,1103,4926
2021,Cheshire East 035,E02003826,8254,1720,6534
2021,Cheshire East 036,E02003827,8902,1711,7191
2021,Cheshire East 037,E02003828,6087,1299,4788
2021,Cheshire East 038,E02003829,5349,643,4706
2021,Cheshire East 039,E02003830,7506,1437,6069
2021,Cheshire East 041,E02003831,9662,1571,8091
2021,Cheshire East 043,E02003832,6224,1024,5200
2021,Cheshire East 044,E02003833,5995,1140,4855
2021,Cheshire East 045,E02003834,6648,1240,5408
2021,Cheshire East 046,E02003835,7981,1177,6804
2021,Cheshire East 047,E02003836,6705,901,5804
2021,Cheshire East 048,E02003838,7696,1279,6417
2021,Cheshire East 050,E02003839,6782,954,5828
2021,Cheshire East 051,E02003840,10425,1647,8778
2021,Cheshire West and Chester 001,E02003841,7608,1335,6273
2021,Cheshire West and Chester 004,E02003842,5427,770,4657
2021,Cheshire West and Chester 005,E02003843,6157,998,5159
2021,Cheshire West and Chester 006,E02003844,6391,1058,5333
2021,Cheshire West and Chester 007,E02003845,10131,1929,8202
2021,Cheshire West and Chester 008,E02003846,6423,1417,5006
2021,Cheshire West and Chester 009,E02003847,9344,1491,7853
2021,Cheshire West and Chester 010,E02003848,5030,1033,3997
2021,Cheshire West and Chester 011,E02003849,7842,1672,6170
2021,Cheshire West and Chester 013,E02003850,4850,781,4069
2021,Cheshire West and Chester 014,E02003851,5537,905,4632
2021,Cheshire West and Chester 016,E02003852,6225,1007,5218
2021,Cheshire East 001,E02003853,5841,890,4951
2021,Cheshire East 002,E02003854,6112,1103,5009
2021,Cheshire East 003,E02003855,6175,997,5178
2021,Cheshire East 004,E02003856,10784,1933,8851
2021,Cheshire East 005,E02003857,6429,1308,5121
2021,Cheshire East 006,E02003858,6564,1141,5423
2021,Cheshire East 007,E02003859,11945,1912,10033
2021,Cheshire East 008,E02003860,6904,1483,5421
2021,Cheshire East 009,E02003861,6093,1153,4940
2021,Cheshire East 011,E02003862,5108,820,4288
2021,Cheshire East 010,E02003863,6527,1226,5301
2021,Cheshire East 012,E02003864,8235,1228,7007
2021,Cheshire East 013,E02003865,7578,1269,6309
2021,Cheshire East 014,E02003866,5988,1087,4901
2021,Cheshire East 015,E02003867,7271,1455,5816
2021,Cheshire East 016,E02003868,7996,1330,6666
2021,Cheshire East 017,E02003869,6993,1109,5884
2021,Cheshire East 018,E02003870,9930,1349,8581
2021,Cheshire East 019,E02003871,6494,1143,5351
2021,Cheshire East 020,E02003872,9842,1508,8334
2021,Cheshire East 021,E02003873,5847,1075,4772
2021,Cheshire West and Chester 002,E02003874,8799,1541,7258
2021,Cheshire West and Chester 003,E02003875,6205,878,5327
2021,Cheshire West and Chester 012,E02003876,5380,974,4406
2021,Cheshire West and Chester 015,E02003877,9217,1395,7822
2021,Cheshire West and Chester 017,E02003878,8835,1378,7457
2021,Cheshire West and Chester 018,E02003879,8490,1456,7034
2021,Cheshire West and Chester 019,E02003880,6247,1106,5141
2021,Cheshire West and Chester 020,E02003881,5572,952,4620
2021,Cheshire West and Chester 021,E02003882,9006,1662,7344
2021,Cheshire West and Chester 023,E02003883,10762,2075,8687
2021,Cheshire West and Chester 024,E02003884,8505,1442,7063
2021,Cheshire West and Chester 026,E02003885,6149,1057,5092
2021,Cheshire West and Chester 035,E02003886,6190,1214,4976
2021,Cheshire West and Chester 037,E02003887,6565,1187,5378
2021,Cheshire West and Chester 038,E02003888,6125,1028,5097
2021,Cheshire West and Chester 040,E02003889,6043,1370,4673
2021,Cheshire West and Chester 042,E02003890,6624,1201,5423
2021,Cheshire West and Chester 045,E02003891,6199,1086,5113
2021,Cornwall 010,E02003892,6416,879,5537
2021,Cornwall 012,E02003893,6345,851,5494
2021,Cornwall 013,E02003894,7941,1224,6717
2021,Cornwall 016,E02003895,8942,1504,7438
2021,Cornwall 017,E02003896,5676,921,4755
2021,Cornwall 022,E02003897,5209,904,4305
2021,Cornwall 023,E02003898,6505,957,5548
2021,Cornwall 025,E02003899,5056,838,4218
2021,Cornwall 026,E02003900,6794,1215,5579
2021,Cornwall 028,E02003901,8007,1106,6901
2021,Cornwall 029,E02003902,5061,857,4204
2021,Cornwall 034,E02003903,6001,916,5085
2021,Cornwall 037,E02003904,4888,556,4332
2021,Cornwall 032,E02003905,6809,1313,5496
2021,Cornwall 033,E02003906,6128,1098,5030
2021,Cornwall 040,E02003907,8084,1487,6597
2021,Cornwall 042,E02003908,8070,1576,6494
2021,Cornwall 043,E02003909,10203,1954,8249
2021,Cornwall 044,E02003910,6650,1109,5541
2021,Cornwall 047,E02003911,8741,1439,7302
2021,Cornwall 048,E02003912,7906,1198,6708
2021,Cornwall 056,E02003913,5718,834,4884
2021,Cornwall 060,E02003914,8083,2434,5649
2021,Cornwall 062,E02003915,7979,2468,5511
2021,Cornwall 063,E02003916,6895,2355,4540
2021,Cornwall 064,E02003917,7907,1498,6409
2021,Cornwall 045,E02003918,6849,1053,5796
2021,Cornwall 046,E02003919,6941,1174,5767
2021,Cornwall 049,E02003920,7787,1355,6432
2021,Cornwall 050,E02003921,6014,987,5027
2021,Cornwall 051,E02003922,8527,1586,6941
2021,Cornwall 052,E02003923,8843,1636,7207
2021,Cornwall 053,E02003924,7030,1075,5955
2021,Cornwall 055,E02003925,6894,1277,5617
2021,Cornwall 059,E02003926,7955,1290,6665
2021,Cornwall 066,E02003927,10261,2675,7586
2021,Cornwall 071,E02003928,11450,2253,9197
2021,Cornwall 072,E02003929,6603,920,5683
2021,Cornwall 073,E02003930,8590,1372,7218
2021,Cornwall 001,E02003931,10145,1694,8451
2021,Cornwall 002,E02003932,7179,1156,6023
2021,Cornwall 003,E02003933,6795,978,5817
2021,Cornwall 004,E02003934,6861,1139,5722
2021,Cornwall 005,E02003935,9684,1823,7861
2021,Cornwall 006,E02003936,8072,1153,6919
2021,Cornwall 007,E02003937,5101,829,4272
2021,Cornwall 008,E02003938,6448,1088,5360
2021,Cornwall 009,E02003939,6546,1057,5489
2021,Cornwall 011,E02003940,6173,873,5300
2021,Cornwall 014,E02003941,8454,1524,6930
2021,Cornwall 015,E02003942,7469,1405,6064
2021,Cornwall 054,E02003943,6665,992,5673
2021,Cornwall 057,E02003944,9821,1691,8130
2021,Cornwall 058,E02003945,5707,760,4947
2021,Cornwall 061,E02003946,9057,1521,7536
2021,Cornwall 065,E02003947,6290,920,5370
2021,Cornwall 067,E02003948,7952,1334,6618
2021,Cornwall 068,E02003949,6261,825,5436
2021,Cornwall 069,E02003950,5193,834,4359
2021,Cornwall 070,E02003951,5621,807,4814
2021,Cornwall 018,E02003952,9185,1703,7482
2021,Cornwall 019,E02003953,10265,1826,8439
2021,Cornwall 020,E02003954,7303,1012,6291
2021,Cornwall 021,E02003955,9645,1628,8017
2021,Cornwall 024,E02003956,7360,1287,6073
2021,Cornwall 027,E02003957,10540,1832,8708
2021,Cornwall 030,E02003958,7801,1409,6392
2021,Cornwall 031,E02003959,6581,1220,5361
2021,Cornwall 035,E02003960,5517,745,4772
2021,Cornwall 036,E02003961,9207,1560,7647
2021,Cornwall 038,E02003962,6851,1145,5706
2021,Cornwall 039,E02003963,9508,1625,7883
2021,Cornwall 041,E02003964,7759,1048,6711
2021,Allerdale 001,E02003965,10521,1570,8951
2021,Allerdale 002,E02003966,6773,976,5797
2021,Allerdale 003,E02003967,7733,1237,6496
2021,Allerdale 004,E02003968,8448,1297,7151
2021,Allerdale 005,E02003969,6163,1111,5052
2021,Allerdale 006,E02003970,7882,1220,6662
2021,Allerdale 007,E02003971,7439,1097,6342
2021,Allerdale 008,E02003972,8525,1334,7191
2021,Allerdale 009,E02003973,8087,1398,6689
2021,Allerdale 010,E02003974,7244,1231,6013
2021,Allerdale 011,E02003975,6890,1116,5774
2021,Allerdale 012,E02003976,6108,822,5286
2021,Barrow-in-Furness 001,E02003977,5907,892,5015
2021,Barrow-in-Furness 002,E02003978,5488,831,4657
2021,Barrow-in-Furness 003,E02003979,7456,998,6458
2021,Barrow-in-Furness 004,E02003980,6316,1132,5184
2021,Barrow-in-Furness 005,E02003981,6107,915,5192
2021,Barrow-in-Furness 006,E02003982,7700,1358,6342
2021,Barrow-in-Furness 007,E02003983,6836,1271,5565
2021,Barrow-in-Furness 008,E02003984,6002,1048,4954
2021,Barrow-in-Furness 009,E02003985,6366,984,5382
2021,Barrow-in-Furness 010,E02003986,5745,850,4895
2021,Carlisle 001,E02003987,5762,856,4906
2021,Carlisle 002,E02003988,6257,948,5309
2021,Carlisle 003,E02003989,7178,1128,6050
2021,Carlisle 004,E02003990,10430,1848,8582
2021,Carlisle 005,E02003991,7232,1084,6148
2021,Carlisle 006,E02003992,7749,1406,6343
2021,Carlisle 007,E02003993,8478,1245,7233
2021,Carlisle 008,E02003994,6851,1094,5757
2021,Carlisle 009,E02003995,9541,1793,7748
2021,Carlisle 010,E02003996,8895,1571,7324
2021,Carlisle 011,E02003997,8884,1880,7004
2021,Carlisle 012,E02003998,6121,1243,4878
2021,Carlisle 013,E02003999,11266,1931,9335
2021,Copeland 001,E02004000,4936,773,4163
2021,Copeland 002,E02004001,4997,681,4316
2021,Copeland 003,E02004002,9127,1479,7648
2021,Copeland 004,E02004003,11028,1702,9326
2021,Copeland 005,E02004004,9182,1692,7490
2021,Copeland 006,E02004005,7320,1245,6075
2021,Copeland 007,E02004006,8062,1137,6925
2021,Copeland 008,E02004007,9293,1328,7965
2021,Eden 001,E02004008,6199,887,5312
2021,Eden 002,E02004009,5984,902,5082
2021,Eden 003,E02004010,7369,1174,6195
2021,Eden 004,E02004011,10437,1536,8901
2021,Eden 005,E02004012,5326,735,4591
2021,Eden 006,E02004013,9825,1449,8376
2021,Eden 007,E02004014,7441,1060,6381
2021,South Lakeland 001,E02004015,5977,889,5088
2021,South Lakeland 002,E02004016,7737,1128,6609
2021,South Lakeland 003,E02004017,8467,1308,7159
2021,South Lakeland 004,E02004018,7946,1358,6588
2021,South Lakeland 005,E02004019,7393,1001,6392
2021,South Lakeland 006,E02004020,8575,1344,7231
2021,South Lakeland 007,E02004021,5110,604,4506
2021,South Lakeland 008,E02004022,5346,710,4636
2021,South Lakeland 009,E02004023,6114,1285,4829
2021,South Lakeland 010,E02004024,7136,1023,6113
2021,South Lakeland 011,E02004025,7717,1196,6521
2021,South Lakeland 012,E02004026,7716,1153,6563
2021,South Lakeland 013,E02004027,7709,820,6889
2021,South Lakeland 014,E02004028,7590,995,6595
2021,Amber Valley 001,E02004029,6957,1124,5833
2021,Amber Valley 002,E02004030,5796,803,4993
2021,Amber Valley 003,E02004031,6967,1308,5659
2021,Amber Valley 004,E02004032,8061,1142,6919
2021,Amber Valley 005,E02004033,8476,1236,7240
2021,Amber Valley 006,E02004034,6565,893,5672
2021,Amber Valley 007,E02004035,6169,873,5296
2021,Amber Valley 008,E02004036,9781,1675,8106
2021,Amber Valley 009,E02004037,7515,1290,6225
2021,Amber Valley 010,E02004038,7215,979,6236
2021,Amber Valley 011,E02004039,7415,1205,6210
2021,Amber Valley 012,E02004040,8946,1486,7460
2021,Amber Valley 013,E02004041,7027,1154,5873
2021,Amber Valley 015,E02004043,6989,1163,5826
2021,Amber Valley 016,E02004044,8716,1831,6885
2021,Bolsover 001,E02004045,9333,1516,7817
2021,Bolsover 002,E02004046,5915,927,4988
2021,Bolsover 003,E02004047,5745,1037,4708
2021,Bolsover 004,E02004048,6603,1177,5426
2021,Bolsover 005,E02004049,7596,1141,6455
2021,Bolsover 006,E02004050,7339,1411,5928
2021,Bolsover 007,E02004051,9195,1438,7757
2021,Bolsover 008,E02004052,8240,1353,6887
2021,Bolsover 009,E02004053,7452,1348,6104
2021,Bolsover 010,E02004054,8753,1329,7424
2021,Chesterfield 001,E02004055,6599,1006,5593
2021,Chesterfield 002,E02004056,7547,1597,5950
2021,Chesterfield 003,E02004057,7317,1307,6010
2021,Chesterfield 004,E02004058,7563,1315,6248
2021,Chesterfield 005,E02004059,6901,974,5927
2021,Chesterfield 006,E02004060,7181,1364,5817
2021,Chesterfield 007,E02004061,7036,1125,5911
2021,Chesterfield 008,E02004062,7278,1102,6176
2021,Chesterfield 009,E02004063,7419,1124,6295
2021,Chesterfield 010,E02004064,9086,1590,7496
2021,Chesterfield 011,E02004065,7780,1122,6658
2021,Chesterfield 012,E02004066,10861,1665,9196
2021,Chesterfield 013,E02004067,5921,1003,4918
2021,Derbyshire Dales 001,E02004068,7002,1089,5913
2021,Derbyshire Dales 002,E02004069,6132,877,5255
2021,Derbyshire Dales 005,E02004072,9035,1356,7679
2021,Derbyshire Dales 006,E02004073,8478,1244,7234
2021,Derbyshire Dales 007,E02004074,5619,875,4744
2021,Derbyshire Dales 008,E02004075,6880,943,5937
2021,Derbyshire Dales 009,E02004076,7113,1289,5824
2021,Derbyshire Dales 010,E02004077,7984,1247,6737
2021,Erewash 001,E02004078,6612,1237,5375
2021,Erewash 003,E02004080,9176,1407,7769
2021,Erewash 004,E02004081,5606,911,4695
2021,Erewash 005,E02004082,5872,883,4989
2021,Erewash 006,E02004083,7806,1396,6410
2021,Erewash 007,E02004084,5657,1022,4635
2021,Erewash 008,E02004085,8463,1511,6952
2021,Erewash 009,E02004086,6869,1185,5684
2021,Erewash 010,E02004087,7326,1302,6024
2021,Erewash 011,E02004088,7317,1281,6036
2021,Erewash 012,E02004089,6442,986,5456
2021,Erewash 013,E02004090,5729,864,4865
2021,Erewash 014,E02004091,8846,1344,7502
2021,Erewash 015,E02004092,8932,1557,7375
2021,High Peak 001,E02004093,6031,1054,4977
2021,High Peak 002,E02004094,6641,1354,5287
2021,High Peak 003,E02004095,9652,1513,8139
2021,High Peak 004,E02004096,9330,1578,7752
2021,High Peak 005,E02004097,7143,1020,6123
2021,High Peak 006,E02004098,7002,1157,5845
2021,High Peak 008,E02004100,7793,1306,6487
2021,High Peak 010,E02004102,7367,1016,6351
2021,High Peak 011,E02004103,6452,1308,5144
2021,High Peak 012,E02004104,6920,1247,5673
2021,North East Derbyshire 001,E02004105,8746,1364,7382
2021,North East Derbyshire 002,E02004106,6551,911,5640
2021,North East Derbyshire 004,E02004108,7253,1248,6005
2021,North East Derbyshire 005,E02004109,6477,1016,5461
2021,North East Derbyshire 006,E02004110,7029,1223,5806
2021,North East Derbyshire 007,E02004111,5314,776,4538
2021,North East Derbyshire 008,E02004112,6101,816,5285
2021,North East Derbyshire 009,E02004113,9578,1706,7872
2021,North East Derbyshire 010,E02004114,8101,1148,6953
2021,North East Derbyshire 011,E02004115,8455,1227,7228
2021,North East Derbyshire 012,E02004116,8073,1362,6711
2021,North East Derbyshire 013,E02004117,7649,1228,6421
2021,South Derbyshire 001,E02004118,7313,1279,6034
2021,South Derbyshire 002,E02004119,11251,2386,8865
2021,South Derbyshire 003,E02004120,10197,1856,8341
2021,South Derbyshire 004,E02004121,8725,1592,7133
2021,South Derbyshire 005,E02004122,6663,1431,5232
2021,South Derbyshire 006,E02004123,6510,1091,5419
2021,South Derbyshire 007,E02004124,7171,1321,5850
2021,South Derbyshire 008,E02004125,8279,1466,6813
2021,South Derbyshire 009,E02004126,7066,1158,5908
2021,South Derbyshire 011,E02004128,10905,1772,9133
2021,East Devon 001,E02004129,5826,836,4990
2021,East Devon 002,E02004130,5908,836,5072
2021,East Devon 003,E02004131,5235,773,4462
2021,East Devon 004,E02004132,8518,1435,7083
2021,East Devon 005,E02004133,9334,1391,7943
2021,East Devon 007,E02004135,8125,1058,7067
2021,East Devon 008,E02004136,9080,1702,7378
2021,East Devon 009,E02004137,5167,640,4527
2021,East Devon 010,E02004138,7477,746,6731
2021,East Devon 011,E02004139,6734,1017,5717
2021,East Devon 012,E02004140,5159,481,4678
2021,East Devon 013,E02004141,6004,1004,5000
2021,East Devon 014,E02004142,6127,897,5230
2021,East Devon 015,E02004143,6083,913,5170
2021,East Devon 016,E02004144,6625,1054,5571
2021,East Devon 017,E02004145,5955,707,5248
2021,East Devon 018,E02004146,7179,1291,5888
2021,East Devon 019,E02004147,6693,973,5720
2021,East Devon 020,E02004148,7546,979,6567
2021,Exeter 001,E02004149,10832,6142,4690
2021,Exeter 002,E02004150,6717,2111,4606
2021,Exeter 003,E02004151,9448,1789,7659
2021,Exeter 004,E02004152,9551,5771,3780
2021,Exeter 005,E02004153,7075,1366,5709
2021,Exeter 006,E02004154,7886,2600,5286
2021,Exeter 007,E02004155,7023,1292,5731
2021,Exeter 008,E02004156,11313,4822,6491
2021,Exeter 009,E02004157,6079,1239,4840
2021,Exeter 010,E02004158,7649,1347,6302
2021,Exeter 011,E02004159,11982,2321,9661
2021,Exeter 012,E02004160,6846,1128,5718
2021,Exeter 013,E02004161,7924,1585,6339
2021,Exeter 014,E02004162,6637,961,5676
2021,Exeter 015,E02004163,7867,1304,6563
2021,Mid Devon 001,E02004164,6525,970,5555
2021,Mid Devon 002,E02004165,8490,1300,7190
2021,Mid Devon 003,E02004166,6491,1195,5296
2021,Mid Devon 004,E02004167,6807,1503,5304
2021,Mid Devon 005,E02004168,5900,1018,4882
2021,Mid Devon 006,E02004169,7213,1276,5937
2021,Mid Devon 007,E02004170,8268,1401,6867
2021,Mid Devon 008,E02004171,8094,1463,6631
2021,Mid Devon 009,E02004172,6241,1006,5235
2021,Mid Devon 010,E02004173,7170,1208,5962
2021,Mid Devon 011,E02004174,7630,1316,6314
2021,North Devon 001,E02004175,4943,773,4170
2021,North Devon 002,E02004176,5400,717,4683
2021,North Devon 003,E02004177,5651,973,4678
2021,North Devon 004,E02004178,5078,872,4206
2021,North Devon 005,E02004179,8788,1617,7171
2021,North Devon 006,E02004180,6243,1061,5182
2021,North Devon 007,E02004181,5464,919,4545
2021,North Devon 008,E02004182,5931,966,4965
2021,North Devon 009,E02004183,5618,782,4836
2021,North Devon 010,E02004184,8072,1600,6472
2021,North Devon 011,E02004185,6375,843,5532
2021,North Devon 012,E02004186,9536,1592,7944
2021,North Devon 013,E02004187,10218,1707,8511
2021,North Devon 014,E02004188,6782,959,5823
2021,South Hams 001,E02004189,5856,947,4909
2021,South Hams 002,E02004190,8344,1342,7002
2021,South Hams 003,E02004191,8654,1381,7273
2021,South Hams 004,E02004192,7456,1074,6382
2021,South Hams 005,E02004193,11379,2132,9247
2021,South Hams 006,E02004194,7021,1233,5788
2021,South Hams 007,E02004195,5081,651,4430
2021,South Hams 008,E02004196,7776,1329,6447
2021,South Hams 009,E02004197,6950,1034,5916
2021,South Hams 010,E02004198,6066,981,5085
2021,South Hams 011,E02004199,5579,700,4879
2021,South Hams 012,E02004200,4936,603,4333
2021,Teignbridge 001,E02004201,5289,740,4549
2021,Teignbridge 002,E02004202,8265,1426,6839
2021,Teignbridge 003,E02004203,5557,752,4805
2021,Teignbridge 004,E02004204,9376,1572,7804
2021,Teignbridge 005,E02004205,8203,1291,6912
2021,Teignbridge 006,E02004206,6480,718,5762
2021,Teignbridge 007,E02004207,6404,1017,5387
2021,Teignbridge 008,E02004208,8044,1236,6808
2021,Teignbridge 009,E02004209,8744,1477,7267
2021,Teignbridge 010,E02004210,6303,919,5384
2021,Teignbridge 011,E02004211,6403,837,5566
2021,Teignbridge 012,E02004212,5880,999,4881
2021,Teignbridge 013,E02004213,8589,1486,7103
2021,Teignbridge 014,E02004214,5726,887,4839
2021,Teignbridge 015,E02004215,5560,903,4657
2021,Teignbridge 016,E02004216,5336,810,4526
2021,Teignbridge 017,E02004217,7446,1278,6168
2021,Teignbridge 018,E02004218,5884,943,4941
2021,Teignbridge 019,E02004219,5409,817,4592
2021,Torridge 001,E02004220,5798,713,5085
2021,Torridge 002,E02004221,6182,731,5451
2021,Torridge 003,E02004222,5520,895,4625
2021,Torridge 004,E02004223,12267,2349,9918
2021,Torridge 005,E02004224,6222,829,5393
2021,Torridge 006,E02004225,5523,951,4572
2021,Torridge 007,E02004226,7061,917,6144
2021,Torridge 008,E02004227,9708,1499,8209
2021,Torridge 009,E02004228,7027,983,6044
2021,West Devon 001,E02004229,9481,1546,7935
2021,West Devon 002,E02004230,7381,1280,6101
2021,West Devon 003,E02004231,6844,915,5929
2021,West Devon 004,E02004232,6649,943,5706
2021,West Devon 005,E02004233,12190,2037,10153
2021,West Devon 006,E02004234,6035,843,5192
2021,West Devon 007,E02004235,6320,992,5328
2021,"Bournemouth, Christchurch and Poole 002",E02004236,5973,856,5117
2021,"Bournemouth, Christchurch and Poole 014",E02004237,7825,1551,6274
2021,"Bournemouth, Christchurch and Poole 019",E02004238,7302,832,6470
2021,"Bournemouth, Christchurch and Poole 018",E02004239,6015,871,5144
2021,"Bournemouth, Christchurch and Poole 024",E02004240,5762,1101,4661
2021,"Bournemouth, Christchurch and Poole 031",E02004241,9074,1616,7458
2021,"Bournemouth, Christchurch and Poole 033",E02004242,6275,735,5540
2021,Dorset 007,E02004243,6191,1011,5180
2021,Dorset 010,E02004244,7331,1130,6201
2021,Dorset 012,E02004245,7151,1196,5955
2021,Dorset 015,E02004246,7631,903,6728
2021,Dorset 013,E02004247,5888,970,4918
2021,Dorset 016,E02004248,7161,702,6459
2021,Dorset 017,E02004249,5721,961,4760
2021,Dorset 018,E02004250,7519,1019,6500
2021,Dorset 020,E02004251,6040,867,5173
2021,Dorset 021,E02004252,7586,1252,6334
2021,Dorset 024,E02004253,9493,1244,8249
2021,Dorset 025,E02004254,9902,1722,8180
2021,Dorset 001,E02004255,7043,1059,5984
2021,Dorset 002,E02004256,8829,1462,7367
2021,Dorset 003,E02004257,8672,1544,7128
2021,Dorset 005,E02004258,10058,1422,8636
2021,Dorset 006,E02004259,6958,1181,5777
2021,Dorset 009,E02004260,8632,1935,6697
2021,Dorset 011,E02004261,9844,1631,8213
2021,Dorset 014,E02004262,7623,1132,6491
2021,Dorset 027,E02004263,5573,934,4639
2021,Dorset 028,E02004264,8258,1415,6843
2021,Dorset 033,E02004265,8139,1163,6976
2021,Dorset 035,E02004266,7924,1403,6521
2021,Dorset 039,E02004267,4915,610,4305
2021,Dorset 042,E02004268,9114,1143,7971
2021,Dorset 004,E02004269,9975,2152,7823
2021,Dorset 008,E02004270,7535,1099,6436
2021,Dorset 019,E02004271,9706,1314,8392
2021,Dorset 022,E02004272,11717,1786,9931
2021,Dorset 023,E02004273,7000,872,6128
2021,Dorset 026,E02004274,6179,861,5318
2021,Dorset 029,E02004275,7409,988,6421
2021,Dorset 030,E02004276,5355,595,4760
2021,Dorset 034,E02004278,8440,1498,6942
2021,Dorset 036,E02004279,7721,1170,6551
2021,Dorset 037,E02004280,8037,1207,6830
2021,Dorset 038,E02004281,7248,1247,6001
2021,Dorset 040,E02004282,8608,1009,7599
2021,Dorset 041,E02004283,8703,1523,7180
2021,Dorset 044,E02004284,9174,1106,8068
2021,Dorset 043,E02004285,7367,1101,6266
2021,Dorset 045,E02004286,4850,806,4044
2021,Dorset 046,E02004287,5385,932,4453
2021,Dorset 047,E02004288,5940,877,5063
2021,Dorset 048,E02004289,6989,1100,5889
2021,County Durham 002,E02004290,5499,817,4682
2021,County Durham 005,E02004291,6740,1152,5588
2021,County Durham 007,E02004292,7633,1194,6439
2021,County Durham 011,E02004293,9088,1703,7385
2021,County Durham 013,E02004294,7645,1232,6413
2021,County Durham 015,E02004295,6986,1228,5758
2021,County Durham 019,E02004296,7977,1442,6535
2021,County Durham 001,E02004297,7584,1233,6351
2021,County Durham 003,E02004298,9507,1561,7946
2021,County Durham 004,E02004299,7851,1368,6483
2021,County Durham 006,E02004300,7297,1314,5983
2021,County Durham 008,E02004301,9089,1946,7143
2021,County Durham 009,E02004302,7408,1289,6119
2021,County Durham 010,E02004303,10567,1666,8901
2021,County Durham 012,E02004304,8544,1695,6849
2021,County Durham 014,E02004305,9572,1960,7612
2021,County Durham 020,E02004306,5716,978,4738
2021,County Durham 024,E02004307,6136,978,5158
2021,County Durham 022,E02004308,7483,1088,6395
2021,County Durham 023,E02004309,5907,1181,4726
2021,County Durham 026,E02004310,7399,1314,6085
2021,County Durham 027,E02004311,8693,1413,7280
2021,County Durham 028,E02004312,7124,1075,6049
2021,County Durham 029,E02004313,6441,2294,4147
2021,County Durham 030,E02004314,12608,10073,2535
2021,County Durham 033,E02004315,12742,5107,7635
2021,County Durham 031,E02004316,6149,1140,5009
2021,County Durham 038,E02004317,7008,1188,5820
2021,County Durham 041,E02004318,6241,1046,5195
2021,County Durham 044,E02004319,7560,1330,6230
2021,County Durham 016,E02004320,8188,1429,6759
2021,County Durham 017,E02004321,7747,1370,6377
2021,County Durham 018,E02004322,8138,1675,6463
2021,County Durham 021,E02004323,7010,1215,5795
2021,County Durham 025,E02004324,5475,938,4537
2021,County Durham 032,E02004325,8424,1786,6638
2021,County Durham 034,E02004326,6370,1199,5171
2021,County Durham 036,E02004327,5282,864,4418
2021,County Durham 035,E02004328,6793,1396,5397
2021,County Durham 037,E02004329,6210,1010,5200
2021,County Durham 039,E02004330,5677,847,4830
2021,County Durham 040,E02004331,6787,1127,5660
2021,County Durham 043,E02004332,6987,1307,5680
2021,County Durham 047,E02004333,6435,979,5456
2021,County Durham 048,E02004334,6674,1222,5452
2021,County Durham 049,E02004335,7264,1314,5950
2021,County Durham 050,E02004336,6378,990,5388
2021,County Durham 052,E02004337,9986,1784,8202
2021,County Durham 053,E02004338,6956,1159,5797
2021,County Durham 054,E02004339,6768,1199,5569
2021,County Durham 059,E02004340,9838,1753,8085
2021,County Durham 060,E02004341,8340,1335,7005
2021,County Durham 061,E02004342,5200,1240,3960
2021,County Durham 062,E02004343,5268,954,4314
2021,County Durham 063,E02004344,6645,1184,5461
2021,County Durham 064,E02004345,12085,1831,10254
2021,County Durham 042,E02004348,7598,1068,6530
2021,County Durham 045,E02004349,8772,1622,7150
2021,County Durham 046,E02004350,9336,1549,7787
2021,County Durham 051,E02004351,6870,1302,5568
2021,County Durham 055,E02004352,7707,1324,6383
2021,County Durham 056,E02004353,6917,1118,5799
2021,County Durham 057,E02004354,8617,1587,7030
2021,County Durham 058,E02004355,6645,1370,5275
2021,Eastbourne 001,E02004356,6998,1400,5598
2021,Eastbourne 002,E02004357,7229,1593,5636
2021,Eastbourne 003,E02004358,7599,1403,6196
2021,Eastbourne 004,E02004359,7435,1258,6177
2021,Eastbourne 006,E02004361,7805,1645,6160
2021,Eastbourne 007,E02004362,8343,1753,6590
2021,Eastbourne 008,E02004363,6656,951,5705
2021,Eastbourne 009,E02004364,7880,1359,6521
2021,Eastbourne 010,E02004365,7908,1517,6391
2021,Eastbourne 011,E02004366,7364,1101,6263
2021,Eastbourne 012,E02004367,6586,952,5634
2021,Hastings 001,E02004368,7854,1491,6363
2021,Hastings 002,E02004369,9679,1448,8231
2021,Hastings 003,E02004370,7558,1698,5860
2021,Hastings 004,E02004371,6639,1330,5309
2021,Hastings 005,E02004372,6616,1591,5025
2021,Hastings 006,E02004373,8311,1538,6773
2021,Hastings 007,E02004374,6978,1136,5842
2021,Hastings 008,E02004375,7981,1321,6660
2021,Hastings 009,E02004376,6548,985,5563
2021,Hastings 010,E02004377,10219,1670,8549
2021,Hastings 011,E02004378,7784,1031,6753
2021,Lewes 001,E02004379,7307,1391,5916
2021,Lewes 002,E02004380,9239,1658,7581
2021,Lewes 003,E02004381,8972,1646,7326
2021,Lewes 004,E02004382,6240,1075,5165
2021,Lewes 005,E02004383,7054,1416,5638
2021,Lewes 006,E02004384,7075,1171,5904
2021,Lewes 007,E02004385,7274,1117,6157
2021,Lewes 008,E02004386,6240,1046,5194
2021,Lewes 009,E02004387,5651,1294,4357
2021,Lewes 010,E02004388,7365,1275,6090
2021,Lewes 011,E02004389,8987,1147,7840
2021,Lewes 012,E02004390,7728,1246,6482
2021,Lewes 013,E02004391,6236,769,5467
2021,Rother 001,E02004392,8803,1576,7227
2021,Rother 002,E02004393,6139,837,5302
2021,Rother 003,E02004394,7599,1141,6458
2021,Rother 004,E02004395,7337,1023,6314
2021,Rother 005,E02004396,8925,1237,7688
2021,Rother 006,E02004397,7796,1495,6301
2021,Rother 007,E02004398,8756,1802,6954
2021,Rother 008,E02004399,7708,1051,6657
2021,Rother 009,E02004400,10240,1023,9217
2021,Rother 010,E02004401,7505,826,6679
2021,Rother 011,E02004402,8570,1101,7469
2021,Wealden 001,E02004403,6159,1132,5027
2021,Wealden 002,E02004404,6152,1094,5058
2021,Wealden 003,E02004405,5749,1072,4677
2021,Wealden 004,E02004406,7029,1017,6012
2021,Wealden 005,E02004407,7804,1402,6402
2021,Wealden 006,E02004408,7922,1382,6540
2021,Wealden 007,E02004409,5158,799,4359
2021,Wealden 008,E02004410,7719,1242,6477
2021,Wealden 009,E02004411,8109,1452,6657
2021,Wealden 010,E02004412,7688,1224,6464
2021,Wealden 011,E02004413,7018,1088,5930
2021,Wealden 012,E02004414,6184,1122,5062
2021,Wealden 013,E02004415,6446,1081,5365
2021,Wealden 014,E02004416,6232,958,5274
2021,Wealden 015,E02004417,6206,949,5257
2021,Wealden 016,E02004418,5484,883,4601
2021,Wealden 017,E02004419,5962,1073,4889
2021,Wealden 018,E02004420,13259,2327,10932
2021,Wealden 019,E02004421,8851,1394,7457
2021,Wealden 020,E02004422,10560,1672,8888
2021,Wealden 021,E02004423,7279,934,6345
2021,Basildon 001,E02004424,6733,1327,5406
2021,Basildon 002,E02004425,6908,1236,5672
2021,Basildon 003,E02004426,7640,1370,6270
2021,Basildon 004,E02004427,7633,1311,6322
2021,Basildon 005,E02004428,6609,1068,5541
2021,Basildon 006,E02004429,7249,1140,6109
2021,Basildon 007,E02004430,7980,1515,6465
2021,Basildon 008,E02004431,9043,1687,7356
2021,Basildon 009,E02004432,6140,1059,5081
2021,Basildon 010,E02004433,8200,1457,6743
2021,Basildon 011,E02004434,8031,1467,6564
2021,Basildon 012,E02004435,9036,1968,7068
2021,Basildon 013,E02004436,7347,1774,5573
2021,Basildon 014,E02004437,9357,1763,7594
2021,Basildon 015,E02004438,8799,1828,6971
2021,Basildon 016,E02004439,9005,2352,6653
2021,Basildon 017,E02004440,8511,1815,6696
2021,Basildon 018,E02004441,7333,1416,5917
2021,Basildon 019,E02004442,8002,2000,6002
2021,Basildon 020,E02004443,9582,1675,7907
2021,Basildon 021,E02004444,8484,1513,6971
2021,Basildon 022,E02004445,7757,1526,6231
2021,Braintree 001,E02004446,6748,1132,5616
2021,Braintree 002,E02004447,5741,811,4930
2021,Braintree 003,E02004448,7373,1217,6156
2021,Braintree 004,E02004449,8379,1516,6863
2021,Braintree 005,E02004450,6023,859,5164
2021,Braintree 006,E02004451,9032,1557,7475
2021,Braintree 007,E02004452,8883,1591,7292
2021,Braintree 008,E02004453,6949,1368,5581
2021,Braintree 009,E02004454,8853,1349,7504
2021,Braintree 010,E02004455,7531,1436,6095
2021,Braintree 011,E02004456,9209,1733,7476
2021,Braintree 012,E02004457,9958,1903,8055
2021,Braintree 013,E02004458,9085,1930,7155
2021,Braintree 014,E02004459,9923,1728,8195
2021,Braintree 015,E02004460,9151,1601,7550
2021,Braintree 016,E02004461,5378,1157,4221
2021,Braintree 017,E02004462,10868,1799,9069
2021,Braintree 018,E02004463,7731,1284,6447
2021,Brentwood 001,E02004464,9444,1578,7866
2021,Brentwood 002,E02004465,6045,989,5056
2021,Brentwood 003,E02004466,7754,1498,6256
2021,Brentwood 004,E02004467,7690,1555,6135
2021,Brentwood 005,E02004468,10097,1949,8148
2021,Brentwood 006,E02004469,6844,1259,5585
2021,Brentwood 007,E02004470,11006,1666,9340
2021,Brentwood 008,E02004471,8009,1436,6573
2021,Brentwood 009,E02004472,5878,979,4899
2021,Castle Point 001,E02004473,7402,1331,6071
2021,Castle Point 002,E02004474,7578,1203,6375
2021,Castle Point 003,E02004475,6322,1100,5222
2021,Castle Point 004,E02004476,7706,1305,6401
2021,Castle Point 005,E02004477,5770,781,4989
2021,Castle Point 006,E02004478,6369,1066,5303
2021,Castle Point 007,E02004479,7666,1207,6459
2021,Castle Point 008,E02004480,6563,1301,5262
2021,Castle Point 009,E02004481,6400,782,5618
2021,Castle Point 010,E02004482,7874,1641,6233
2021,Castle Point 011,E02004483,7636,1138,6498
2021,Castle Point 012,E02004484,7988,1158,6830
2021,Chelmsford 001,E02004485,9154,1957,7197
2021,Chelmsford 002,E02004486,8186,1514,6672
2021,Chelmsford 003,E02004487,7165,1513,5652
2021,Chelmsford 004,E02004488,9327,1810,7517
2021,Chelmsford 005,E02004489,9024,2108,6916
2021,Chelmsford 006,E02004490,7449,1677,5772
2021,Chelmsford 007,E02004491,7095,1379,5716
2021,Chelmsford 008,E02004492,8850,1663,7187
2021,Chelmsford 009,E02004493,9766,1920,7846
2021,Chelmsford 011,E02004495,7919,1421,6498
2021,Chelmsford 012,E02004496,7784,1597,6187
2021,Chelmsford 013,E02004497,7487,1251,6236
2021,Chelmsford 014,E02004498,9335,1787,7548
2021,Chelmsford 015,E02004499,6491,1237,5254
2021,Chelmsford 016,E02004500,8847,1590,7257
2021,Chelmsford 017,E02004501,6663,1149,5514
2021,Chelmsford 018,E02004502,6969,1025,5944
2021,Chelmsford 019,E02004503,7593,1399,6194
2021,Chelmsford 020,E02004504,7553,1290,6263
2021,Chelmsford 021,E02004505,6124,887,5237
2021,Colchester 001,E02004506,6815,1243,5572
2021,Colchester 002,E02004507,9151,2071,7080
2021,Colchester 003,E02004508,6294,1127,5167
2021,Colchester 007,E02004512,10665,1872,8793
2021,Colchester 008,E02004513,10812,4760,6052
2021,Colchester 009,E02004514,5568,1121,4447
2021,Colchester 010,E02004515,9090,1736,7354
2021,Colchester 011,E02004516,12447,3542,8905
2021,Colchester 012,E02004517,9070,1755,7315
2021,Colchester 013,E02004518,7582,1733,5849
2021,Colchester 014,E02004519,7198,1325,5873
2021,Colchester 015,E02004520,8889,2210,6679
2021,Colchester 016,E02004521,8881,1796,7085
2021,Colchester 017,E02004522,8618,2732,5886
2021,Colchester 018,E02004523,9774,2137,7637
2021,Colchester 019,E02004524,7973,1355,6618
2021,Colchester 020,E02004525,7709,1199,6510
2021,Colchester 021,E02004526,7001,917,6084
2021,Epping Forest 001,E02004527,8812,1485,7327
2021,Epping Forest 002,E02004528,8409,1277,7132
2021,Epping Forest 003,E02004529,7027,1157,5870
2021,Epping Forest 004,E02004530,6687,1279,5408
2021,Epping Forest 005,E02004531,6702,1244,5458
2021,Epping Forest 006,E02004532,6050,954,5096
2021,Epping Forest 007,E02004533,7261,1335,5926
2021,Epping Forest 008,E02004534,8446,1646,6800
2021,Epping Forest 009,E02004535,5733,856,4877
2021,Epping Forest 010,E02004536,5938,1004,4934
2021,Epping Forest 011,E02004537,8872,1888,6984
2021,Epping Forest 012,E02004538,9340,1760,7580
2021,Epping Forest 013,E02004539,7415,1437,5978
2021,Epping Forest 014,E02004540,5682,1079,4603
2021,Epping Forest 015,E02004541,11018,2012,9006
2021,Epping Forest 016,E02004542,6607,1248,5359
2021,Epping Forest 017,E02004543,7060,1523,5537
2021,Harlow 001,E02004544,10328,1950,8378
2021,Harlow 002,E02004545,7456,1641,5815
2021,Harlow 003,E02004546,7936,1647,6289
2021,Harlow 004,E02004547,9314,2041,7273
2021,Harlow 005,E02004548,8380,1773,6607
2021,Harlow 006,E02004549,7630,1594,6036
2021,Harlow 007,E02004550,8183,1746,6437
2021,Harlow 008,E02004551,7132,1441,5691
2021,Harlow 009,E02004552,6209,1081,5128
2021,Harlow 010,E02004553,7270,1576,5694
2021,Harlow 011,E02004554,7240,1561,5679
2021,Maldon 001,E02004555,6253,998,5255
2021,Maldon 002,E02004556,7244,1245,5999
2021,Maldon 003,E02004557,8403,1435,6968
2021,Maldon 004,E02004558,6557,949,5608
2021,Maldon 005,E02004559,7689,1225,6464
2021,Maldon 006,E02004560,8621,1385,7236
2021,Maldon 007,E02004561,9995,1534,8461
2021,Maldon 008,E02004562,8405,1266,7139
2021,Rochford 001,E02004563,6360,871,5489
2021,Rochford 002,E02004564,7579,1221,6358
2021,Rochford 004,E02004566,5307,992,4315
2021,Rochford 005,E02004567,7775,1291,6484
2021,Rochford 006,E02004568,8321,1604,6717
2021,Rochford 007,E02004569,8120,1393,6727
2021,Rochford 008,E02004570,8260,1445,6815
2021,Rochford 009,E02004571,7459,1280,6179
2021,Rochford 010,E02004572,7522,1292,6230
2021,Tendring 001,E02004573,6064,1049,5015
2021,Tendring 002,E02004574,7358,1450,5908
2021,Tendring 003,E02004575,11518,1831,9687
2021,Tendring 004,E02004576,8759,1406,7353
2021,Tendring 005,E02004577,5835,996,4839
2021,Tendring 006,E02004578,7290,925,6365
2021,Tendring 007,E02004579,7602,1123,6479
2021,Tendring 008,E02004580,11893,1478,10415
2021,Tendring 009,E02004581,8118,1282,6836
2021,Tendring 010,E02004582,6727,807,5920
2021,Tendring 011,E02004583,8532,1332,7200
2021,Tendring 012,E02004584,6432,595,5837
2021,Tendring 013,E02004585,8580,1426,7154
2021,Tendring 014,E02004586,7862,1231,6631
2021,Tendring 015,E02004587,7278,1388,5890
2021,Tendring 016,E02004588,6750,1127,5623
2021,Tendring 017,E02004589,7057,1192,5865
2021,Tendring 018,E02004590,7947,877,7070
2021,Uttlesford 001,E02004591,7235,1408,5827
2021,Uttlesford 002,E02004592,12423,2334,10089
2021,Uttlesford 003,E02004593,8550,1500,7050
2021,Uttlesford 004,E02004594,7898,1461,6437
2021,Uttlesford 005,E02004595,13931,2593,11338
2021,Uttlesford 006,E02004596,9924,2082,7842
2021,Uttlesford 007,E02004597,8446,1495,6951
2021,Uttlesford 008,E02004598,10468,2172,8296
2021,Uttlesford 009,E02004599,7436,1410,6026
2021,Cheltenham 001,E02004600,5234,802,4432
2021,Cheltenham 002,E02004601,5830,1113,4717
2021,Cheltenham 003,E02004602,6313,1224,5089
2021,Cheltenham 004,E02004603,7779,2548,5231
2021,Cheltenham 005,E02004604,7645,1632,6013
2021,Cheltenham 006,E02004605,5500,1139,4361
2021,Cheltenham 007,E02004606,9901,1616,8285
2021,Cheltenham 008,E02004607,9151,1222,7929
2021,Cheltenham 009,E02004608,9647,1801,7846
2021,Cheltenham 010,E02004609,6791,1127,5664
2021,Cheltenham 011,E02004610,7342,1442,5900
2021,Cheltenham 012,E02004611,11551,2621,8930
2021,Cheltenham 013,E02004612,8906,1619,7287
2021,Cheltenham 014,E02004613,6134,1157,4977
2021,Cheltenham 015,E02004614,5256,991,4265
2021,Cotswold 001,E02004615,8377,1227,7150
2021,Cotswold 002,E02004616,9575,1322,8253
2021,Cotswold 003,E02004617,9070,1573,7497
2021,Cotswold 004,E02004618,7000,1242,5758
2021,Cotswold 005,E02004619,6920,1040,5880
2021,Cotswold 006,E02004620,7996,1535,6461
2021,Cotswold 007,E02004621,5897,975,4922
2021,Cotswold 008,E02004622,7125,1209,5916
2021,Cotswold 009,E02004623,8824,1470,7354
2021,Cotswold 010,E02004624,6293,1069,5224
2021,Cotswold 011,E02004625,9739,1521,8218
2021,Forest of Dean 001,E02004626,9628,2292,7336
2021,Forest of Dean 002,E02004627,6031,961,5070
2021,Forest of Dean 003,E02004628,7519,1256,6263
2021,Forest of Dean 004,E02004629,12316,2079,10237
2021,Forest of Dean 005,E02004630,6334,880,5454
2021,Forest of Dean 006,E02004631,4932,666,4266
2021,Forest of Dean 007,E02004632,10340,1671,8669
2021,Forest of Dean 008,E02004633,7971,1246,6725
2021,Forest of Dean 009,E02004634,10700,1688,9012
2021,Forest of Dean 010,E02004635,7256,1154,6102
2021,Gloucester 001,E02004636,7505,1395,6110
2021,Gloucester 002,E02004637,8918,1819,7099
2021,Gloucester 003,E02004638,5583,1038,4545
2021,Gloucester 004,E02004639,10980,2254,8726
2021,Gloucester 005,E02004640,8000,1970,6030
2021,Gloucester 006,E02004641,7087,1061,6026
2021,Gloucester 007,E02004642,11481,2397,9084
2021,Gloucester 008,E02004643,7729,1843,5886
2021,Gloucester 009,E02004644,8615,1781,6834
2021,Gloucester 010,E02004645,8617,1442,7175
2021,Gloucester 011,E02004646,8617,1696,6921
2021,Gloucester 012,E02004647,5874,1056,4818
2021,Gloucester 013,E02004648,5423,841,4582
2021,Gloucester 014,E02004649,6867,1283,5584
2021,Gloucester 015,E02004650,13661,3280,10381
2021,Stroud 001,E02004651,10411,2078,8333
2021,Stroud 002,E02004652,6462,1006,5456
2021,Stroud 003,E02004653,7410,1235,6175
2021,Stroud 004,E02004654,10980,1925,9055
2021,Stroud 005,E02004655,7697,1364,6333
2021,Stroud 006,E02004656,10814,1788,9026
2021,Stroud 007,E02004657,6471,1139,5332
2021,Stroud 008,E02004658,6029,1100,4929
2021,Stroud 009,E02004659,6800,1095,5705
2021,Stroud 010,E02004660,6451,1086,5365
2021,Stroud 011,E02004661,8110,1193,6917
2021,Stroud 012,E02004662,6245,963,5282
2021,Stroud 013,E02004663,6230,1040,5190
2021,Stroud 014,E02004664,7021,1294,5727
2021,Stroud 015,E02004665,8329,1501,6828
2021,Tewkesbury 001,E02004666,11419,2144,9275
2021,Tewkesbury 002,E02004667,10143,1462,8681
2021,Tewkesbury 003,E02004668,8694,1296,7398
2021,Tewkesbury 004,E02004669,7150,1193,5957
2021,Tewkesbury 006,E02004671,6763,1124,5639
2021,Tewkesbury 007,E02004672,11689,2095,9594
2021,Tewkesbury 008,E02004673,7250,1273,5977
2021,Tewkesbury 009,E02004674,11452,2182,9270
2021,Basingstoke and Deane 001,E02004675,7305,1280,6025
2021,Basingstoke and Deane 002,E02004676,7639,1183,6456
2021,Basingstoke and Deane 003,E02004677,7253,1422,5831
2021,Basingstoke and Deane 004,E02004678,7231,1179,6052
2021,Basingstoke and Deane 005,E02004679,10355,1919,8436
2021,Basingstoke and Deane 006,E02004680,7349,1337,6012
2021,Basingstoke and Deane 007,E02004681,13814,3043,10771
2021,Basingstoke and Deane 008,E02004682,7865,1489,6376
2021,Basingstoke and Deane 009,E02004683,7620,1259,6361
2021,Basingstoke and Deane 010,E02004684,10577,1974,8603
2021,Basingstoke and Deane 011,E02004685,7500,1027,6473
2021,Basingstoke and Deane 012,E02004686,8299,1338,6961
2021,Basingstoke and Deane 013,E02004687,7171,1613,5558
2021,Basingstoke and Deane 014,E02004688,7376,1284,6092
2021,Basingstoke and Deane 015,E02004689,5451,863,4588
2021,Basingstoke and Deane 016,E02004690,7717,1333,6384
2021,Basingstoke and Deane 017,E02004691,7628,1212,6416
2021,Basingstoke and Deane 018,E02004692,6975,1072,5903
2021,Basingstoke and Deane 019,E02004693,6995,1320,5675
2021,Basingstoke and Deane 020,E02004694,7106,1249,5857
2021,Basingstoke and Deane 021,E02004695,8277,1838,6439
2021,Basingstoke and Deane 022,E02004696,7098,1228,5870
2021,East Hampshire 001,E02004697,6532,1299,5233
2021,East Hampshire 002,E02004698,6180,1089,5091
2021,East Hampshire 003,E02004699,10251,1640,8611
2021,East Hampshire 004,E02004700,6317,1187,5130
2021,East Hampshire 006,E02004702,7564,1261,6303
2021,East Hampshire 007,E02004703,12103,2147,9956
2021,East Hampshire 008,E02004704,5928,966,4962
2021,East Hampshire 009,E02004705,9327,1833,7494
2021,East Hampshire 010,E02004706,7310,1274,6036
2021,East Hampshire 011,E02004707,10798,2068,8730
2021,East Hampshire 012,E02004708,9098,1655,7443
2021,East Hampshire 013,E02004709,8295,1455,6840
2021,East Hampshire 014,E02004710,6262,1066,5196
2021,Eastleigh 001,E02004712,8452,1849,6603
2021,Eastleigh 002,E02004713,7625,1440,6185
2021,Eastleigh 003,E02004714,7199,1117,6082
2021,Eastleigh 004,E02004715,8472,1487,6985
2021,Eastleigh 005,E02004716,8247,1469,6778
2021,Eastleigh 006,E02004717,12070,2591,9479
2021,Eastleigh 007,E02004718,8179,1422,6757
2021,Eastleigh 008,E02004719,10854,1894,8960
2021,Eastleigh 009,E02004720,10832,1626,9206
2021,Eastleigh 010,E02004721,10931,2634,8297
2021,Eastleigh 011,E02004722,6671,1179,5492
2021,Eastleigh 012,E02004723,9344,1612,7732
2021,Eastleigh 013,E02004724,9038,1636,7402
2021,Eastleigh 014,E02004725,5217,841,4376
2021,Eastleigh 015,E02004726,5721,910,4811
2021,Fareham 001,E02004727,9703,2141,7562
2021,Fareham 002,E02004728,8624,1500,7124
2021,Fareham 003,E02004729,6892,1123,5769
2021,Fareham 004,E02004730,8321,1270,7051
2021,Fareham 005,E02004731,7257,1154,6103
2021,Fareham 006,E02004732,8422,1490,6932
2021,Fareham 007,E02004733,7631,1274,6357
2021,Fareham 008,E02004734,9682,1467,8215
2021,Fareham 009,E02004735,7154,971,6183
2021,Fareham 010,E02004736,7793,1198,6595
2021,Fareham 011,E02004737,7113,1256,5857
2021,Fareham 012,E02004738,6916,1043,5873
2021,Fareham 013,E02004739,7004,1017,5987
2021,Fareham 014,E02004740,6838,1039,5799
2021,Gosport 001,E02004741,7182,1267,5915
2021,Gosport 002,E02004742,6702,1070,5632
2021,Gosport 003,E02004743,6926,1147,5779
2021,Gosport 004,E02004744,8943,2169,6774
2021,Gosport 005,E02004745,8028,1395,6633
2021,Gosport 006,E02004746,10679,1914,8765
2021,Gosport 007,E02004747,5934,944,4990
2021,Gosport 008,E02004748,8843,1406,7437
2021,Gosport 009,E02004749,6926,1152,5774
2021,Gosport 010,E02004750,7546,1129,6417
2021,Hart 001,E02004751,8024,1289,6735
2021,Hart 002,E02004752,7580,1413,6167
2021,Hart 003,E02004753,10988,1838,9150
2021,Hart 004,E02004754,6824,1237,5587
2021,Hart 005,E02004755,11513,2304,9209
2021,Hart 006,E02004756,9081,1822,7259
2021,Hart 007,E02004757,7598,1430,6168
2021,Hart 008,E02004758,8713,1664,7049
2021,Hart 009,E02004759,7826,1555,6271
2021,Hart 010,E02004760,9964,2247,7717
2021,Hart 011,E02004761,6139,1101,5038
2021,Havant 003,E02004764,7879,1062,6817
2021,Havant 004,E02004765,5793,860,4933
2021,Havant 005,E02004766,6739,1192,5547
2021,Havant 006,E02004767,5436,1218,4218
2021,Havant 007,E02004768,5067,945,4122
2021,Havant 008,E02004769,5912,1379,4533
2021,Havant 009,E02004770,6393,1352,5041
2021,Havant 010,E02004771,8370,1737,6633
2021,Havant 011,E02004772,8933,1411,7522
2021,Havant 013,E02004774,9850,1449,8401
2021,Havant 014,E02004775,9812,1557,8255
2021,Havant 015,E02004776,5787,732,5055
2021,Havant 016,E02004777,5069,609,4460
2021,Havant 017,E02004778,5971,696,5275
2021,New Forest 001,E02004779,10508,1501,9007
2021,New Forest 002,E02004780,5555,905,4650
2021,New Forest 003,E02004781,7610,1360,6250
2021,New Forest 004,E02004782,7335,1198,6137
2021,New Forest 005,E02004783,6675,1206,5469
2021,New Forest 006,E02004784,5462,783,4679
2021,New Forest 007,E02004785,5351,716,4635
2021,New Forest 008,E02004786,7816,1421,6395
2021,New Forest 009,E02004787,6991,915,6076
2021,New Forest 010,E02004788,6959,1236,5723
2021,New Forest 011,E02004789,9908,1726,8182
2021,New Forest 012,E02004790,7675,1259,6416
2021,New Forest 013,E02004791,5265,1132,4133
2021,New Forest 014,E02004792,8067,1118,6949
2021,New Forest 015,E02004793,7154,1063,6091
2021,New Forest 016,E02004794,6653,1171,5482
2021,New Forest 017,E02004795,8242,1171,7071
2021,New Forest 018,E02004796,9312,1218,8094
2021,New Forest 019,E02004797,7733,1272,6461
2021,New Forest 020,E02004798,5859,1036,4823
2021,New Forest 021,E02004799,7610,941,6669
2021,New Forest 022,E02004800,7269,589,6680
2021,New Forest 023,E02004801,7539,824,6715
2021,Rushmoor 001,E02004802,6389,1117,5272
2021,Rushmoor 002,E02004803,7080,1433,5647
2021,Rushmoor 003,E02004804,6775,1150,5625
2021,Rushmoor 004,E02004805,8109,1370,6739
2021,Rushmoor 005,E02004806,7550,1399,6151
2021,Rushmoor 006,E02004807,8870,1560,7310
2021,Rushmoor 007,E02004808,11363,2020,9343
2021,Rushmoor 008,E02004809,9840,1856,7984
2021,Rushmoor 009,E02004810,7533,1321,6212
2021,Rushmoor 010,E02004811,7565,1161,6404
2021,Rushmoor 011,E02004812,6384,1089,5295
2021,Rushmoor 012,E02004813,6102,1176,4926
2021,Test Valley 001,E02004814,6743,1127,5616
2021,Test Valley 002,E02004815,6936,1628,5308
2021,Test Valley 004,E02004817,7149,1210,5939
2021,Test Valley 005,E02004818,9814,1584,8230
2021,Test Valley 006,E02004819,7471,1159,6312
2021,Test Valley 007,E02004820,6925,1195,5730
2021,Test Valley 008,E02004821,5020,890,4130
2021,Test Valley 009,E02004822,7675,1190,6485
2021,Test Valley 010,E02004823,8223,1292,6931
2021,Test Valley 011,E02004824,5663,663,5000
2021,Test Valley 012,E02004825,10414,1774,8640
2021,Test Valley 013,E02004826,9171,1594,7577
2021,Test Valley 014,E02004827,6994,1482,5512
2021,Test Valley 015,E02004828,6910,1171,5739
2021,Winchester 001,E02004829,5553,1031,4522
2021,Winchester 002,E02004830,6609,1208,5401
2021,Winchester 003,E02004831,9956,2128,7828
2021,Winchester 004,E02004832,8214,1368,6846
2021,Winchester 005,E02004833,9621,2710,6911
2021,Winchester 006,E02004834,7280,1812,5468
2021,Winchester 007,E02004835,10300,2878,7422
2021,Winchester 008,E02004836,6536,3116,3420
2021,Winchester 009,E02004837,7882,1788,6094
2021,Winchester 010,E02004838,9272,1897,7375
2021,Winchester 011,E02004839,8555,1537,7018
2021,Winchester 012,E02004840,9679,1587,8092
2021,Winchester 013,E02004841,11116,2016,9100
2021,Winchester 014,E02004842,10830,1896,8934
2021,Broxbourne 001,E02004843,6884,1341,5543
2021,Broxbourne 002,E02004844,7040,1431,5609
2021,Broxbourne 003,E02004845,7415,1249,6166
2021,Broxbourne 004,E02004846,6118,1140,4978
2021,Broxbourne 005,E02004847,9605,2072,7533
2021,Broxbourne 006,E02004848,7265,1478,5787
2021,Broxbourne 007,E02004849,6451,1091,5360
2021,Broxbourne 008,E02004850,7002,1271,5731
2021,Broxbourne 009,E02004851,5609,1122,4487
2021,Broxbourne 010,E02004852,7562,1481,6081
2021,Broxbourne 011,E02004853,6547,1317,5230
2021,Broxbourne 012,E02004854,7594,1417,6177
2021,Broxbourne 013,E02004855,7968,1694,6274
2021,Dacorum 001,E02004856,5468,1047,4421
2021,Dacorum 002,E02004857,5736,1158,4578
2021,Dacorum 003,E02004858,4727,961,3766
2021,Dacorum 004,E02004859,5072,944,4128
2021,Dacorum 005,E02004860,5347,1061,4286
2021,Dacorum 006,E02004861,5301,933,4368
2021,Dacorum 007,E02004862,7304,1541,5763
2021,Dacorum 008,E02004863,7352,1576,5776
2021,Dacorum 009,E02004864,6045,1035,5010
2021,Dacorum 010,E02004865,5184,955,4229
2021,Dacorum 011,E02004866,6340,1242,5098
2021,Dacorum 012,E02004867,6111,1398,4713
2021,Dacorum 013,E02004868,7072,1443,5629
2021,Dacorum 014,E02004869,5528,1171,4357
2021,Dacorum 015,E02004870,10817,2042,8775
2021,Dacorum 016,E02004871,4730,903,3827
2021,Dacorum 017,E02004872,7002,1340,5662
2021,Dacorum 018,E02004873,10893,1870,9023
2021,Dacorum 019,E02004874,5645,1057,4588
2021,Dacorum 020,E02004875,9732,2102,7630
2021,Dacorum 021,E02004876,9111,1523,7588
2021,Dacorum 022,E02004877,4983,885,4098
2021,East Hertfordshire 001,E02004878,8708,1668,7040
2021,East Hertfordshire 003,E02004880,10203,2104,8099
2021,East Hertfordshire 004,E02004881,6483,1160,5323
2021,East Hertfordshire 005,E02004882,8056,1837,6219
2021,East Hertfordshire 006,E02004883,5918,1135,4783
2021,East Hertfordshire 007,E02004884,9815,1708,8107
2021,East Hertfordshire 008,E02004885,8179,1758,6421
2021,East Hertfordshire 009,E02004886,6285,1175,5110
2021,East Hertfordshire 010,E02004887,7180,1288,5892
2021,East Hertfordshire 011,E02004888,8302,1522,6780
2021,East Hertfordshire 012,E02004889,10577,1990,8587
2021,East Hertfordshire 013,E02004890,7947,1272,6675
2021,East Hertfordshire 014,E02004891,7431,1364,6067
2021,East Hertfordshire 015,E02004892,5462,1050,4412
2021,East Hertfordshire 016,E02004893,5576,1203,4373
2021,East Hertfordshire 017,E02004894,9057,1475,7582
2021,East Hertfordshire 018,E02004895,8941,2056,6885
2021,Hertsmere 001,E02004896,7625,1344,6281
2021,Hertsmere 002,E02004897,6503,1489,5014
2021,Hertsmere 003,E02004898,7342,1605,5737
2021,Hertsmere 004,E02004899,5114,1085,4029
2021,Hertsmere 005,E02004900,7810,1645,6165
2021,Hertsmere 006,E02004901,9491,2064,7427
2021,Hertsmere 007,E02004902,7548,1738,5810
2021,Hertsmere 008,E02004903,7040,1562,5478
2021,Hertsmere 009,E02004904,6386,1284,5102
2021,Hertsmere 010,E02004905,6237,1346,4891
2021,Hertsmere 011,E02004906,10289,2263,8026
2021,Hertsmere 012,E02004907,10143,2088,8055
2021,Hertsmere 013,E02004908,10002,1905,8097
2021,North Hertfordshire 001,E02004909,5415,892,4523
2021,North Hertfordshire 002,E02004910,10861,1849,9012
2021,North Hertfordshire 003,E02004911,6417,1180,5237
2021,North Hertfordshire 004,E02004912,10121,1802,8319
2021,North Hertfordshire 006,E02004914,7551,1430,6121
2021,North Hertfordshire 007,E02004915,5318,1010,4308
2021,North Hertfordshire 008,E02004916,7079,1324,5755
2021,North Hertfordshire 009,E02004917,6059,1057,5002
2021,North Hertfordshire 010,E02004918,7621,1327,6294
2021,North Hertfordshire 011,E02004919,7262,1450,5812
2021,North Hertfordshire 012,E02004920,10908,2021,8887
2021,North Hertfordshire 013,E02004921,7422,1497,5925
2021,North Hertfordshire 014,E02004922,9598,1781,7817
2021,North Hertfordshire 015,E02004923,9853,1735,8118
2021,St Albans 001,E02004924,7340,1934,5406
2021,St Albans 002,E02004925,7443,1982,5461
2021,St Albans 003,E02004926,7673,1788,5885
2021,St Albans 004,E02004927,6341,1390,4951
2021,St Albans 005,E02004928,6462,1432,5030
2021,St Albans 006,E02004929,6044,1223,4821
2021,St Albans 007,E02004930,6611,1423,5188
2021,St Albans 008,E02004931,6623,1611,5012
2021,St Albans 009,E02004932,7263,1771,5492
2021,St Albans 010,E02004933,6536,1618,4918
2021,St Albans 011,E02004934,7259,1399,5860
2021,St Albans 012,E02004935,8418,1224,7194
2021,St Albans 013,E02004936,6150,1552,4598
2021,St Albans 014,E02004937,6916,1329,5587
2021,St Albans 016,E02004939,6274,1391,4883
2021,St Albans 017,E02004940,7096,1570,5526
2021,St Albans 018,E02004941,9233,1923,7310
2021,St Albans 019,E02004942,6094,1149,4945
2021,St Albans 020,E02004943,7816,1412,6404
2021,Stevenage 001,E02004944,7519,1729,5790
2021,Stevenage 002,E02004945,11507,2182,9325
2021,Stevenage 003,E02004946,6038,1161,4877
2021,Stevenage 005,E02004948,5702,980,4722
2021,Stevenage 006,E02004949,8281,1545,6736
2021,Stevenage 007,E02004950,6379,1389,4990
2021,Stevenage 008,E02004951,7481,1448,6033
2021,Stevenage 009,E02004952,6499,1292,5207
2021,Stevenage 010,E02004953,6091,1377,4714
2021,Stevenage 011,E02004954,6656,1341,5315
2021,Stevenage 012,E02004955,5645,1077,4568
2021,Three Rivers 001,E02004956,8590,1551,7039
2021,Three Rivers 002,E02004957,10099,2259,7840
2021,Three Rivers 003,E02004958,7487,1517,5970
2021,Three Rivers 004,E02004959,5970,1158,4812
2021,Three Rivers 005,E02004960,5478,1248,4230
2021,Three Rivers 006,E02004961,9139,1952,7187
2021,Three Rivers 007,E02004962,8511,1713,6798
2021,Three Rivers 008,E02004963,7128,1627,5501
2021,Three Rivers 009,E02004964,5385,1124,4261
2021,Three Rivers 010,E02004965,6584,1224,5360
2021,Three Rivers 011,E02004966,6961,1231,5730
2021,Three Rivers 012,E02004967,7319,1568,5751
2021,Watford 001,E02004968,7192,1555,5637
2021,Watford 002,E02004969,6854,1448,5406
2021,Watford 003,E02004970,7880,1754,6126
2021,Watford 004,E02004971,8141,2002,6139
2021,Watford 005,E02004972,5815,1108,4707
2021,Watford 006,E02004973,8043,1684,6359
2021,Watford 007,E02004974,8501,1610,6891
2021,Watford 008,E02004975,7817,1805,6012
2021,Watford 009,E02004976,10602,1833,8769
2021,Watford 010,E02004977,8538,1982,6556
2021,Watford 011,E02004978,9593,2239,7354
2021,Watford 012,E02004979,6741,1284,5457
2021,Welwyn Hatfield 001,E02004980,5979,1097,4882
2021,Welwyn Hatfield 002,E02004981,7671,1546,6125
2021,Welwyn Hatfield 003,E02004982,5606,1206,4400
2021,Welwyn Hatfield 004,E02004983,5739,1155,4584
2021,Welwyn Hatfield 005,E02004984,5935,910,5025
2021,Welwyn Hatfield 006,E02004985,6619,1179,5440
2021,Welwyn Hatfield 007,E02004986,8170,1774,6396
2021,Welwyn Hatfield 008,E02004987,7217,1586,5631
2021,Welwyn Hatfield 009,E02004988,7293,1643,5650
2021,Welwyn Hatfield 010,E02004989,11995,5077,6918
2021,Welwyn Hatfield 011,E02004990,6865,1340,5525
2021,Welwyn Hatfield 012,E02004991,7675,2365,5310
2021,Welwyn Hatfield 013,E02004992,9935,4938,4997
2021,Welwyn Hatfield 015,E02004994,5883,1244,4639
2021,Welwyn Hatfield 016,E02004995,5388,960,4428
2021,Ashford 001,E02004996,8030,1624,6406
2021,Ashford 002,E02004997,7887,1303,6584
2021,Ashford 003,E02004998,6489,1264,5225
2021,Ashford 005,E02005000,11280,2242,9038
2021,Ashford 006,E02005001,9018,1651,7367
2021,Ashford 007,E02005002,9308,1898,7410
2021,Ashford 008,E02005003,8585,2048,6537
2021,Ashford 009,E02005004,11075,2362,8713
2021,Ashford 010,E02005005,9703,1797,7906
2021,Ashford 011,E02005006,5929,1017,4912
2021,Ashford 012,E02005007,8867,1528,7339
2021,Ashford 013,E02005008,8400,1110,7290
2021,Ashford 014,E02005009,5717,971,4746
2021,Canterbury 001,E02005010,7167,1156,6011
2021,Canterbury 002,E02005011,7245,1006,6239
2021,Canterbury 003,E02005012,8547,1536,7011
2021,Canterbury 004,E02005013,7900,1280,6620
2021,Canterbury 005,E02005014,8179,1227,6952
2021,Canterbury 006,E02005015,9067,1777,7290
2021,Canterbury 007,E02005016,7481,1321,6160
2021,Canterbury 008,E02005017,6351,979,5372
2021,Canterbury 009,E02005018,8383,1482,6901
2021,Canterbury 010,E02005019,6206,1107,5099
2021,Canterbury 011,E02005020,7120,1376,5744
2021,Canterbury 012,E02005021,10766,5771,4995
2021,Canterbury 013,E02005022,7743,3528,4215
2021,Canterbury 014,E02005023,9185,3762,5423
2021,Canterbury 016,E02005025,9563,3674,5889
2021,Canterbury 017,E02005026,7646,1574,6072
2021,Canterbury 018,E02005027,5298,932,4366
2021,Dartford 001,E02005028,12900,3390,9510
2021,Dartford 002,E02005029,13404,2759,10645
2021,Dartford 003,E02005030,11364,2510,8854
2021,Dartford 004,E02005031,7547,1595,5952
2021,Dartford 005,E02005032,8998,1848,7150
2021,Dartford 006,E02005033,7091,1466,5625
2021,Dartford 007,E02005034,7340,1472,5868
2021,Dartford 008,E02005035,8026,1771,6255
2021,Dartford 009,E02005036,6309,1486,4823
2021,Dartford 010,E02005037,6774,1265,5509
2021,Dartford 011,E02005038,5721,1029,4692
2021,Dartford 012,E02005039,6463,1275,5188
2021,Dartford 013,E02005040,6533,1049,5484
2021,Dover 001,E02005041,6973,1181,5792
2021,Dover 002,E02005042,8611,1308,7303
2021,Dover 003,E02005043,6879,991,5888
2021,Dover 004,E02005044,5887,649,5238
2021,Dover 005,E02005045,8819,1699,7120
2021,Dover 006,E02005046,8297,1727,6570
2021,Dover 007,E02005047,7384,1263,6121
2021,Dover 008,E02005048,6360,914,5446
2021,Dover 009,E02005049,6741,858,5883
2021,Dover 010,E02005050,9232,1501,7731
2021,Dover 011,E02005051,12741,2908,9833
2021,Dover 012,E02005052,7875,1577,6298
2021,Dover 013,E02005053,8520,1678,6842
2021,Dover 014,E02005054,6425,919,5506
2021,Gravesham 001,E02005055,7671,1881,5790
2021,Gravesham 002,E02005056,9448,1695,7753
2021,Gravesham 003,E02005057,10745,2391,8354
2021,Gravesham 004,E02005058,7422,1682,5740
2021,Gravesham 005,E02005059,9120,1670,7450
2021,Gravesham 006,E02005060,8081,1645,6436
2021,Gravesham 007,E02005061,7073,1684,5389
2021,Gravesham 008,E02005062,6684,1421,5263
2021,Gravesham 009,E02005063,6874,1418,5456
2021,Gravesham 010,E02005064,6297,1100,5197
2021,Gravesham 011,E02005065,7773,1845,5928
2021,Gravesham 012,E02005066,7423,1189,6234
2021,Gravesham 013,E02005067,5691,991,4700
2021,Maidstone 001,E02005068,6791,1225,5566
2021,Maidstone 002,E02005069,8574,1600,6974
2021,Maidstone 003,E02005070,9276,1610,7666
2021,Maidstone 004,E02005071,11547,1665,9882
2021,Maidstone 005,E02005072,7658,1512,6146
2021,Maidstone 006,E02005073,11565,2018,9547
2021,Maidstone 007,E02005074,7669,1363,6306
2021,Maidstone 008,E02005075,10362,2216,8146
2021,Maidstone 009,E02005076,9314,1855,7459
2021,Maidstone 010,E02005077,7689,1555,6134
2021,Maidstone 011,E02005078,9260,1469,7791
2021,Maidstone 012,E02005079,8559,1652,6907
2021,Maidstone 013,E02005080,11185,2497,8688
2021,Maidstone 014,E02005081,6658,1023,5635
2021,Maidstone 015,E02005082,11104,2017,9087
2021,Maidstone 016,E02005083,7406,1258,6148
2021,Maidstone 017,E02005084,7103,1249,5854
2021,Maidstone 018,E02005085,7317,1252,6065
2021,Maidstone 019,E02005086,6356,1110,5246
2021,Sevenoaks 001,E02005087,6762,1145,5617
2021,Sevenoaks 002,E02005088,9265,1947,7318
2021,Sevenoaks 003,E02005089,6405,1053,5352
2021,Sevenoaks 004,E02005090,5676,845,4831
2021,Sevenoaks 005,E02005091,6428,1046,5382
2021,Sevenoaks 007,E02005093,5775,847,4928
2021,Sevenoaks 008,E02005094,9125,1652,7473
2021,Sevenoaks 009,E02005095,7189,1493,5696
2021,Sevenoaks 010,E02005096,9235,1964,7271
2021,Sevenoaks 011,E02005097,9079,2310,6769
2021,Sevenoaks 012,E02005098,9656,2254,7402
2021,Sevenoaks 013,E02005099,7510,1351,6159
2021,Sevenoaks 014,E02005100,9238,1697,7541
2021,Sevenoaks 015,E02005101,6740,1299,5441
2021,Folkestone and Hythe 001,E02005102,5892,783,5109
2021,Folkestone and Hythe 002,E02005103,9567,2026,7541
2021,Folkestone and Hythe 003,E02005104,7581,1527,6054
2021,Folkestone and Hythe 004,E02005105,7137,1683,5454
2021,Folkestone and Hythe 005,E02005106,9423,1836,7587
2021,Folkestone and Hythe 006,E02005107,12421,2097,10324
2021,Folkestone and Hythe 008,E02005109,6497,864,5633
2021,Folkestone and Hythe 009,E02005110,6782,978,5804
2021,Folkestone and Hythe 010,E02005111,6933,870,6063
2021,Folkestone and Hythe 011,E02005112,6820,898,5922
2021,Folkestone and Hythe 012,E02005113,6978,928,6050
2021,Folkestone and Hythe 013,E02005114,6073,990,5083
2021,Swale 001,E02005115,6078,1435,4643
2021,Swale 002,E02005116,6091,1367,4724
2021,Swale 003,E02005117,6332,899,5433
2021,Swale 004,E02005118,10180,1986,8194
2021,Swale 005,E02005119,6188,1115,5073
2021,Swale 006,E02005120,9290,1121,8169
2021,Swale 007,E02005121,13094,2873,10221
2021,Swale 008,E02005122,7341,1187,6154
2021,Swale 009,E02005123,11904,2357,9547
2021,Swale 010,E02005124,8223,1593,6630
2021,Swale 011,E02005125,7954,1623,6331
2021,Swale 012,E02005126,7720,1398,6322
2021,Swale 013,E02005127,8518,1608,6910
2021,Swale 014,E02005128,8467,1584,6883
2021,Swale 015,E02005129,10869,1864,9005
2021,Swale 016,E02005130,8984,1535,7449
2021,Swale 017,E02005131,5551,938,4613
2021,Thanet 001,E02005132,9709,1740,7969
2021,Thanet 002,E02005133,8330,1194,7136
2021,Thanet 003,E02005134,7434,1407,6027
2021,Thanet 004,E02005135,7373,1483,5890
2021,Thanet 005,E02005136,7678,1360,6318
2021,Thanet 006,E02005137,7250,1664,5586
2021,Thanet 007,E02005138,8650,1373,7277
2021,Thanet 008,E02005139,8601,1061,7540
2021,Thanet 009,E02005140,7269,1151,6118
2021,Thanet 010,E02005141,6791,1090,5701
2021,Thanet 011,E02005142,7013,1166,5847
2021,Thanet 012,E02005143,7777,1558,6219
2021,Thanet 013,E02005144,8363,1932,6431
2021,Thanet 014,E02005145,7682,1272,6410
2021,Thanet 015,E02005146,7637,1668,5969
2021,Thanet 016,E02005147,8188,1244,6944
2021,Thanet 017,E02005148,7510,1081,6429
2021,Tonbridge and Malling 001,E02005149,11395,1999,9396
2021,Tonbridge and Malling 002,E02005150,11028,2030,8998
2021,Tonbridge and Malling 003,E02005151,11957,2217,9740
2021,Tonbridge and Malling 005,E02005153,8769,1628,7141
2021,Tonbridge and Malling 006,E02005154,11101,2217,8884
2021,Tonbridge and Malling 007,E02005155,11867,2997,8870
2021,Tonbridge and Malling 008,E02005156,6885,1274,5611
2021,Tonbridge and Malling 009,E02005157,6372,1276,5096
2021,Tonbridge and Malling 010,E02005158,6326,1261,5065
2021,Tonbridge and Malling 011,E02005159,7371,1469,5902
2021,Tonbridge and Malling 012,E02005160,11772,2489,9283
2021,Tonbridge and Malling 013,E02005161,8051,1557,6494
2021,Tunbridge Wells 001,E02005162,10004,1793,8211
2021,Tunbridge Wells 002,E02005163,7652,1702,5950
2021,Tunbridge Wells 003,E02005164,8319,1657,6662
2021,Tunbridge Wells 004,E02005165,7219,1294,5925
2021,Tunbridge Wells 005,E02005166,6479,1436,5043
2021,Tunbridge Wells 006,E02005167,7313,1627,5686
2021,Tunbridge Wells 007,E02005168,7181,1514,5667
2021,Tunbridge Wells 008,E02005169,8534,1241,7293
2021,Tunbridge Wells 009,E02005170,9243,1830,7413
2021,Tunbridge Wells 010,E02005171,5818,1141,4677
2021,Tunbridge Wells 011,E02005172,7885,1620,6265
2021,Tunbridge Wells 012,E02005173,7975,1411,6564
2021,Tunbridge Wells 013,E02005174,7190,1515,5675
2021,Tunbridge Wells 014,E02005175,8331,1868,6463
2021,Burnley 001,E02005176,8577,1726,6851
2021,Burnley 002,E02005177,6230,1365,4865
2021,Burnley 003,E02005178,10853,3269,7584
2021,Burnley 004,E02005179,8753,1767,6986
2021,Burnley 005,E02005180,6750,1144,5606
2021,Burnley 006,E02005181,6225,1176,5049
2021,Burnley 007,E02005182,5890,1242,4648
2021,Burnley 008,E02005183,5796,1046,4750
2021,Burnley 009,E02005184,4922,670,4252
2021,Burnley 010,E02005185,8897,1969,6928
2021,Burnley 011,E02005186,5907,1026,4881
2021,Chorley 001,E02005189,5015,911,4104
2021,Chorley 002,E02005190,5767,904,4863
2021,Chorley 003,E02005191,9178,1652,7526
2021,Chorley 004,E02005192,8369,1663,6706
2021,Chorley 005,E02005193,8302,1429,6873
2021,Chorley 006,E02005194,7577,1267,6310
2021,Chorley 007,E02005195,7649,1068,6581
2021,Chorley 008,E02005196,10570,2047,8523
2021,Chorley 009,E02005197,6809,1362,5447
2021,Chorley 010,E02005198,9148,1672,7476
2021,Chorley 011,E02005199,7248,1192,6056
2021,Chorley 012,E02005200,8620,1800,6820
2021,Chorley 013,E02005201,7872,1357,6515
2021,Chorley 014,E02005202,9547,1559,7988
2021,Fylde 001,E02005203,8045,1329,6716
2021,Fylde 002,E02005204,11909,2133,9776
2021,Fylde 003,E02005205,6416,1036,5380
2021,Fylde 004,E02005206,7218,1234,5984
2021,Fylde 005,E02005207,8232,1233,6999
2021,Fylde 006,E02005208,9747,1221,8526
2021,Fylde 007,E02005209,8363,1290,7073
2021,Fylde 008,E02005210,9931,1392,8539
2021,Fylde 009,E02005211,8205,1100,7105
2021,Hyndburn 001,E02005212,10410,1946,8464
2021,Hyndburn 002,E02005213,10828,2119,8709
2021,Hyndburn 003,E02005214,6290,1123,5167
2021,Hyndburn 004,E02005215,11784,2388,9396
2021,Hyndburn 005,E02005216,5012,1017,3995
2021,Hyndburn 006,E02005217,12310,3807,8503
2021,Hyndburn 007,E02005218,6850,1225,5625
2021,Hyndburn 008,E02005219,8187,1423,6764
2021,Hyndburn 009,E02005220,5641,807,4834
2021,Lancaster 001,E02005221,9554,1498,8056
2021,Lancaster 002,E02005222,5772,898,4874
2021,Lancaster 003,E02005223,6981,1008,5973
2021,Lancaster 004,E02005224,5026,605,4421
2021,Lancaster 005,E02005225,5747,1003,4744
2021,Lancaster 006,E02005226,7011,1385,5626
2021,Lancaster 008,E02005228,5423,1046,4377
2021,Lancaster 009,E02005229,5413,1048,4365
2021,Lancaster 010,E02005230,6227,1055,5172
2021,Lancaster 011,E02005231,7763,1631,6132
2021,Lancaster 013,E02005233,7593,1647,5946
2021,Lancaster 014,E02005234,8817,4388,4429
2021,Lancaster 015,E02005235,4919,2086,2833
2021,Lancaster 016,E02005236,12689,2306,10383
2021,Lancaster 017,E02005237,9826,2472,7354
2021,Lancaster 018,E02005238,5305,1302,4003
2021,Lancaster 019,E02005239,10592,5604,4988
2021,Pendle 001,E02005240,5237,967,4270
2021,Pendle 002,E02005241,5319,858,4461
2021,Pendle 003,E02005242,5905,994,4911
2021,Pendle 006,E02005245,6636,1062,5574
2021,Pendle 007,E02005246,5083,943,4140
2021,Pendle 008,E02005247,9395,1393,8002
2021,Pendle 009,E02005248,7137,2073,5064
2021,Pendle 010,E02005249,9616,2498,7118
2021,Pendle 011,E02005250,8741,2726,6015
2021,Pendle 012,E02005251,6829,1636,5193
2021,Pendle 013,E02005252,9710,2458,7252
2021,Preston 001,E02005253,6774,1233,5541
2021,Preston 002,E02005254,9135,1899,7236
2021,Preston 003,E02005255,9023,1808,7215
2021,Preston 004,E02005256,6518,1227,5291
2021,Preston 005,E02005257,5428,1026,4402
2021,Preston 006,E02005258,7983,1794,6189
2021,Preston 007,E02005259,9865,2306,7559
2021,Preston 008,E02005260,6362,1131,5231
2021,Preston 009,E02005261,9579,2506,7073
2021,Preston 010,E02005262,6854,1247,5607
2021,Preston 011,E02005263,6700,2098,4602
2021,Preston 012,E02005264,11748,4437,7311
2021,Preston 013,E02005265,10161,2025,8136
2021,Preston 014,E02005266,8181,2026,6155
2021,Preston 015,E02005267,6051,2715,3336
2021,Preston 016,E02005268,8633,2256,6377
2021,Preston 017,E02005269,9919,3053,6866
2021,Ribble Valley 001,E02005270,7191,1347,5844
2021,Ribble Valley 002,E02005271,7774,1342,6432
2021,Ribble Valley 003,E02005272,8508,1513,6995
2021,Ribble Valley 004,E02005273,5663,832,4831
2021,Ribble Valley 005,E02005274,7479,1235,6244
2021,Ribble Valley 006,E02005275,5449,890,4559
2021,Ribble Valley 007,E02005276,8463,1510,6953
2021,Ribble Valley 008,E02005277,8402,1346,7056
2021,Rossendale 001,E02005278,7524,1419,6105
2021,Rossendale 002,E02005279,9731,2064,7667
2021,Rossendale 003,E02005280,10487,2235,8252
2021,Rossendale 004,E02005281,8389,1712,6677
2021,Rossendale 007,E02005284,5811,1051,4760
2021,Rossendale 008,E02005285,6003,973,5030
2021,Rossendale 009,E02005286,7410,1290,6120
2021,South Ribble 001,E02005287,5093,946,4147
2021,South Ribble 002,E02005288,5693,837,4856
2021,South Ribble 003,E02005289,5639,892,4747
2021,South Ribble 004,E02005290,6813,1208,5605
2021,South Ribble 005,E02005291,5380,938,4442
2021,South Ribble 006,E02005292,5335,1014,4321
2021,South Ribble 007,E02005293,5189,834,4355
2021,South Ribble 008,E02005294,6651,1276,5375
2021,South Ribble 009,E02005295,7146,1179,5967
2021,South Ribble 010,E02005296,5848,1044,4804
2021,South Ribble 011,E02005297,7973,1257,6716
2021,South Ribble 012,E02005298,7895,1380,6515
2021,South Ribble 013,E02005299,6964,1253,5711
2021,South Ribble 014,E02005300,4822,892,3930
2021,South Ribble 015,E02005301,5822,974,4848
2021,South Ribble 016,E02005302,7305,1405,5900
2021,South Ribble 017,E02005303,5965,1197,4768
2021,West Lancashire 001,E02005304,8620,1427,7193
2021,West Lancashire 002,E02005305,7642,1071,6571
2021,West Lancashire 003,E02005306,7204,1090,6114
2021,West Lancashire 004,E02005307,9155,1703,7452
2021,West Lancashire 005,E02005308,6299,1058,5241
2021,West Lancashire 006,E02005309,8415,1695,6720
2021,West Lancashire 007,E02005310,9910,4743,5167
2021,West Lancashire 008,E02005311,6591,2084,4507
2021,West Lancashire 009,E02005312,6023,1016,5007
2021,West Lancashire 010,E02005313,8312,1987,6325
2021,West Lancashire 011,E02005314,6082,1112,4970
2021,West Lancashire 012,E02005315,7763,1331,6432
2021,West Lancashire 013,E02005316,6144,1365,4779
2021,West Lancashire 014,E02005317,6787,1561,5226
2021,West Lancashire 015,E02005318,7236,1242,5994
2021,Wyre 001,E02005319,7724,1303,6421
2021,Wyre 002,E02005320,5583,1095,4488
2021,Wyre 003,E02005321,5829,1091,4738
2021,Wyre 004,E02005322,9920,1353,8567
2021,Wyre 005,E02005323,7098,1414,5684
2021,Wyre 006,E02005324,6937,1399,5538
2021,Wyre 007,E02005325,8990,1289,7701
2021,Wyre 008,E02005326,8003,1089,6914
2021,Wyre 009,E02005327,6415,1040,5375
2021,Wyre 010,E02005328,7283,977,6306
2021,Wyre 011,E02005329,8833,1618,7215
2021,Wyre 012,E02005330,8500,1357,7143
2021,Wyre 013,E02005331,7960,1296,6664
2021,Wyre 014,E02005332,7980,1191,6789
2021,Blaby 002,E02005334,5696,1100,4596
2021,Blaby 003,E02005335,7205,1333,5872
2021,Blaby 004,E02005336,6805,1386,5419
2021,Blaby 005,E02005337,9460,1804,7656
2021,Blaby 006,E02005338,10688,1951,8737
2021,Blaby 007,E02005339,8238,1486,6752
2021,Blaby 008,E02005340,8431,1416,7015
2021,Blaby 009,E02005341,7157,1342,5815
2021,Blaby 010,E02005342,7006,1238,5768
2021,Blaby 011,E02005343,7573,1387,6186
2021,Blaby 012,E02005344,8672,1499,7173
2021,Charnwood 001,E02005345,6072,980,5092
2021,Charnwood 002,E02005346,11930,2939,8991
2021,Charnwood 003,E02005347,10975,6242,4733
2021,Charnwood 004,E02005348,5326,902,4424
2021,Charnwood 005,E02005349,7475,1269,6206
2021,Charnwood 006,E02005350,6598,1018,5580
2021,Charnwood 007,E02005351,10978,7073,3905
2021,Charnwood 008,E02005352,6019,1153,4866
2021,Charnwood 009,E02005353,10089,2692,7397
2021,Charnwood 010,E02005354,9707,2129,7578
2021,Charnwood 011,E02005355,6978,1267,5711
2021,Charnwood 012,E02005356,6956,1215,5741
2021,Charnwood 013,E02005357,7900,1521,6379
2021,Charnwood 014,E02005358,11450,2129,9321
2021,Charnwood 015,E02005359,7231,1282,5949
2021,Charnwood 016,E02005360,6081,1114,4967
2021,Charnwood 017,E02005361,6002,971,5031
2021,Charnwood 018,E02005362,6840,1264,5576
2021,Charnwood 019,E02005363,8555,1603,6952
2021,Charnwood 020,E02005364,5007,897,4110
2021,Charnwood 021,E02005365,9390,1730,7660
2021,Charnwood 022,E02005366,7238,1267,5971
2021,Harborough 002,E02005368,6180,1057,5123
2021,Harborough 003,E02005369,12058,2383,9675
2021,Harborough 004,E02005370,9166,1745,7421
2021,Harborough 005,E02005371,10303,1820,8483
2021,Harborough 006,E02005372,9788,1604,8184
2021,Harborough 007,E02005373,11589,1958,9631
2021,Harborough 008,E02005374,6294,1130,5164
2021,Harborough 009,E02005375,8918,1618,7300
2021,Harborough 010,E02005376,10289,1958,8331
2021,Hinckley and Bosworth 001,E02005377,8593,1523,7070
2021,Hinckley and Bosworth 002,E02005378,5060,898,4162
2021,Hinckley and Bosworth 003,E02005379,5743,958,4785
2021,Hinckley and Bosworth 004,E02005380,8305,1347,6958
2021,Hinckley and Bosworth 005,E02005381,8473,1551,6922
2021,Hinckley and Bosworth 006,E02005382,10057,1664,8393
2021,Hinckley and Bosworth 007,E02005383,8714,1477,7237
2021,Hinckley and Bosworth 008,E02005384,7105,1228,5877
2021,Hinckley and Bosworth 009,E02005385,6345,976,5369
2021,Hinckley and Bosworth 010,E02005386,8614,1322,7292
2021,Hinckley and Bosworth 011,E02005387,9363,1655,7708
2021,Hinckley and Bosworth 012,E02005388,5860,986,4874
2021,Hinckley and Bosworth 013,E02005389,5793,974,4819
2021,Hinckley and Bosworth 014,E02005390,9927,1675,8252
2021,Melton 001,E02005391,9371,1602,7769
2021,Melton 002,E02005392,8815,1513,7302
2021,Melton 003,E02005393,7073,1179,5894
2021,Melton 004,E02005394,9025,1693,7332
2021,Melton 005,E02005395,8399,1302,7097
2021,Melton 006,E02005396,6651,1026,5625
2021,North West Leicestershire 001,E02005397,8822,1430,7392
2021,North West Leicestershire 002,E02005398,6595,1668,4927
2021,North West Leicestershire 003,E02005399,7856,1499,6357
2021,North West Leicestershire 004,E02005400,5548,854,4694
2021,North West Leicestershire 005,E02005401,6189,1092,5097
2021,North West Leicestershire 006,E02005402,6503,1216,5287
2021,North West Leicestershire 007,E02005403,6261,842,5419
2021,North West Leicestershire 008,E02005404,8276,1483,6793
2021,North West Leicestershire 009,E02005405,6820,1258,5562
2021,North West Leicestershire 010,E02005406,7372,1335,6037
2021,North West Leicestershire 011,E02005407,10263,1815,8448
2021,North West Leicestershire 012,E02005408,7439,1291,6148
2021,North West Leicestershire 013,E02005409,11306,2022,9284
2021,Oadby and Wigston 003,E02005412,8388,1752,6636
2021,Oadby and Wigston 005,E02005414,7772,1528,6244
2021,Oadby and Wigston 006,E02005415,7604,1383,6221
2021,Oadby and Wigston 007,E02005416,8593,1348,7245
2021,Boston 001,E02005417,7301,1084,6217
2021,Boston 002,E02005418,10321,2168,8153
2021,Boston 003,E02005419,8227,1447,6780
2021,Boston 004,E02005420,8382,1639,6743
2021,Boston 006,E02005422,6381,1030,5351
2021,Boston 007,E02005423,9910,1800,8110
2021,East Lindsey 001,E02005424,9827,1489,8338
2021,East Lindsey 002,E02005425,6279,906,5373
2021,East Lindsey 003,E02005426,9902,1826,8076
2021,East Lindsey 004,E02005427,6638,1009,5629
2021,East Lindsey 005,E02005428,8155,1026,7129
2021,East Lindsey 006,E02005429,6118,481,5637
2021,East Lindsey 007,E02005430,6808,913,5895
2021,East Lindsey 008,E02005431,8507,1180,7327
2021,East Lindsey 009,E02005432,7505,1005,6500
2021,East Lindsey 010,E02005433,6845,698,6147
2021,East Lindsey 011,E02005434,7198,1150,6048
2021,East Lindsey 012,E02005435,7492,1041,6451
2021,East Lindsey 013,E02005436,7866,1224,6642
2021,East Lindsey 014,E02005437,5938,887,5051
2021,East Lindsey 015,E02005438,6655,1177,5478
2021,East Lindsey 016,E02005439,11402,1729,9673
2021,East Lindsey 017,E02005440,5331,815,4516
2021,East Lindsey 018,E02005441,8196,1188,7008
2021,Lincoln 001,E02005442,6158,1370,4788
2021,Lincoln 002,E02005443,7071,1272,5799
2021,Lincoln 003,E02005444,13053,3333,9720
2021,Lincoln 004,E02005445,11983,3232,8751
2021,Lincoln 005,E02005446,10292,6391,3901
2021,Lincoln 006,E02005447,7947,2366,5581
2021,Lincoln 007,E02005448,6826,1458,5368
2021,Lincoln 008,E02005449,9015,3297,5718
2021,Lincoln 009,E02005450,8019,1215,6804
2021,Lincoln 010,E02005451,7513,1625,5888
2021,Lincoln 011,E02005452,10820,1985,8835
2021,North Kesteven 001,E02005453,10323,1617,8706
2021,North Kesteven 003,E02005455,13686,2438,11248
2021,North Kesteven 004,E02005456,10281,1801,8480
2021,North Kesteven 005,E02005457,8328,1430,6898
2021,North Kesteven 006,E02005458,6502,970,5532
2021,North Kesteven 007,E02005459,8123,1386,6737
2021,North Kesteven 008,E02005460,6048,995,5053
2021,North Kesteven 009,E02005461,6168,828,5340
2021,North Kesteven 010,E02005462,9297,1739,7558
2021,North Kesteven 011,E02005463,9478,1926,7552
2021,North Kesteven 012,E02005464,8333,1221,7112
2021,South Holland 001,E02005465,8422,1305,7117
2021,South Holland 002,E02005466,6478,926,5552
2021,South Holland 003,E02005467,7337,1118,6219
2021,South Holland 004,E02005468,7319,1163,6156
2021,South Holland 005,E02005469,7543,1249,6294
2021,South Holland 006,E02005470,12159,2076,10083
2021,South Holland 007,E02005471,8676,1468,7208
2021,South Holland 008,E02005472,9491,1412,8079
2021,South Holland 009,E02005473,9294,1533,7761
2021,South Holland 010,E02005474,6848,912,5936
2021,South Holland 011,E02005475,6823,1182,5641
2021,South Kesteven 001,E02005476,6943,1168,5775
2021,South Kesteven 002,E02005477,8784,1391,7393
2021,South Kesteven 003,E02005478,9559,1833,7726
2021,South Kesteven 004,E02005479,9323,1535,7788
2021,South Kesteven 005,E02005480,6906,1710,5196
2021,South Kesteven 006,E02005481,11535,2089,9446
2021,South Kesteven 007,E02005482,9231,1487,7744
2021,South Kesteven 008,E02005483,7578,1204,6374
2021,South Kesteven 009,E02005484,6888,1122,5766
2021,South Kesteven 010,E02005485,7927,1473,6454
2021,South Kesteven 011,E02005486,9054,1694,7360
2021,South Kesteven 012,E02005487,9444,1567,7877
2021,South Kesteven 013,E02005488,6747,1124,5623
2021,South Kesteven 014,E02005489,6940,1191,5749
2021,South Kesteven 015,E02005490,8783,1513,7270
2021,South Kesteven 016,E02005491,11004,1923,9081
2021,West Lindsey 001,E02005492,9467,1549,7918
2021,West Lindsey 002,E02005493,9686,1641,8045
2021,West Lindsey 003,E02005494,9303,1420,7883
2021,West Lindsey 004,E02005495,9884,1752,8132
2021,West Lindsey 005,E02005496,6021,911,5110
2021,West Lindsey 006,E02005497,6960,1586,5374
2021,West Lindsey 007,E02005498,7151,906,6245
2021,West Lindsey 008,E02005499,8178,1576,6602
2021,West Lindsey 009,E02005500,7011,1054,5957
2021,West Lindsey 010,E02005501,7752,1309,6443
2021,West Lindsey 011,E02005502,9334,1527,7807
2021,Breckland 001,E02005503,7151,1145,6006
2021,Breckland 002,E02005504,8905,1316,7589
2021,Breckland 003,E02005505,7275,1254,6021
2021,Breckland 004,E02005506,6691,1000,5691
2021,Breckland 005,E02005507,11052,1862,9190
2021,Breckland 006,E02005508,6975,1006,5969
2021,Breckland 007,E02005509,8149,1101,7048
2021,Breckland 008,E02005510,7054,953,6101
2021,Breckland 009,E02005511,8502,1067,7435
2021,Breckland 010,E02005512,9640,1474,8166
2021,Breckland 011,E02005513,10001,1565,8436
2021,Breckland 012,E02005514,6556,903,5653
2021,Breckland 013,E02005515,6214,1046,5168
2021,Breckland 014,E02005516,6747,1049,5698
2021,Breckland 015,E02005517,5563,1258,4305
2021,Breckland 016,E02005518,10110,1624,8486
2021,Breckland 017,E02005519,8106,1700,6406
2021,Broadland 001,E02005520,8526,1373,7153
2021,Broadland 002,E02005521,8334,1324,7010
2021,Broadland 003,E02005522,5263,805,4458
2021,Broadland 004,E02005523,8143,1438,6705
2021,Broadland 005,E02005524,5109,753,4356
2021,Broadland 006,E02005525,9416,1624,7792
2021,Broadland 007,E02005526,5123,851,4272
2021,Broadland 008,E02005527,8689,1414,7275
2021,Broadland 009,E02005528,8094,1248,6846
2021,Broadland 010,E02005529,5474,740,4734
2021,Broadland 011,E02005530,5205,784,4421
2021,Broadland 012,E02005531,5120,835,4285
2021,Broadland 013,E02005532,8975,1283,7692
2021,Broadland 014,E02005533,8651,1406,7245
2021,Broadland 015,E02005534,7077,1072,6005
2021,Broadland 016,E02005535,6861,1257,5604
2021,Broadland 017,E02005536,5947,863,5084
2021,Broadland 018,E02005537,5767,863,4904
2021,Great Yarmouth 001,E02005538,9377,1205,8172
2021,Great Yarmouth 002,E02005539,7702,1146,6556
2021,Great Yarmouth 003,E02005540,8520,1164,7356
2021,Great Yarmouth 004,E02005541,5631,1037,4594
2021,Great Yarmouth 005,E02005542,6721,1242,5479
2021,Great Yarmouth 006,E02005543,8694,1877,6817
2021,Great Yarmouth 007,E02005544,6657,1405,5252
2021,Great Yarmouth 008,E02005545,6226,987,5239
2021,Great Yarmouth 009,E02005546,7432,1274,6158
2021,Great Yarmouth 010,E02005547,8132,1343,6789
2021,Great Yarmouth 011,E02005548,6968,1367,5601
2021,Great Yarmouth 012,E02005549,5402,783,4619
2021,Great Yarmouth 013,E02005550,7333,1189,6144
2021,King's Lynn and West Norfolk 001,E02005551,5097,483,4614
2021,King's Lynn and West Norfolk 002,E02005552,6327,780,5547
2021,King's Lynn and West Norfolk 003,E02005553,8487,937,7550
2021,King's Lynn and West Norfolk 004,E02005554,6816,870,5946
2021,King's Lynn and West Norfolk 005,E02005555,6592,1062,5530
2021,King's Lynn and West Norfolk 006,E02005556,7348,1169,6179
2021,King's Lynn and West Norfolk 007,E02005557,6385,1430,4955
2021,King's Lynn and West Norfolk 008,E02005558,7040,1085,5955
2021,King's Lynn and West Norfolk 009,E02005559,6981,1275,5706
2021,King's Lynn and West Norfolk 010,E02005560,8494,1820,6674
2021,King's Lynn and West Norfolk 011,E02005561,10211,1714,8497
2021,King's Lynn and West Norfolk 012,E02005562,7158,1026,6132
2021,King's Lynn and West Norfolk 013,E02005563,7691,1222,6469
2021,King's Lynn and West Norfolk 014,E02005564,9175,1345,7830
2021,King's Lynn and West Norfolk 015,E02005565,6992,1070,5922
2021,King's Lynn and West Norfolk 016,E02005566,9923,1521,8402
2021,King's Lynn and West Norfolk 017,E02005567,10810,1629,9181
2021,King's Lynn and West Norfolk 018,E02005568,7284,1031,6253
2021,King's Lynn and West Norfolk 019,E02005569,8254,1456,6798
2021,North Norfolk 001,E02005570,6911,900,6011
2021,North Norfolk 002,E02005571,5637,680,4957
2021,North Norfolk 003,E02005572,7313,860,6453
2021,North Norfolk 004,E02005573,5545,770,4775
2021,North Norfolk 005,E02005574,6721,787,5934
2021,North Norfolk 006,E02005575,6783,950,5833
2021,North Norfolk 007,E02005576,6446,848,5598
2021,North Norfolk 008,E02005577,5735,779,4956
2021,North Norfolk 009,E02005578,5653,854,4799
2021,North Norfolk 011,E02005580,7646,1070,6576
2021,North Norfolk 012,E02005581,7567,993,6574
2021,North Norfolk 013,E02005582,6547,880,5667
2021,North Norfolk 014,E02005583,8359,943,7416
2021,Norwich 001,E02005584,10465,2070,8395
2021,Norwich 002,E02005585,10559,2345,8214
2021,Norwich 003,E02005586,9809,1612,8197
2021,Norwich 004,E02005587,9805,1971,7834
2021,Norwich 005,E02005588,12304,4185,8119
2021,Norwich 006,E02005589,11552,3542,8010
2021,Norwich 009,E02005592,8829,2449,6380
2021,Norwich 010,E02005593,10551,6332,4219
2021,Norwich 011,E02005594,10524,2131,8393
2021,Norwich 012,E02005595,9042,2097,6945
2021,Norwich 013,E02005596,9347,1882,7465
2021,South Norfolk 002,E02005598,9380,1803,7577
2021,South Norfolk 003,E02005599,6778,1228,5550
2021,South Norfolk 004,E02005600,6151,1454,4697
2021,South Norfolk 005,E02005601,5285,704,4581
2021,South Norfolk 006,E02005602,12050,1974,10076
2021,South Norfolk 007,E02005603,11964,2486,9478
2021,South Norfolk 008,E02005604,8421,1355,7066
2021,South Norfolk 009,E02005605,10193,1748,8445
2021,South Norfolk 010,E02005606,5660,875,4785
2021,South Norfolk 011,E02005607,11012,1826,9186
2021,South Norfolk 012,E02005608,7362,1067,6295
2021,South Norfolk 013,E02005609,7222,1123,6099
2021,South Norfolk 014,E02005610,7793,1068,6725
2021,South Norfolk 015,E02005611,10444,1533,8911
2021,North Northamptonshire 002,E02005612,6940,1229,5711
2021,North Northamptonshire 003,E02005613,8817,1614,7203
2021,North Northamptonshire 006,E02005614,12721,2596,10125
2021,North Northamptonshire 004,E02005615,8856,1581,7275
2021,North Northamptonshire 005,E02005616,5484,1001,4483
2021,North Northamptonshire 007,E02005617,10513,2216,8297
2021,West Northamptonshire 001,E02005619,6087,1020,5067
2021,West Northamptonshire 002,E02005620,8246,1599,6647
2021,West Northamptonshire 004,E02005621,8695,1210,7485
2021,West Northamptonshire 005,E02005622,9426,1722,7704
2021,West Northamptonshire 003,E02005623,10822,2033,8789
2021,West Northamptonshire 010,E02005624,10785,1944,8841
2021,West Northamptonshire 016,E02005625,8918,1509,7409
2021,West Northamptonshire 022,E02005626,6708,1401,5307
2021,West Northamptonshire 027,E02005627,7285,1210,6075
2021,West Northamptonshire 042,E02005628,8077,1301,6776
2021,North Northamptonshire 001,E02005629,6167,1002,5165
2021,North Northamptonshire 010,E02005630,10231,2424,7807
2021,North Northamptonshire 011,E02005631,10574,1864,8710
2021,North Northamptonshire 024,E02005632,6251,1028,5223
2021,North Northamptonshire 025,E02005633,9293,1565,7728
2021,North Northamptonshire 027,E02005634,8767,1656,7111
2021,North Northamptonshire 035,E02005635,8951,1725,7226
2021,North Northamptonshire 034,E02005636,11645,2234,9411
2021,North Northamptonshire 037,E02005637,8732,1470,7262
2021,North Northamptonshire 039,E02005638,9539,1657,7882
2021,North Northamptonshire 012,E02005639,5368,779,4589
2021,North Northamptonshire 013,E02005640,11201,2089,9112
2021,North Northamptonshire 014,E02005641,8126,1408,6718
2021,North Northamptonshire 015,E02005642,8067,1482,6585
2021,North Northamptonshire 016,E02005643,8111,1873,6238
2021,North Northamptonshire 017,E02005644,8565,1637,6928
2021,North Northamptonshire 018,E02005645,11827,2055,9772
2021,North Northamptonshire 019,E02005646,6244,1147,5097
2021,North Northamptonshire 022,E02005647,7212,1380,5832
2021,North Northamptonshire 021,E02005648,9149,1832,7317
2021,West Northamptonshire 006,E02005650,6588,1555,5033
2021,West Northamptonshire 007,E02005651,6148,933,5215
2021,West Northamptonshire 008,E02005652,6371,1046,5325
2021,West Northamptonshire 011,E02005653,8282,2098,6184
2021,West Northamptonshire 009,E02005654,8137,2002,6135
2021,West Northamptonshire 012,E02005655,6090,1115,4975
2021,West Northamptonshire 014,E02005656,6219,1672,4547
2021,West Northamptonshire 013,E02005657,6260,1012,5248
2021,West Northamptonshire 015,E02005658,6464,1608,4856
2021,West Northamptonshire 018,E02005659,5683,1144,4539
2021,West Northamptonshire 026,E02005660,6260,1451,4809
2021,West Northamptonshire 017,E02005661,6561,1698,4863
2021,West Northamptonshire 019,E02005662,6450,1332,5118
2021,West Northamptonshire 023,E02005663,5242,857,4385
2021,West Northamptonshire 025,E02005664,5837,1089,4748
2021,West Northamptonshire 024,E02005665,8056,1595,6461
2021,West Northamptonshire 021,E02005666,8483,2313,6170
2021,West Northamptonshire 020,E02005667,6392,1277,5115
2021,West Northamptonshire 028,E02005668,6269,1123,5146
2021,West Northamptonshire 029,E02005669,5798,1073,4725
2021,West Northamptonshire 032,E02005670,8932,2035,6897
2021,West Northamptonshire 030,E02005671,7439,1595,5844
2021,West Northamptonshire 031,E02005672,7990,1866,6124
2021,West Northamptonshire 033,E02005673,7252,1298,5954
2021,West Northamptonshire 034,E02005674,8727,1970,6757
2021,West Northamptonshire 036,E02005675,5994,1486,4508
2021,West Northamptonshire 038,E02005676,5910,1365,4545
2021,West Northamptonshire 037,E02005677,9454,2818,6636
2021,West Northamptonshire 041,E02005679,8524,1632,6892
2021,West Northamptonshire 044,E02005680,8322,2155,6167
2021,West Northamptonshire 040,E02005681,8249,1504,6745
2021,West Northamptonshire 043,E02005682,7193,1337,5856
2021,West Northamptonshire 046,E02005683,14197,2915,11282
2021,West Northamptonshire 045,E02005684,8298,1451,6847
2021,West Northamptonshire 047,E02005685,9466,1609,7857
2021,West Northamptonshire 048,E02005686,7702,1365,6337
2021,West Northamptonshire 049,E02005687,6399,1153,5246
2021,West Northamptonshire 050,E02005688,9244,1742,7502
2021,West Northamptonshire 051,E02005689,9936,1821,8115
2021,West Northamptonshire 053,E02005690,5211,830,4381
2021,West Northamptonshire 052,E02005691,6457,995,5462
2021,North Northamptonshire 026,E02005692,6670,1043,5627
2021,North Northamptonshire 028,E02005693,8189,1881,6308
2021,North Northamptonshire 029,E02005694,7275,1288,5987
2021,North Northamptonshire 030,E02005695,9379,1744,7635
2021,North Northamptonshire 031,E02005696,6003,1439,4564
2021,North Northamptonshire 032,E02005697,6879,1088,5791
2021,North Northamptonshire 033,E02005698,5708,1181,4527
2021,North Northamptonshire 036,E02005699,8056,1906,6150
2021,North Northamptonshire 038,E02005700,9724,1550,8174
2021,North Northamptonshire 040,E02005701,10725,1854,8871
2021,Northumberland 004,E02005702,6462,910,5552
2021,Northumberland 005,E02005703,6559,964,5595
2021,Northumberland 006,E02005704,12133,1625,10508
2021,Northumberland 007,E02005705,7368,957,6411
2021,Northumberland 001,E02005706,8748,1431,7317
2021,Northumberland 002,E02005707,6832,918,5914
2021,Northumberland 003,E02005708,9699,1083,8616
2021,Northumberland 022,E02005709,6347,1276,5071
2021,Northumberland 023,E02005710,8888,1406,7482
2021,Northumberland 024,E02005711,7400,1399,6001
2021,Northumberland 025,E02005712,8768,1710,7058
2021,Northumberland 026,E02005713,6024,933,5091
2021,Northumberland 029,E02005715,8739,1650,7089
2021,Northumberland 030,E02005717,7112,1006,6106
2021,Northumberland 031,E02005718,6045,778,5267
2021,Northumberland 032,E02005719,7742,1114,6628
2021,Northumberland 008,E02005720,11660,1503,10157
2021,Northumberland 011,E02005721,5204,887,4317
2021,Northumberland 015,E02005722,9035,1484,7551
2021,Northumberland 016,E02005723,5802,871,4931
2021,Northumberland 018,E02005724,6353,1076,5277
2021,Northumberland 033,E02005725,6720,1107,5613
2021,Northumberland 034,E02005726,7588,1303,6285
2021,Northumberland 019,E02005727,5825,805,5020
2021,Northumberland 037,E02005728,6460,899,5561
2021,Northumberland 036,E02005729,5404,926,4478
2021,Northumberland 035,E02005730,12173,1915,10258
2021,Northumberland 038,E02005731,10250,1926,8324
2021,Northumberland 040,E02005733,7943,1190,6753
2021,Northumberland 009,E02005734,5630,871,4759
2021,Northumberland 010,E02005735,6704,1314,5390
2021,Northumberland 013,E02005736,8202,1611,6591
2021,Northumberland 017,E02005739,8587,1304,7283
2021,Northumberland 020,E02005740,9566,1700,7866
2021,Northumberland 021,E02005741,8119,1292,6827
2021,Craven 001,E02005742,7145,974,6171
2021,Craven 003,E02005744,7631,1005,6626
2021,Craven 005,E02005746,6358,928,5430
2021,Craven 006,E02005747,6531,1059,5472
2021,Craven 007,E02005748,7465,1201,6264
2021,Craven 008,E02005749,9610,1608,8002
2021,Hambleton 001,E02005750,7401,1086,6315
2021,Hambleton 002,E02005751,8312,1056,7256
2021,Hambleton 003,E02005752,6644,937,5707
2021,Hambleton 005,E02005754,7162,941,6221
2021,Hambleton 006,E02005755,6468,951,5517
2021,Hambleton 007,E02005756,6026,888,5138
2021,Hambleton 008,E02005757,8282,1139,7143
2021,Hambleton 009,E02005758,9051,1508,7543
2021,Hambleton 010,E02005759,8901,1324,7577
2021,Hambleton 011,E02005760,5957,1015,4942
2021,Harrogate 001,E02005761,5290,877,4413
2021,Harrogate 002,E02005762,6008,1112,4896
2021,Harrogate 003,E02005763,6151,1044,5107
2021,Harrogate 004,E02005764,9908,1594,8314
2021,Harrogate 005,E02005765,6805,1002,5803
2021,Harrogate 006,E02005766,5796,856,4940
2021,Harrogate 007,E02005767,7073,1328,5745
2021,Harrogate 008,E02005768,7649,2279,5370
2021,Harrogate 009,E02005769,6661,1082,5579
2021,Harrogate 010,E02005770,8588,1314,7274
2021,Harrogate 011,E02005771,7168,1296,5872
2021,Harrogate 012,E02005772,5675,912,4763
2021,Harrogate 013,E02005773,8540,1338,7202
2021,Harrogate 014,E02005774,8892,1448,7444
2021,Harrogate 015,E02005775,8892,1069,7823
2021,Harrogate 016,E02005776,8959,2101,6858
2021,Harrogate 017,E02005777,7882,1484,6398
2021,Harrogate 018,E02005778,5875,923,4952
2021,Harrogate 019,E02005779,7135,1134,6001
2021,Harrogate 020,E02005780,10580,2244,8336
2021,Harrogate 021,E02005781,5855,1079,4776
2021,Richmondshire 001,E02005782,7258,1020,6238
2021,Richmondshire 002,E02005783,7785,1194,6591
2021,Richmondshire 003,E02005784,5559,882,4677
2021,Richmondshire 004,E02005785,13035,2525,10510
2021,Richmondshire 005,E02005786,5569,587,4982
2021,Richmondshire 006,E02005787,8245,1126,7119
2021,Ryedale 001,E02005788,6122,810,5312
2021,Ryedale 002,E02005789,10232,1331,8901
2021,Ryedale 003,E02005790,6845,1201,5644
2021,Ryedale 004,E02005791,6527,1026,5501
2021,Ryedale 007,E02005794,8937,1276,7661
2021,Scarborough 001,E02005795,6673,855,5818
2021,Scarborough 002,E02005796,6288,838,5450
2021,Scarborough 003,E02005797,5927,950,4977
2021,Scarborough 004,E02005798,7941,1111,6830
2021,Scarborough 005,E02005799,8994,1403,7591
2021,Scarborough 006,E02005800,7045,1068,5977
2021,Scarborough 007,E02005801,5259,1150,4109
2021,Scarborough 008,E02005802,7307,1394,5913
2021,Scarborough 009,E02005803,8804,1394,7410
2021,Scarborough 010,E02005804,7412,705,6707
2021,Scarborough 011,E02005805,7359,988,6371
2021,Scarborough 012,E02005806,7619,1703,5916
2021,Scarborough 013,E02005807,6242,1002,5240
2021,Scarborough 014,E02005808,11152,1420,9732
2021,Selby 001,E02005809,7132,1161,5971
2021,Selby 002,E02005810,8958,1714,7244
2021,Selby 003,E02005811,9369,1694,7675
2021,Selby 004,E02005812,10623,1854,8769
2021,Selby 005,E02005813,12374,2303,10071
2021,Selby 006,E02005814,6645,1079,5566
2021,Selby 007,E02005815,8248,1288,6960
2021,Selby 008,E02005816,8263,1376,6887
2021,Selby 009,E02005817,7041,1142,5899
2021,Selby 010,E02005818,8380,1387,6993
2021,Ashfield 001,E02005819,5960,967,4993
2021,Ashfield 002,E02005820,5315,806,4509
2021,Ashfield 003,E02005821,6322,1197,5125
2021,Ashfield 004,E02005822,9633,1913,7720
2021,Ashfield 005,E02005823,7264,1403,5861
2021,Ashfield 006,E02005824,9339,1566,7773
2021,Ashfield 007,E02005825,7380,1418,5962
2021,Ashfield 008,E02005826,5776,1248,4528
2021,Ashfield 009,E02005827,8972,1581,7391
2021,Ashfield 010,E02005828,7297,1141,6156
2021,Ashfield 011,E02005829,6286,1027,5259
2021,Ashfield 012,E02005830,5652,773,4879
2021,Ashfield 013,E02005831,9972,1842,8130
2021,Ashfield 014,E02005832,8811,1557,7254
2021,Ashfield 015,E02005833,7282,1223,6059
2021,Ashfield 016,E02005834,8260,1603,6657
2021,Bassetlaw 001,E02005835,10512,1782,8730
2021,Bassetlaw 002,E02005836,8862,1398,7464
2021,Bassetlaw 003,E02005837,7554,984,6570
2021,Bassetlaw 004,E02005838,7810,1277,6533
2021,Bassetlaw 005,E02005839,6078,906,5172
2021,Bassetlaw 006,E02005840,9166,1858,7308
2021,Bassetlaw 008,E02005842,8320,1343,6977
2021,Bassetlaw 009,E02005843,6636,1222,5414
2021,Bassetlaw 010,E02005844,8269,1515,6754
2021,Bassetlaw 012,E02005846,6290,1246,5044
2021,Bassetlaw 013,E02005847,6600,995,5605
2021,Bassetlaw 014,E02005848,6130,978,5152
2021,Bassetlaw 015,E02005849,9067,1493,7574
2021,Broxtowe 001,E02005850,6395,964,5431
2021,Broxtowe 002,E02005851,5874,1094,4780
2021,Broxtowe 003,E02005852,7899,1134,6765
2021,Broxtowe 004,E02005853,8684,1448,7236
2021,Broxtowe 007,E02005856,6947,1197,5750
2021,Broxtowe 008,E02005857,5804,1055,4749
2021,Broxtowe 009,E02005858,7745,2363,5382
2021,Broxtowe 010,E02005859,8785,1633,7152
2021,Broxtowe 011,E02005860,8759,2581,6178
2021,Broxtowe 012,E02005861,5124,883,4241
2021,Broxtowe 013,E02005862,7139,1314,5825
2021,Broxtowe 014,E02005863,7093,1174,5919
2021,Broxtowe 015,E02005864,7763,1497,6266
2021,Gedling 001,E02005865,8195,1331,6864
2021,Gedling 002,E02005866,8761,1437,7324
2021,Gedling 004,E02005868,6926,1277,5649
2021,Gedling 005,E02005869,5553,1210,4343
2021,Gedling 006,E02005870,6341,1229,5112
2021,Gedling 007,E02005871,6738,1028,5710
2021,Gedling 008,E02005872,6300,1088,5212
2021,Gedling 009,E02005873,9583,1685,7898
2021,Gedling 010,E02005874,7981,1292,6689
2021,Gedling 011,E02005875,7700,1407,6293
2021,Gedling 012,E02005876,8372,1504,6868
2021,Gedling 013,E02005877,6995,1322,5673
2021,Gedling 014,E02005878,9232,1577,7655
2021,Gedling 015,E02005879,6833,1204,5629
2021,Mansfield 001,E02005880,6036,1162,4874
2021,Mansfield 002,E02005881,5873,1014,4859
2021,Mansfield 003,E02005882,7512,1238,6274
2021,Mansfield 004,E02005883,7821,1482,6339
2021,Mansfield 005,E02005884,5812,858,4954
2021,Mansfield 006,E02005885,8429,1450,6979
2021,Mansfield 007,E02005886,10830,2004,8826
2021,Mansfield 008,E02005887,9528,1571,7957
2021,Mansfield 009,E02005888,7918,1453,6465
2021,Mansfield 010,E02005889,10098,1845,8253
2021,Mansfield 011,E02005890,6275,923,5352
2021,Mansfield 012,E02005891,6005,1173,4832
2021,Mansfield 013,E02005892,12387,2139,10248
2021,Newark and Sherwood 001,E02005893,10669,1833,8836
2021,Newark and Sherwood 002,E02005894,11024,1989,9035
2021,Newark and Sherwood 003,E02005895,7773,1158,6615
2021,Newark and Sherwood 004,E02005896,7279,1063,6216
2021,Newark and Sherwood 005,E02005897,8876,1529,7347
2021,Newark and Sherwood 006,E02005898,10766,1897,8869
2021,Newark and Sherwood 007,E02005899,10960,1749,9211
2021,Newark and Sherwood 008,E02005900,7339,1693,5646
2021,Newark and Sherwood 009,E02005901,9109,1652,7457
2021,Newark and Sherwood 010,E02005902,7707,1362,6345
2021,Newark and Sherwood 011,E02005903,9865,1577,8288
2021,Newark and Sherwood 012,E02005904,9027,1695,7332
2021,Newark and Sherwood 013,E02005905,6500,849,5651
2021,Rushcliffe 001,E02005906,7005,1038,5967
2021,Rushcliffe 002,E02005907,9571,1967,7604
2021,Rushcliffe 003,E02005908,8852,1525,7327
2021,Rushcliffe 004,E02005909,7869,1965,5904
2021,Rushcliffe 005,E02005910,8557,2411,6146
2021,Rushcliffe 006,E02005911,8128,1758,6370
2021,Rushcliffe 007,E02005912,8916,1764,7152
2021,Rushcliffe 008,E02005913,8090,1770,6320
2021,Rushcliffe 009,E02005914,7715,1426,6289
2021,Rushcliffe 010,E02005915,5461,838,4623
2021,Rushcliffe 011,E02005916,7243,1323,5920
2021,Rushcliffe 012,E02005917,5721,923,4798
2021,Rushcliffe 013,E02005918,4842,795,4047
2021,Rushcliffe 014,E02005919,6969,1959,5010
2021,Rushcliffe 015,E02005920,8285,1402,6883
2021,Cherwell 001,E02005921,6490,947,5543
2021,Cherwell 002,E02005922,8249,1521,6728
2021,Cherwell 003,E02005923,5643,1164,4479
2021,Cherwell 004,E02005924,11781,1828,9953
2021,Cherwell 005,E02005925,8317,1984,6333
2021,Cherwell 006,E02005926,8656,1464,7192
2021,Cherwell 007,E02005927,5332,887,4445
2021,Cherwell 008,E02005928,10382,2119,8263
2021,Cherwell 009,E02005929,7025,1278,5747
2021,Cherwell 010,E02005930,8872,1605,7267
2021,Cherwell 011,E02005931,10499,1942,8557
2021,Cherwell 012,E02005932,6352,1220,5132
2021,Cherwell 013,E02005933,7292,1239,6053
2021,Cherwell 014,E02005934,8403,1444,6959
2021,Cherwell 015,E02005935,8058,1373,6685
2021,Cherwell 016,E02005936,12201,2273,9928
2021,Cherwell 017,E02005937,6270,906,5364
2021,Cherwell 018,E02005938,5398,954,4444
2021,Cherwell 019,E02005939,6441,1085,5356
2021,Oxford 001,E02005940,5896,1298,4598
2021,Oxford 002,E02005941,6821,2165,4656
2021,Oxford 003,E02005942,6064,2170,3894
2021,Oxford 004,E02005943,6961,1871,5090
2021,Oxford 005,E02005944,7869,1863,6006
2021,Oxford 006,E02005945,10736,3832,6904
2021,Oxford 007,E02005946,8018,1750,6268
2021,Oxford 008,E02005947,18220,14399,3821
2021,Oxford 009,E02005948,6293,2166,4127
2021,Oxford 010,E02005949,7266,2820,4446
2021,Oxford 011,E02005950,10835,5111,5724
2021,Oxford 012,E02005951,5363,1349,4014
2021,Oxford 014,E02005953,5776,1703,4073
2021,Oxford 015,E02005954,9843,1919,7924
2021,Oxford 016,E02005955,10507,2333,8174
2021,Oxford 017,E02005956,6189,1381,4808
2021,Oxford 018,E02005957,6462,1581,4881
2021,South Oxfordshire 001,E02005958,5102,837,4265
2021,South Oxfordshire 002,E02005959,5616,1025,4591
2021,South Oxfordshire 003,E02005960,7401,1458,5943
2021,South Oxfordshire 004,E02005961,6429,1033,5396
2021,South Oxfordshire 005,E02005962,9563,1660,7903
2021,South Oxfordshire 006,E02005963,7669,1282,6387
2021,South Oxfordshire 007,E02005964,6962,1123,5839
2021,South Oxfordshire 008,E02005965,5262,911,4351
2021,South Oxfordshire 009,E02005966,7659,1449,6210
2021,South Oxfordshire 010,E02005967,8838,1657,7181
2021,South Oxfordshire 011,E02005968,7517,1316,6201
2021,South Oxfordshire 012,E02005969,9171,1627,7544
2021,South Oxfordshire 013,E02005970,5202,822,4380
2021,South Oxfordshire 014,E02005971,6014,1075,4939
2021,South Oxfordshire 015,E02005972,11176,2249,8927
2021,South Oxfordshire 016,E02005973,5659,883,4776
2021,South Oxfordshire 017,E02005974,5976,1032,4944
2021,South Oxfordshire 018,E02005975,7921,1622,6299
2021,South Oxfordshire 019,E02005976,6117,1300,4817
2021,South Oxfordshire 020,E02005977,5851,1063,4788
2021,Vale of White Horse 001,E02005978,7267,1254,6013
2021,Vale of White Horse 002,E02005979,9842,2104,7738
2021,Vale of White Horse 003,E02005980,11220,2681,8539
2021,Vale of White Horse 004,E02005981,8154,1380,6774
2021,Vale of White Horse 005,E02005982,5419,930,4489
2021,Vale of White Horse 006,E02005983,10408,1793,8615
2021,Vale of White Horse 007,E02005984,8647,1629,7018
2021,Vale of White Horse 008,E02005985,7464,1293,6171
2021,Vale of White Horse 009,E02005986,9182,1666,7516
2021,Vale of White Horse 010,E02005987,9583,1841,7742
2021,Vale of White Horse 011,E02005988,8464,1523,6941
2021,Vale of White Horse 014,E02005991,9561,1569,7992
2021,Vale of White Horse 015,E02005992,12929,2503,10426
2021,West Oxfordshire 001,E02005993,6860,1120,5740
2021,West Oxfordshire 002,E02005994,6004,1115,4889
2021,West Oxfordshire 003,E02005995,6132,992,5140
2021,West Oxfordshire 004,E02005996,8535,1555,6980
2021,West Oxfordshire 005,E02005997,5708,903,4805
2021,West Oxfordshire 006,E02005998,6674,1188,5486
2021,West Oxfordshire 007,E02005999,6284,1032,5252
2021,West Oxfordshire 008,E02006000,11206,2124,9082
2021,West Oxfordshire 009,E02006001,6634,1276,5358
2021,West Oxfordshire 010,E02006002,10247,1548,8699
2021,West Oxfordshire 011,E02006003,5647,972,4675
2021,West Oxfordshire 012,E02006004,7076,934,6142
2021,West Oxfordshire 013,E02006005,9192,1938,7254
2021,West Oxfordshire 014,E02006006,5353,894,4459
2021,West Oxfordshire 015,E02006007,6966,1199,5767
2021,Shropshire 025,E02006008,9866,1666,8200
2021,Shropshire 027,E02006009,7627,1241,6386
2021,Shropshire 029,E02006010,11346,1829,9517
2021,Shropshire 031,E02006011,5459,835,4624
2021,Shropshire 033,E02006012,5977,782,5195
2021,Shropshire 034,E02006013,7607,1125,6482
2021,Shropshire 035,E02006014,9421,1262,8159
2021,Shropshire 001,E02006015,9685,1570,8115
2021,Shropshire 002,E02006016,7805,1148,6657
2021,Shropshire 004,E02006017,7758,1291,6467
2021,Shropshire 005,E02006018,11903,2009,9894
2021,Shropshire 008,E02006019,6006,981,5025
2021,Shropshire 009,E02006020,7409,1061,6348
2021,Shropshire 010,E02006021,8408,1450,6958
2021,Shropshire 013,E02006022,5749,923,4826
2021,Shropshire 003,E02006023,9514,1763,7751
2021,Shropshire 006,E02006024,9312,1588,7724
2021,Shropshire 007,E02006025,9229,1565,7664
2021,Shropshire 011,E02006026,7086,1235,5851
2021,Shropshire 012,E02006027,5222,759,4463
2021,Shropshire 014,E02006028,9423,1557,7866
2021,Shropshire 015,E02006029,7713,1626,6087
2021,Shropshire 016,E02006030,8545,1484,7061
2021,Shropshire 017,E02006031,7584,1163,6421
2021,Shropshire 018,E02006032,8145,1563,6582
2021,Shropshire 019,E02006033,8186,1085,7101
2021,Shropshire 020,E02006034,10063,1902,8161
2021,Shropshire 021,E02006035,5647,799,4848
2021,Shropshire 022,E02006036,6309,897,5412
2021,Shropshire 023,E02006037,9551,2134,7417
2021,Shropshire 024,E02006038,7985,1346,6639
2021,Shropshire 026,E02006039,7886,1307,6579
2021,Shropshire 028,E02006040,7509,1313,6196
2021,Shropshire 030,E02006041,5435,738,4697
2021,Shropshire 032,E02006042,5618,678,4940
2021,Shropshire 036,E02006043,6434,905,5529
2021,Shropshire 037,E02006044,5921,764,5157
2021,Shropshire 038,E02006045,10288,1411,8877
2021,Shropshire 039,E02006046,8550,1220,7330
2021,Mendip 001,E02006047,8408,1430,6978
2021,Mendip 002,E02006048,6901,1349,5552
2021,Mendip 003,E02006049,6866,1045,5821
2021,Mendip 004,E02006050,8273,1528,6745
2021,Mendip 005,E02006051,8134,1506,6628
2021,Mendip 006,E02006052,7438,1151,6287
2021,Mendip 007,E02006053,10413,2048,8365
2021,Mendip 008,E02006054,7965,1102,6863
2021,Mendip 009,E02006055,8533,1459,7074
2021,Mendip 010,E02006056,7410,1162,6248
2021,Mendip 011,E02006057,7324,1021,6303
2021,Mendip 012,E02006058,8449,2140,6309
2021,Mendip 013,E02006059,6680,1029,5651
2021,Mendip 014,E02006060,7832,1419,6413
2021,Sedgemoor 001,E02006061,8977,1548,7429
2021,Sedgemoor 002,E02006062,10689,1499,9190
2021,Sedgemoor 003,E02006063,6689,1159,5530
2021,Sedgemoor 004,E02006064,7528,911,6617
2021,Sedgemoor 005,E02006065,8434,1486,6948
2021,Sedgemoor 006,E02006066,8125,1224,6901
2021,Sedgemoor 007,E02006067,6871,1192,5679
2021,Sedgemoor 008,E02006068,7418,1607,5811
2021,Sedgemoor 009,E02006069,9975,1646,8329
2021,Sedgemoor 010,E02006070,8200,1320,6880
2021,Sedgemoor 011,E02006071,9119,1664,7455
2021,Sedgemoor 012,E02006072,9050,1300,7750
2021,Sedgemoor 013,E02006073,7363,1521,5842
2021,Sedgemoor 014,E02006074,10907,2038,8869
2021,South Somerset 001,E02006075,5107,1124,3983
2021,South Somerset 002,E02006076,8769,1279,7490
2021,South Somerset 003,E02006077,5933,932,5001
2021,South Somerset 004,E02006078,6046,874,5172
2021,South Somerset 005,E02006079,7888,1229,6659
2021,South Somerset 006,E02006080,6573,1047,5526
2021,South Somerset 007,E02006081,5540,925,4615
2021,South Somerset 008,E02006082,6710,1046,5664
2021,South Somerset 009,E02006083,5382,720,4662
2021,South Somerset 010,E02006084,7205,1017,6188
2021,South Somerset 011,E02006085,7232,1238,5994
2021,South Somerset 012,E02006086,7339,1471,5868
2021,South Somerset 013,E02006087,5660,1104,4556
2021,South Somerset 014,E02006088,7375,1514,5861
2021,South Somerset 015,E02006089,6812,1079,5733
2021,South Somerset 016,E02006090,6799,1172,5627
2021,South Somerset 017,E02006091,9591,1440,8151
2021,South Somerset 018,E02006092,6208,950,5258
2021,South Somerset 019,E02006093,8356,1228,7128
2021,South Somerset 020,E02006094,5211,778,4433
2021,South Somerset 021,E02006095,7997,1170,6827
2021,South Somerset 022,E02006096,6935,1109,5826
2021,South Somerset 023,E02006097,6546,1094,5452
2021,South Somerset 024,E02006098,7227,979,6248
2021,Somerset West and Taunton 006,E02006099,6869,1308,5561
2021,Somerset West and Taunton 007,E02006100,7756,1608,6148
2021,Somerset West and Taunton 013,E02006101,5569,901,4668
2021,Somerset West and Taunton 010,E02006102,6536,1181,5355
2021,Somerset West and Taunton 009,E02006103,7669,1275,6394
2021,Somerset West and Taunton 008,E02006104,10023,1849,8174
2021,Somerset West and Taunton 011,E02006105,10611,1626,8985
2021,Somerset West and Taunton 012,E02006106,9336,1748,7588
2021,Somerset West and Taunton 014,E02006107,7881,1653,6228
2021,Somerset West and Taunton 015,E02006108,8310,1166,7144
2021,Somerset West and Taunton 016,E02006109,7609,1359,6250
2021,Somerset West and Taunton 018,E02006110,9873,1726,8147
2021,Somerset West and Taunton 017,E02006111,10304,1558,8746
2021,Somerset West and Taunton 019,E02006112,8007,1403,6604
2021,Somerset West and Taunton 001,E02006113,7126,982,6144
2021,Somerset West and Taunton 002,E02006114,6172,694,5478
2021,Somerset West and Taunton 003,E02006115,7246,990,6256
2021,Somerset West and Taunton 004,E02006116,7741,956,6785
2021,Somerset West and Taunton 005,E02006117,5449,601,4848
2021,Cannock Chase 001,E02006118,7086,1060,6026
2021,Cannock Chase 002,E02006119,7722,1377,6345
2021,Cannock Chase 003,E02006120,8765,1629,7136
2021,Cannock Chase 004,E02006121,5529,871,4658
2021,Cannock Chase 005,E02006122,7542,1251,6291
2021,Cannock Chase 006,E02006123,6134,1054,5080
2021,Cannock Chase 007,E02006124,6929,1357,5572
2021,Cannock Chase 008,E02006125,6908,1129,5779
2021,Cannock Chase 009,E02006126,7936,1301,6635
2021,Cannock Chase 010,E02006127,6729,1325,5404
2021,Cannock Chase 011,E02006128,8103,1142,6961
2021,Cannock Chase 012,E02006129,7757,1325,6432
2021,Cannock Chase 013,E02006130,7815,1339,6476
2021,East Staffordshire 001,E02006131,7437,1266,6171
2021,East Staffordshire 002,E02006132,6653,1300,5353
2021,East Staffordshire 003,E02006133,6606,1112,5494
2021,East Staffordshire 004,E02006134,9964,1704,8260
2021,East Staffordshire 005,E02006135,7452,1233,6219
2021,East Staffordshire 006,E02006136,8734,1218,7516
2021,East Staffordshire 007,E02006137,8597,1800,6797
2021,East Staffordshire 008,E02006138,7402,1736,5666
2021,East Staffordshire 009,E02006139,7856,1753,6103
2021,East Staffordshire 010,E02006140,7920,1565,6355
2021,East Staffordshire 011,E02006141,11205,2385,8820
2021,East Staffordshire 012,E02006142,5011,787,4224
2021,East Staffordshire 013,E02006143,8784,1694,7090
2021,East Staffordshire 014,E02006144,7716,1388,6328
2021,East Staffordshire 015,E02006145,5717,1061,4656
2021,Lichfield 001,E02006146,8278,1338,6940
2021,Lichfield 002,E02006147,8012,1500,6512
2021,Lichfield 003,E02006148,6879,1062,5817
2021,Lichfield 004,E02006149,10179,1866,8313
2021,Lichfield 005,E02006150,10994,1627,9367
2021,Lichfield 006,E02006151,9243,1526,7717
2021,Lichfield 007,E02006152,9871,1794,8077
2021,Lichfield 008,E02006153,8597,1407,7190
2021,Lichfield 009,E02006154,9269,1262,8007
2021,Lichfield 010,E02006155,5347,1084,4263
2021,Lichfield 011,E02006156,7653,1229,6424
2021,Lichfield 012,E02006157,6883,1061,5822
2021,Newcastle-under-Lyme 001,E02006158,7792,1162,6630
2021,Newcastle-under-Lyme 002,E02006159,5406,983,4423
2021,Newcastle-under-Lyme 003,E02006160,8141,1407,6734
2021,Newcastle-under-Lyme 004,E02006161,6290,1025,5265
2021,Newcastle-under-Lyme 005,E02006162,7956,1224,6732
2021,Newcastle-under-Lyme 006,E02006163,7421,1504,5917
2021,Newcastle-under-Lyme 007,E02006164,6770,1373,5397
2021,Newcastle-under-Lyme 008,E02006165,7014,1125,5889
2021,Newcastle-under-Lyme 009,E02006166,6691,1110,5581
2021,Newcastle-under-Lyme 010,E02006167,9401,2472,6929
2021,Newcastle-under-Lyme 011,E02006168,8035,2174,5861
2021,Newcastle-under-Lyme 012,E02006169,7301,3182,4119
2021,Newcastle-under-Lyme 013,E02006170,4947,773,4174
2021,Newcastle-under-Lyme 014,E02006171,8588,1805,6783
2021,Newcastle-under-Lyme 015,E02006172,9058,1556,7502
2021,Newcastle-under-Lyme 016,E02006173,6698,974,5724
2021,South Staffordshire 001,E02006174,10412,1645,8767
2021,South Staffordshire 002,E02006175,6455,1150,5305
2021,South Staffordshire 003,E02006176,7064,1086,5978
2021,South Staffordshire 004,E02006177,9290,1418,7872
2021,South Staffordshire 005,E02006178,7145,1096,6049
2021,South Staffordshire 006,E02006179,9261,917,8344
2021,South Staffordshire 007,E02006180,6597,1144,5453
2021,South Staffordshire 008,E02006181,5273,871,4402
2021,South Staffordshire 009,E02006182,6829,1217,5612
2021,South Staffordshire 012,E02006185,6801,1107,5694
2021,South Staffordshire 013,E02006186,11967,1748,10219
2021,South Staffordshire 014,E02006187,6865,998,5867
2021,Stafford 001,E02006188,5743,912,4831
2021,Stafford 002,E02006189,6934,1066,5868
2021,Stafford 003,E02006190,10529,1839,8690
2021,Stafford 004,E02006191,7731,1212,6519
2021,Stafford 005,E02006192,8782,1354,7428
2021,Stafford 006,E02006193,7065,1152,5913
2021,Stafford 007,E02006194,7883,1514,6369
2021,Stafford 008,E02006195,8390,1259,7131
2021,Stafford 009,E02006196,6811,1264,5547
2021,Stafford 010,E02006197,8831,1383,7448
2021,Stafford 011,E02006198,8502,1541,6961
2021,Stafford 012,E02006199,7985,1218,6767
2021,Stafford 013,E02006200,7225,1424,5801
2021,Stafford 014,E02006201,11603,2193,9410
2021,Stafford 015,E02006202,8864,1284,7580
2021,Stafford 016,E02006203,7271,1426,5845
2021,Staffordshire Moorlands 001,E02006204,7095,1305,5790
2021,Staffordshire Moorlands 002,E02006205,7007,945,6062
2021,Staffordshire Moorlands 003,E02006206,7560,1563,5997
2021,Staffordshire Moorlands 004,E02006207,6033,799,5234
2021,Staffordshire Moorlands 005,E02006208,7597,1218,6379
2021,Staffordshire Moorlands 006,E02006209,10160,1627,8533
2021,Staffordshire Moorlands 007,E02006210,5002,694,4308
2021,Staffordshire Moorlands 008,E02006211,6124,968,5156
2021,Staffordshire Moorlands 009,E02006212,7432,1146,6286
2021,Staffordshire Moorlands 010,E02006213,6276,995,5281
2021,Staffordshire Moorlands 011,E02006214,5867,914,4953
2021,Staffordshire Moorlands 012,E02006215,7554,1124,6430
2021,Staffordshire Moorlands 013,E02006216,8069,1327,6742
2021,Tamworth 001,E02006217,9634,1654,7980
2021,Tamworth 002,E02006218,7990,1250,6740
2021,Tamworth 003,E02006219,7812,1402,6410
2021,Tamworth 004,E02006220,6978,1150,5828
2021,Tamworth 005,E02006221,5546,974,4572
2021,Tamworth 006,E02006222,6513,1245,5268
2021,Tamworth 007,E02006223,6395,1659,4736
2021,Tamworth 008,E02006224,7083,1292,5791
2021,Tamworth 009,E02006225,6986,1203,5783
2021,Tamworth 010,E02006226,9269,1805,7464
2021,Babergh 001,E02006227,6198,812,5386
2021,Babergh 002,E02006228,5867,939,4928
2021,Babergh 003,E02006229,5955,848,5107
2021,Babergh 004,E02006230,10541,1898,8643
2021,Babergh 005,E02006231,8232,1339,6893
2021,Babergh 006,E02006232,5854,910,4944
2021,Babergh 007,E02006233,11069,1615,9454
2021,Babergh 008,E02006234,9406,1851,7555
2021,Babergh 009,E02006235,7869,1198,6671
2021,Babergh 010,E02006236,10065,1691,8374
2021,Babergh 011,E02006237,7314,1386,5928
2021,West Suffolk 002,E02006238,9203,1406,7797
2021,West Suffolk 001,E02006239,8060,1587,6473
2021,West Suffolk 003,E02006240,9373,1643,7730
2021,West Suffolk 004,E02006241,8358,1417,6941
2021,West Suffolk 007,E02006242,9808,1819,7989
2021,West Suffolk 008,E02006243,8818,1371,7447
2021,Ipswich 001,E02006245,7775,1568,6207
2021,Ipswich 002,E02006246,7033,1202,5831
2021,Ipswich 003,E02006247,8511,1747,6764
2021,Ipswich 004,E02006248,8052,1872,6180
2021,Ipswich 005,E02006249,8028,1576,6452
2021,Ipswich 006,E02006250,9478,1882,7596
2021,Ipswich 007,E02006251,10061,1773,8288
2021,Ipswich 008,E02006252,9130,1837,7293
2021,Ipswich 009,E02006253,7100,1201,5899
2021,Ipswich 010,E02006254,8813,1755,7058
2021,Ipswich 011,E02006255,7666,1574,6092
2021,Ipswich 012,E02006256,9157,1851,7306
2021,Ipswich 013,E02006257,6423,1217,5206
2021,Ipswich 014,E02006258,9079,2046,7033
2021,Ipswich 015,E02006259,6772,1341,5431
2021,Ipswich 016,E02006260,8236,1846,6390
2021,Mid Suffolk 001,E02006261,7702,1174,6528
2021,Mid Suffolk 002,E02006262,8669,1355,7314
2021,Mid Suffolk 003,E02006263,7263,1071,6192
2021,Mid Suffolk 004,E02006264,8420,1395,7025
2021,Mid Suffolk 005,E02006265,7064,1046,6018
2021,Mid Suffolk 006,E02006266,9046,1342,7704
2021,Mid Suffolk 007,E02006267,8097,1363,6734
2021,Mid Suffolk 008,E02006268,5887,994,4893
2021,Mid Suffolk 009,E02006269,7345,1173,6172
2021,Mid Suffolk 010,E02006270,12056,2200,9856
2021,Mid Suffolk 011,E02006271,9278,1270,8008
2021,Mid Suffolk 012,E02006272,7372,1163,6209
2021,West Suffolk 005,E02006273,6546,983,5563
2021,West Suffolk 006,E02006274,6290,965,5325
2021,West Suffolk 009,E02006275,6616,1328,5288
2021,West Suffolk 016,E02006276,7830,1292,6538
2021,West Suffolk 012,E02006277,7249,1459,5790
2021,West Suffolk 011,E02006278,8033,1080,6953
2021,West Suffolk 014,E02006279,8235,1261,6974
2021,West Suffolk 010,E02006280,9305,1654,7651
2021,West Suffolk 013,E02006281,8016,1075,6941
2021,West Suffolk 017,E02006282,6307,896,5411
2021,West Suffolk 018,E02006283,7912,1100,6812
2021,West Suffolk 019,E02006284,7287,1334,5953
2021,West Suffolk 021,E02006285,7122,1471,5651
2021,West Suffolk 020,E02006286,10492,2014,8478
2021,East Suffolk 016,E02006287,6044,717,5327
2021,East Suffolk 017,E02006288,9661,1766,7895
2021,East Suffolk 018,E02006289,9229,1412,7817
2021,East Suffolk 019,E02006290,7761,1022,6739
2021,East Suffolk 020,E02006291,7344,1107,6237
2021,East Suffolk 021,E02006292,6559,1116,5443
2021,East Suffolk 023,E02006293,10647,1708,8939
2021,East Suffolk 022,E02006294,7619,1146,6473
2021,East Suffolk 024,E02006295,8938,1606,7332
2021,East Suffolk 025,E02006296,12471,2479,9992
2021,East Suffolk 026,E02006297,7783,1270,6513
2021,East Suffolk 027,E02006298,8723,1321,7402
2021,East Suffolk 028,E02006299,8004,962,7042
2021,East Suffolk 029,E02006300,7475,1297,6178
2021,East Suffolk 030,E02006301,6047,856,5191
2021,East Suffolk 001,E02006302,6462,826,5636
2021,East Suffolk 002,E02006303,7534,1638,5896
2021,East Suffolk 003,E02006304,7782,1113,6669
2021,East Suffolk 004,E02006305,9030,1879,7151
2021,East Suffolk 005,E02006306,6954,1135,5819
2021,East Suffolk 007,E02006307,7118,953,6165
2021,East Suffolk 006,E02006308,7188,1177,6011
2021,East Suffolk 009,E02006309,6450,1094,5356
2021,East Suffolk 008,E02006310,7667,1399,6268
2021,East Suffolk 010,E02006311,7891,1249,6642
2021,East Suffolk 011,E02006312,8163,1245,6918
2021,East Suffolk 012,E02006313,9524,1398,8126
2021,East Suffolk 013,E02006314,6946,992,5954
2021,East Suffolk 014,E02006315,5633,702,4931
2021,East Suffolk 015,E02006316,6784,941,5843
2021,Elmbridge 001,E02006317,5966,1197,4769
2021,Elmbridge 002,E02006318,6521,1176,5345
2021,Elmbridge 003,E02006319,6709,1386,5323
2021,Elmbridge 004,E02006320,6632,1268,5364
2021,Elmbridge 005,E02006321,6181,1417,4764
2021,Elmbridge 006,E02006322,6129,1443,4686
2021,Elmbridge 007,E02006323,7025,1275,5750
2021,Elmbridge 008,E02006324,7329,1669,5660
2021,Elmbridge 009,E02006325,8694,2152,6542
2021,Elmbridge 010,E02006326,6997,1426,5571
2021,Elmbridge 011,E02006327,6333,1393,4940
2021,Elmbridge 012,E02006328,9028,1828,7200
2021,Elmbridge 013,E02006329,6775,1436,5339
2021,Elmbridge 014,E02006330,9292,1899,7393
2021,Elmbridge 015,E02006331,6879,1507,5372
2021,Elmbridge 016,E02006332,6335,1299,5036
2021,Elmbridge 017,E02006333,9452,2249,7203
2021,Elmbridge 018,E02006334,8130,1861,6269
2021,Epsom and Ewell 001,E02006335,7503,1323,6180
2021,Epsom and Ewell 002,E02006336,6702,1439,5263
2021,Epsom and Ewell 003,E02006337,8385,1607,6778
2021,Epsom and Ewell 004,E02006338,6395,1265,5130
2021,Epsom and Ewell 005,E02006339,10204,2416,7788
2021,Epsom and Ewell 007,E02006341,9649,2085,7564
2021,Epsom and Ewell 008,E02006342,7704,1665,6039
2021,Epsom and Ewell 009,E02006343,8584,2040,6544
2021,Guildford 001,E02006344,8182,1502,6680
2021,Guildford 002,E02006345,7322,1195,6127
2021,Guildford 003,E02006346,9562,2042,7520
2021,Guildford 004,E02006347,6721,1061,5660
2021,Guildford 005,E02006348,8002,1502,6500
2021,Guildford 006,E02006349,7553,1908,5645
2021,Guildford 007,E02006350,6000,1319,4681
2021,Guildford 008,E02006351,7965,1836,6129
2021,Guildford 009,E02006352,5856,1803,4053
2021,Guildford 010,E02006353,5782,1047,4735
2021,Guildford 011,E02006354,9196,2136,7060
2021,Guildford 012,E02006355,9466,5223,4243
2021,Guildford 013,E02006356,10892,2316,8576
2021,Guildford 014,E02006357,6739,1094,5645
2021,Guildford 015,E02006358,8673,4400,4273
2021,Guildford 016,E02006359,5855,1268,4587
2021,Guildford 017,E02006360,7761,1474,6287
2021,Guildford 018,E02006361,5439,1006,4433
2021,Mole Valley 001,E02006362,6557,1360,5197
2021,Mole Valley 002,E02006363,5781,1195,4586
2021,Mole Valley 003,E02006364,7180,1223,5957
2021,Mole Valley 004,E02006365,6013,1017,4996
2021,Mole Valley 005,E02006366,7643,1390,6253
2021,Mole Valley 006,E02006367,5722,1043,4679
2021,Mole Valley 007,E02006368,5464,962,4502
2021,Mole Valley 008,E02006369,6038,818,5220
2021,Mole Valley 009,E02006370,6068,1034,5034
2021,Mole Valley 010,E02006371,7006,1208,5798
2021,Mole Valley 011,E02006372,6047,1147,4900
2021,Mole Valley 012,E02006373,7206,1266,5940
2021,Mole Valley 013,E02006374,6654,989,5665
2021,Reigate and Banstead 001,E02006375,6423,1232,5191
2021,Reigate and Banstead 002,E02006376,8865,1360,7505
2021,Reigate and Banstead 003,E02006377,5919,1088,4831
2021,Reigate and Banstead 004,E02006378,8353,1640,6713
2021,Reigate and Banstead 005,E02006379,6411,1467,4944
2021,Reigate and Banstead 006,E02006380,6774,1149,5625
2021,Reigate and Banstead 007,E02006381,6922,1212,5710
2021,Reigate and Banstead 008,E02006382,6360,1370,4990
2021,Reigate and Banstead 009,E02006383,9609,2127,7482
2021,Reigate and Banstead 010,E02006384,10266,2145,8121
2021,Reigate and Banstead 011,E02006385,10439,1878,8561
2021,Reigate and Banstead 012,E02006386,7927,1872,6055
2021,Reigate and Banstead 013,E02006387,6369,1477,4892
2021,Reigate and Banstead 014,E02006388,8743,1642,7101
2021,Reigate and Banstead 015,E02006389,6927,1407,5520
2021,Reigate and Banstead 016,E02006390,9682,1914,7768
2021,Reigate and Banstead 017,E02006391,7230,1447,5783
2021,Reigate and Banstead 018,E02006392,8585,1337,7248
2021,Runnymede 001,E02006393,6628,2361,4267
2021,Runnymede 002,E02006394,11484,5989,5495
2021,Runnymede 003,E02006395,9129,1708,7421
2021,Runnymede 004,E02006396,5700,1007,4693
2021,Runnymede 005,E02006397,6048,1229,4819
2021,Runnymede 006,E02006398,8077,1406,6671
2021,Runnymede 007,E02006399,11425,2050,9375
2021,Runnymede 008,E02006400,5386,877,4509
2021,Runnymede 009,E02006401,10065,1948,8117
2021,Runnymede 010,E02006402,9356,1702,7654
2021,Spelthorne 001,E02006403,6253,1123,5130
2021,Spelthorne 002,E02006404,7217,1623,5594
2021,Spelthorne 003,E02006405,10711,1851,8860
2021,Spelthorne 004,E02006406,8408,1380,7028
2021,Spelthorne 005,E02006407,8753,1582,7171
2021,Spelthorne 006,E02006408,8287,1489,6798
2021,Spelthorne 007,E02006409,6406,1265,5141
2021,Spelthorne 008,E02006410,7964,1716,6248
2021,Spelthorne 009,E02006411,6825,1085,5740
2021,Spelthorne 010,E02006412,7353,1420,5933
2021,Spelthorne 011,E02006413,6144,1092,5052
2021,Spelthorne 012,E02006414,5927,1089,4838
2021,Spelthorne 013,E02006415,6697,1036,5661
2021,Surrey Heath 001,E02006416,7953,1373,6580
2021,Surrey Heath 002,E02006417,5725,1011,4714
2021,Surrey Heath 003,E02006418,6278,979,5299
2021,Surrey Heath 004,E02006419,7751,1487,6264
2021,Surrey Heath 005,E02006420,7455,1329,6126
2021,Surrey Heath 006,E02006421,9812,2173,7639
2021,Surrey Heath 007,E02006422,5917,1274,4643
2021,Surrey Heath 008,E02006423,10618,1836,8782
2021,Surrey Heath 009,E02006424,6230,1259,4971
2021,Surrey Heath 010,E02006425,6153,1168,4985
2021,Surrey Heath 011,E02006426,5281,967,4314
2021,Surrey Heath 012,E02006427,6802,1213,5589
2021,Tandridge 002,E02006429,7634,1273,6361
2021,Tandridge 003,E02006430,8865,1814,7051
2021,Tandridge 004,E02006431,10870,2579,8291
2021,Tandridge 005,E02006432,5373,964,4409
2021,Tandridge 006,E02006433,8983,1638,7345
2021,Tandridge 007,E02006434,6231,1295,4936
2021,Tandridge 008,E02006435,5771,1048,4723
2021,Tandridge 009,E02006436,5843,1056,4787
2021,Tandridge 010,E02006437,7998,1466,6532
2021,Tandridge 011,E02006438,8027,1348,6679
2021,Waverley 001,E02006439,5919,1057,4862
2021,Waverley 002,E02006440,6845,1397,5448
2021,Waverley 003,E02006441,8019,1999,6020
2021,Waverley 004,E02006442,6127,1440,4687
2021,Waverley 005,E02006443,6993,1176,5817
2021,Waverley 006,E02006444,6762,1657,5105
2021,Waverley 007,E02006445,7942,1875,6067
2021,Waverley 008,E02006446,6659,1449,5210
2021,Waverley 009,E02006447,6439,1562,4877
2021,Waverley 010,E02006448,6941,1412,5529
2021,Waverley 011,E02006449,6601,1213,5388
2021,Waverley 012,E02006450,6801,1399,5402
2021,Waverley 013,E02006451,11250,2293,8957
2021,Waverley 015,E02006453,8021,1598,6423
2021,Waverley 016,E02006454,6418,1247,5171
2021,Waverley 017,E02006455,5834,1133,4701
2021,Woking 001,E02006456,7527,1405,6122
2021,Woking 002,E02006457,8828,1665,7163
2021,Woking 003,E02006458,8769,1791,6978
2021,Woking 004,E02006459,9886,2250,7636
2021,Woking 005,E02006460,8726,1725,7001
2021,Woking 006,E02006461,6470,1211,5259
2021,Woking 007,E02006462,7886,1557,6329
2021,Woking 008,E02006463,9969,1561,8408
2021,Woking 009,E02006464,6412,1186,5226
2021,Woking 010,E02006465,5871,1115,4756
2021,Woking 011,E02006466,10570,2518,8052
2021,Woking 012,E02006467,6815,1347,5468
2021,North Warwickshire 001,E02006468,10472,1795,8677
2021,North Warwickshire 002,E02006469,8289,1542,6747
2021,North Warwickshire 003,E02006470,11119,1897,9222
2021,North Warwickshire 004,E02006471,6684,1026,5658
2021,North Warwickshire 005,E02006472,9293,1582,7711
2021,North Warwickshire 006,E02006473,9874,1541,8333
2021,North Warwickshire 007,E02006474,6098,965,5133
2021,Nuneaton and Bedworth 001,E02006475,9011,1730,7281
2021,Nuneaton and Bedworth 002,E02006476,8862,1903,6959
2021,Nuneaton and Bedworth 003,E02006477,8261,1598,6663
2021,Nuneaton and Bedworth 004,E02006478,7914,1481,6433
2021,Nuneaton and Bedworth 005,E02006479,8615,1522,7093
2021,Nuneaton and Bedworth 006,E02006480,7021,1286,5735
2021,Nuneaton and Bedworth 007,E02006481,6857,1464,5393
2021,Nuneaton and Bedworth 008,E02006482,6784,1223,5561
2021,Nuneaton and Bedworth 009,E02006483,7494,1541,5953
2021,Nuneaton and Bedworth 010,E02006484,7249,1278,5971
2021,Nuneaton and Bedworth 011,E02006485,6336,841,5495
2021,Nuneaton and Bedworth 012,E02006486,6725,1098,5627
2021,Nuneaton and Bedworth 013,E02006487,6557,1174,5383
2021,Nuneaton and Bedworth 014,E02006488,5831,782,5049
2021,Nuneaton and Bedworth 015,E02006489,7543,1554,5989
2021,Nuneaton and Bedworth 016,E02006490,7307,1425,5882
2021,Rugby 002,E02006493,10043,2000,8043
2021,Rugby 003,E02006494,6883,1171,5712
2021,Rugby 004,E02006495,7395,1180,6215
2021,Rugby 005,E02006496,6746,1221,5525
2021,Rugby 006,E02006497,7635,1387,6248
2021,Rugby 007,E02006498,13024,3066,9958
2021,Rugby 008,E02006499,6094,1233,4861
2021,Rugby 009,E02006500,5862,1475,4387
2021,Rugby 010,E02006501,9656,1967,7689
2021,Rugby 011,E02006502,10566,1807,8759
2021,Rugby 012,E02006503,9602,1840,7762
2021,Stratford-on-Avon 001,E02006504,5663,847,4816
2021,Stratford-on-Avon 002,E02006505,6686,990,5696
2021,Stratford-on-Avon 003,E02006506,5758,1013,4745
2021,Stratford-on-Avon 004,E02006507,10460,1755,8705
2021,Stratford-on-Avon 005,E02006508,10569,1840,8729
2021,Stratford-on-Avon 006,E02006509,5634,817,4817
2021,Stratford-on-Avon 007,E02006510,6592,993,5599
2021,Stratford-on-Avon 008,E02006511,10081,1841,8240
2021,Stratford-on-Avon 009,E02006512,11726,1737,9989
2021,Stratford-on-Avon 010,E02006513,7962,1415,6547
2021,Stratford-on-Avon 011,E02006514,8574,1262,7312
2021,Stratford-on-Avon 012,E02006515,10580,1760,8820
2021,Stratford-on-Avon 013,E02006516,9163,1374,7789
2021,Stratford-on-Avon 014,E02006517,9252,1691,7561
2021,Stratford-on-Avon 015,E02006518,9779,1386,8393
2021,Warwick 001,E02006519,7646,1434,6212
2021,Warwick 002,E02006520,8071,1523,6548
2021,Warwick 003,E02006521,7012,1249,5763
2021,Warwick 004,E02006522,5571,923,4648
2021,Warwick 005,E02006523,12384,4071,8313
2021,Warwick 006,E02006524,5197,980,4217
2021,Warwick 007,E02006525,12463,2847,9616
2021,Warwick 008,E02006526,8199,1298,6901
2021,Warwick 009,E02006527,8964,1908,7056
2021,Warwick 010,E02006528,10702,2825,7877
2021,Warwick 011,E02006529,11948,2291,9657
2021,Warwick 012,E02006530,12452,2485,9967
2021,Warwick 013,E02006531,9888,3305,6583
2021,Warwick 014,E02006532,10840,2229,8611
2021,Warwick 015,E02006533,9679,1748,7931
2021,Adur 001,E02006534,8638,1647,6991
2021,Adur 002,E02006535,6975,1336,5639
2021,Adur 003,E02006536,7175,1489,5686
2021,Adur 004,E02006537,9928,2001,7927
2021,Adur 005,E02006538,8838,1438,7400
2021,Adur 006,E02006539,6966,1161,5805
2021,Adur 007,E02006540,5427,797,4630
2021,Adur 008,E02006541,7407,1070,6337
2021,Arun 001,E02006542,5556,798,4758
2021,Arun 002,E02006543,5417,773,4644
2021,Arun 003,E02006544,11070,1855,9215
2021,Arun 004,E02006545,11245,2495,8750
2021,Arun 005,E02006546,10455,1814,8641
2021,Arun 006,E02006547,6563,1081,5482
2021,Arun 007,E02006548,9283,1592,7691
2021,Arun 008,E02006549,6111,605,5506
2021,Arun 009,E02006550,9246,1324,7922
2021,Arun 010,E02006551,7791,583,7208
2021,Arun 011,E02006552,6994,959,6035
2021,Arun 012,E02006553,9113,1599,7514
2021,Arun 013,E02006554,6384,842,5542
2021,Arun 014,E02006555,7309,1414,5895
2021,Arun 015,E02006556,10162,1771,8391
2021,Arun 016,E02006557,7327,1425,5902
2021,Arun 017,E02006558,10257,1562,8695
2021,Arun 018,E02006559,7980,858,7122
2021,Arun 019,E02006560,9380,1184,8196
2021,Chichester 001,E02006561,6435,1303,5132
2021,Chichester 002,E02006562,5911,1027,4884
2021,Chichester 003,E02006563,5575,962,4613
2021,Chichester 004,E02006564,7672,1179,6493
2021,Chichester 005,E02006565,7889,1392,6497
2021,Chichester 006,E02006566,7855,1269,6586
2021,Chichester 007,E02006567,7337,1191,6146
2021,Chichester 008,E02006568,11658,2823,8835
2021,Chichester 009,E02006569,9148,1356,7792
2021,Chichester 010,E02006570,8574,1636,6938
2021,Chichester 011,E02006571,8141,1536,6605
2021,Chichester 012,E02006572,10822,2157,8665
2021,Chichester 013,E02006573,11185,1621,9564
2021,Chichester 014,E02006574,10556,1337,9219
2021,Crawley 001,E02006575,8374,1947,6427
2021,Crawley 002,E02006576,9907,1993,7914
2021,Crawley 003,E02006577,8495,1800,6695
2021,Crawley 004,E02006578,11707,2258,9449
2021,Crawley 005,E02006579,7916,1521,6395
2021,Crawley 006,E02006580,7868,1500,6368
2021,Crawley 007,E02006581,9611,1777,7834
2021,Crawley 008,E02006582,7441,1562,5879
2021,Crawley 009,E02006583,8925,1635,7290
2021,Crawley 010,E02006584,7273,1581,5692
2021,Crawley 011,E02006585,7837,1762,6075
2021,Crawley 012,E02006586,7521,1821,5700
2021,Crawley 013,E02006587,7979,1633,6346
2021,Horsham 001,E02006588,9747,1616,8131
2021,Horsham 002,E02006589,10788,1903,8885
2021,Horsham 003,E02006590,8361,1481,6880
2021,Horsham 004,E02006591,7824,1321,6503
2021,Horsham 005,E02006592,6369,1197,5172
2021,Horsham 006,E02006593,10652,1704,8948
2021,Horsham 007,E02006594,10194,2024,8170
2021,Horsham 008,E02006595,8579,2046,6533
2021,Horsham 009,E02006596,8892,1753,7139
2021,Horsham 010,E02006597,11610,2169,9441
2021,Horsham 011,E02006598,5251,836,4415
2021,Horsham 012,E02006599,6742,843,5899
2021,Horsham 013,E02006600,9428,1321,8107
2021,Horsham 014,E02006601,8523,1490,7033
2021,Horsham 015,E02006602,8292,1525,6767
2021,Horsham 016,E02006603,8158,1274,6884
2021,Mid Sussex 001,E02006604,12609,2152,10457
2021,Mid Sussex 002,E02006605,6055,1164,4891
2021,Mid Sussex 003,E02006606,7930,1460,6470
2021,Mid Sussex 004,E02006607,7589,1325,6264
2021,Mid Sussex 005,E02006608,6003,1029,4974
2021,Mid Sussex 006,E02006609,6586,1294,5292
2021,Mid Sussex 007,E02006610,7467,1397,6070
2021,Mid Sussex 008,E02006611,10769,2216,8553
2021,Mid Sussex 009,E02006612,11090,1835,9255
2021,Mid Sussex 010,E02006613,7287,1420,5867
2021,Mid Sussex 011,E02006614,12042,2477,9565
2021,Mid Sussex 012,E02006615,6665,1300,5365
2021,Mid Sussex 013,E02006616,9174,1550,7624
2021,Mid Sussex 014,E02006617,8622,1418,7204
2021,Mid Sussex 015,E02006618,6177,1093,5084
2021,Mid Sussex 016,E02006619,8637,2043,6594
2021,Mid Sussex 017,E02006620,9549,1845,7704
2021,Worthing 001,E02006621,7471,944,6527
2021,Worthing 002,E02006622,7522,1287,6235
2021,Worthing 003,E02006623,7646,1475,6171
2021,Worthing 004,E02006624,7080,1446,5634
2021,Worthing 005,E02006625,7632,1546,6086
2021,Worthing 006,E02006626,9406,2172,7234
2021,Worthing 007,E02006627,9073,1562,7511
2021,Worthing 008,E02006628,8411,1687,6724
2021,Worthing 009,E02006629,7412,1411,6001
2021,Worthing 010,E02006630,8519,958,7561
2021,Worthing 011,E02006631,9709,1246,8463
2021,Worthing 012,E02006632,7889,1127,6762
2021,Worthing 013,E02006633,8121,1199,6922
2021,Wiltshire 012,E02006634,8229,1396,6833
2021,Wiltshire 019,E02006635,8823,2253,6570
2021,Wiltshire 024,E02006636,6812,1018,5794
2021,Wiltshire 025,E02006637,10467,1847,8620
2021,Wiltshire 026,E02006638,6144,813,5331
2021,Wiltshire 028,E02006639,8144,1092,7052
2021,Wiltshire 029,E02006640,7034,1235,5799
2021,Wiltshire 034,E02006641,7874,1495,6379
2021,Wiltshire 038,E02006642,5434,832,4602
2021,Wiltshire 001,E02006644,6553,1078,5475
2021,Wiltshire 002,E02006645,7510,1493,6017
2021,Wiltshire 003,E02006646,7760,1502,6258
2021,Wiltshire 004,E02006647,5901,974,4927
2021,Wiltshire 005,E02006648,5988,1079,4909
2021,Wiltshire 006,E02006649,7286,1238,6048
2021,Wiltshire 007,E02006650,13354,2264,11090
2021,Wiltshire 008,E02006651,6978,1194,5784
2021,Wiltshire 009,E02006652,9210,1783,7427
2021,Wiltshire 010,E02006653,9335,1685,7650
2021,Wiltshire 011,E02006654,9121,1382,7739
2021,Wiltshire 013,E02006655,7826,1240,6586
2021,Wiltshire 014,E02006656,6365,1075,5290
2021,Wiltshire 015,E02006657,10526,2341,8185
2021,Wiltshire 016,E02006658,7539,1102,6437
2021,Wiltshire 017,E02006659,7836,1454,6382
2021,Wiltshire 018,E02006660,12814,2252,10562
2021,Wiltshire 045,E02006661,9030,1753,7277
2021,Wiltshire 046,E02006662,6775,1255,5520
2021,Wiltshire 048,E02006663,12325,2386,9939
2021,Wiltshire 049,E02006664,6146,1001,5145
2021,Wiltshire 050,E02006665,6515,887,5628
2021,Wiltshire 051,E02006666,6504,1342,5162
2021,Wiltshire 052,E02006667,7021,1546,5475
2021,Wiltshire 053,E02006668,5672,938,4734
2021,Wiltshire 054,E02006669,9957,1463,8494
2021,Wiltshire 055,E02006670,6562,914,5648
2021,Wiltshire 056,E02006671,5920,857,5063
2021,Wiltshire 057,E02006672,8916,1765,7151
2021,Wiltshire 058,E02006673,4852,667,4185
2021,Wiltshire 059,E02006674,5711,1087,4624
2021,Wiltshire 060,E02006675,7790,1289,6501
2021,Wiltshire 061,E02006676,5934,903,5031
2021,Wiltshire 062,E02006677,7633,1258,6375
2021,Wiltshire 020,E02006678,7354,1280,6074
2021,Wiltshire 021,E02006679,11786,2221,9565
2021,Wiltshire 022,E02006680,7244,1090,6154
2021,Wiltshire 023,E02006681,5717,964,4753
2021,Wiltshire 027,E02006682,9923,1633,8290
2021,Wiltshire 030,E02006683,7689,1489,6200
2021,Wiltshire 031,E02006684,6504,1010,5494
2021,Wiltshire 032,E02006685,9529,1865,7664
2021,Wiltshire 033,E02006686,5183,903,4280
2021,Wiltshire 035,E02006687,7656,1438,6218
2021,Wiltshire 036,E02006688,5308,827,4481
2021,Wiltshire 037,E02006689,6672,1183,5489
2021,Wiltshire 039,E02006690,6697,987,5710
2021,Wiltshire 042,E02006692,5245,917,4328
2021,Wiltshire 043,E02006693,6166,959,5207
2021,Wiltshire 044,E02006694,5874,790,5084
2021,Wiltshire 047,E02006695,6205,892,5313
2021,Bromsgrove 001,E02006696,6898,1521,5377
2021,Bromsgrove 002,E02006697,7156,1194,5962
2021,Bromsgrove 003,E02006698,6099,1047,5052
2021,Bromsgrove 004,E02006699,5624,995,4629
2021,Bromsgrove 005,E02006700,6036,929,5107
2021,Bromsgrove 006,E02006701,6904,1268,5636
2021,Bromsgrove 007,E02006702,5614,958,4656
2021,Bromsgrove 008,E02006703,7594,1339,6255
2021,Bromsgrove 009,E02006704,6606,1180,5426
2021,Bromsgrove 010,E02006705,6960,1355,5605
2021,Bromsgrove 011,E02006706,6658,1211,5447
2021,Bromsgrove 012,E02006707,6462,1386,5076
2021,Bromsgrove 013,E02006708,7501,1561,5940
2021,Bromsgrove 014,E02006709,7913,1201,6712
2021,Malvern Hills 001,E02006710,8094,1271,6823
2021,Malvern Hills 002,E02006711,8236,1456,6780
2021,Malvern Hills 003,E02006712,7318,1123,6195
2021,Malvern Hills 004,E02006713,6065,847,5218
2021,Malvern Hills 005,E02006714,5652,842,4810
2021,Malvern Hills 006,E02006715,8338,1517,6821
2021,Malvern Hills 007,E02006716,6060,1238,4822
2021,Malvern Hills 008,E02006717,6585,1042,5543
2021,Malvern Hills 009,E02006718,5796,903,4893
2021,Malvern Hills 010,E02006719,7216,1272,5944
2021,Malvern Hills 011,E02006720,7013,1044,5969
2021,Redditch 001,E02006721,6265,1085,5180
2021,Redditch 002,E02006722,5094,1115,3979
2021,Redditch 003,E02006723,8700,1863,6837
2021,Redditch 004,E02006724,6530,1348,5182
2021,Redditch 005,E02006725,5219,937,4282
2021,Redditch 006,E02006726,6019,1071,4948
2021,Redditch 007,E02006727,5647,943,4704
2021,Redditch 008,E02006728,7332,1182,6150
2021,Redditch 009,E02006729,7212,1326,5886
2021,Redditch 010,E02006730,6292,1467,4825
2021,Redditch 011,E02006731,5291,844,4447
2021,Redditch 012,E02006732,6660,1102,5558
2021,Redditch 013,E02006733,5780,957,4823
2021,Worcester 001,E02006734,7881,1465,6416
2021,Worcester 002,E02006735,5079,1094,3985
2021,Worcester 003,E02006736,6153,1053,5100
2021,Worcester 004,E02006737,7878,1360,6518
2021,Worcester 005,E02006738,8645,1974,6671
2021,Worcester 006,E02006739,5586,1987,3599
2021,Worcester 007,E02006740,7077,1270,5807
2021,Worcester 008,E02006741,5895,1178,4717
2021,Worcester 009,E02006742,8559,2349,6210
2021,Worcester 010,E02006743,6509,1422,5087
2021,Worcester 011,E02006744,7065,1292,5773
2021,Worcester 012,E02006745,8322,1485,6837
2021,Worcester 013,E02006746,8537,1493,7044
2021,Worcester 014,E02006747,5410,908,4502
2021,Wychavon 001,E02006748,8271,1430,6841
2021,Wychavon 002,E02006749,5109,1110,3999
2021,Wychavon 003,E02006750,5169,685,4484
2021,Wychavon 004,E02006751,5621,963,4658
2021,Wychavon 005,E02006752,7828,1348,6480
2021,Wychavon 006,E02006753,7002,1198,5804
2021,Wychavon 007,E02006754,5578,902,4676
2021,Wychavon 008,E02006755,5662,841,4821
2021,Wychavon 009,E02006756,6310,1168,5142
2021,Wychavon 010,E02006757,6978,968,6010
2021,Wychavon 011,E02006758,6196,938,5258
2021,Wychavon 012,E02006759,8010,1238,6772
2021,Wychavon 013,E02006760,8629,1324,7305
2021,Wychavon 014,E02006761,5968,868,5100
2021,Wychavon 015,E02006762,6729,1065,5664
2021,Wychavon 016,E02006763,8005,1453,6552
2021,Wychavon 017,E02006764,5484,949,4535
2021,Wychavon 018,E02006765,6105,741,5364
2021,Wychavon 019,E02006766,7586,1151,6435
2021,Wyre Forest 001,E02006767,9218,1644,7574
2021,Wyre Forest 002,E02006768,6665,1096,5569
2021,Wyre Forest 003,E02006769,6735,1074,5661
2021,Wyre Forest 004,E02006770,7782,1603,6179
2021,Wyre Forest 005,E02006771,6513,981,5532
2021,Wyre Forest 006,E02006772,6376,1050,5326
2021,Wyre Forest 007,E02006773,7824,1275,6549
2021,Wyre Forest 008,E02006774,7141,1234,5907
2021,Wyre Forest 009,E02006775,5723,1241,4482
2021,Wyre Forest 010,E02006776,6086,937,5149
2021,Wyre Forest 011,E02006777,6984,903,6081
2021,Wyre Forest 012,E02006778,6838,1149,5689
2021,Wyre Forest 013,E02006779,7270,1060,6210
2021,Wyre Forest 014,E02006780,5643,790,4853
2021,Isles of Scilly 001,E02006781,1958,259,1699
2021,Bromley 040,E02006782,7643,1560,6083
2021,Lewisham 037,E02006783,7308,1969,5339
2021,Lewisham 038,E02006784,7564,1772,5792
2021,Bexley 029,E02006785,6248,1175,5073
2021,Greenwich 033,E02006786,7068,1692,5376
2021,Bromley 041,E02006787,7375,1588,5787
2021,Croydon 045,E02006788,7096,1683,5413
2021,Bromley 042,E02006789,6482,1081,5401
2021,Tandridge 012,E02006790,7303,1314,5989
2021,Ealing 040,E02006791,7114,1175,5939
2021,Hounslow 029,E02006792,8542,1486,7056
2021,Enfield 037,E02006793,8994,2531,6463
2021,Haringey 037,E02006794,7705,2115,5590
2021,Harrow 032,E02006795,7845,1895,5950
2021,Hillingdon 033,E02006796,9051,1771,7280
2021,Lewisham 039,E02006798,8427,1949,6478
2021,Barking and Dagenham 023,E02006799,11117,3271,7846
2021,Redbridge 034,E02006800,13538,3489,10049
2021,Lambeth 036,E02006801,8336,2559,5777
2021,Southwark 034,E02006802,8920,2573,6347
2021,Sheffield 072,E02006803,8811,1496,7315
2021,North East Derbyshire 014,E02006804,7837,1438,6399
2021,Coventry 043,E02006805,8470,2250,6220
2021,Nuneaton and Bedworth 018,E02006806,8076,1536,6540
2021,Birmingham 132,E02006807,7717,1820,5897
2021,Solihull 030,E02006808,6297,1276,5021
2021,Birmingham 133,E02006809,9612,2159,7453
2021,Sandwell 039,E02006810,10087,1919,8168
2021,Middlesbrough 020,E02006811,10783,2056,8727
2021,Redcar and Cleveland 021,E02006812,7227,1340,5887
2021,Kingston upon Hull 033,E02006813,7787,1449,6338
2021,East Riding of Yorkshire 043,E02006814,7656,1316,6340
2021,Leicester 037,E02006815,10843,2789,8054
2021,Harborough 011,E02006816,8321,1469,6852
2021,Leicester 038,E02006817,8751,2936,5815
2021,Oadby and Wigston 008,E02006818,7995,1515,6480
2021,Leicester 039,E02006819,8192,2355,5837
2021,Blaby 013,E02006820,10288,1780,8508
2021,Portsmouth 026,E02006821,6330,1274,5056
2021,Havant 018,E02006822,8890,1434,7456
2021,Buckinghamshire 039,E02006823,8537,1646,6891
2021,Buckinghamshire 036,E02006824,9122,1838,7284
2021,East Cambridgeshire 011,E02006825,5890,936,4954
2021,West Suffolk 015,E02006826,9254,1372,7882
2021,Amber Valley 017,E02006827,7540,1355,6185
2021,Erewash 016,E02006828,6760,1166,5594
2021,East Hampshire 016,E02006829,7092,1084,6008
2021,Havant 019,E02006830,6249,1213,5036
2021,Havant 020,E02006831,5931,867,5064
2021,Sevenoaks 016,E02006832,5709,1073,4636
2021,Tonbridge and Malling 014,E02006833,11626,2015,9611
2021,Nottingham 038,E02006834,7202,1542,5660
2021,Gedling 016,E02006835,5773,1023,4750
2021,Sutton 025,E02006836,8285,1694,6591
2021,Epsom and Ewell 010,E02006837,11186,2222,8964
2021,East Hampshire 017,E02006838,6678,996,5682
2021,Waverley 018,E02006839,8187,1481,6706
2021,Torbay 019,E02006840,10798,2078,8720
2021,Gateshead 027,E02006841,7406,1866,5540
2021,Gateshead 028,E02006842,4786,1095,3691
2021,Sheffield 073,E02006843,10333,5858,4475
2021,Sheffield 074,E02006844,7604,4829,2775
2021,North Somerset 026,E02006845,9051,1950,7101
2021,North Somerset 027,E02006846,8812,2030,6782
2021,Swindon 026,E02006847,9271,2391,6880
2021,Swindon 027,E02006848,7945,2012,5933
2021,Swindon 028,E02006849,9713,2136,7577
2021,Leicester 040,E02006850,9819,5973,3846
2021,Leicester 041,E02006851,9817,5739,4078
2021,Leeds 109,E02006852,11297,2907,8390
2021,Tower Hamlets 032,E02006853,10304,2187,8117
2021,Tower Hamlets 033,E02006854,6725,1175,5550
2021,Canterbury 019,E02006855,6048,1733,4315
2021,Canterbury 020,E02006856,10709,3609,7100
2021,Eastbourne 013,E02006857,8563,1528,7035
2021,Eastbourne 014,E02006858,6603,971,5632
2021,Thurrock 019,E02006859,7126,1928,5198
2021,Leeds 110,E02006861,13423,8744,4679
2021,North Northamptonshire 009,E02006862,6325,1217,5108
2021,North Northamptonshire 008,E02006863,11175,2868,8307
2021,Boston 008,E02006864,8421,1491,6930
2021,Boston 009,E02006865,7913,1334,6579
2021,North Kesteven 013,E02006866,8210,1537,6673
2021,North Kesteven 014,E02006867,7765,1226,6539
2021,Sheffield 075,E02006868,11287,2985,8302
2021,Sheffield 076,E02006869,10486,1821,8665
2021,Lancaster 020,E02006871,11534,2084,9450
2021,High Peak 013,E02006872,12273,1911,10362
2021,South Cambridgeshire 020,E02006873,9167,2796,6371
2021,South Cambridgeshire 021,E02006874,9640,2116,7524
2021,Leeds 111,E02006875,9464,5231,4233
2021,Leeds 112,E02006876,7475,1440,6035
2021,Peterborough 022,E02006877,10062,2059,8003
2021,Peterborough 023,E02006878,11986,3282,8704
2021,Folkestone and Hythe 014,E02006879,6159,1002,5157
2021,Folkestone and Hythe 015,E02006880,6380,744,5636
2021,Burnley 014,E02006881,10086,1968,8118
2021,Harrow 033,E02006882,13595,2631,10964
2021,"Bournemouth, Christchurch and Poole 040",E02006883,5480,504,4976
2021,Rossendale 010,E02006884,11735,2156,9579
2021,"Bournemouth, Christchurch and Poole 045",E02006885,7206,724,6482
2021,Vale of White Horse 016,E02006886,12974,2429,10545
2021,Bristol 054,E02006887,9640,2988,6652
2021,Bristol 055,E02006888,6740,1727,5013
2021,Bristol 056,E02006889,7469,2354,5115
2021,Bristol 057,E02006890,8502,1710,6792
2021,East Riding of Yorkshire 044,E02006891,7737,1192,6545
2021,East Riding of Yorkshire 045,E02006892,5933,894,5039
2021,Newcastle upon Tyne 031,E02006893,10351,1535,8816
2021,Wolverhampton 035,E02006894,13252,3453,9799
2021,Birmingham 134,E02006895,8761,2889,5872
2021,Birmingham 135,E02006896,5788,1549,4239
2021,Birmingham 136,E02006897,7961,2625,5336
2021,Birmingham 137,E02006898,7551,1515,6036
2021,Birmingham 138,E02006899,5981,1238,4743
2021,Birmingham 139,E02006900,14463,5181,9282
2021,Manchester 054,E02006902,7665,1572,6093
2021,Bassetlaw 016,E02006903,10545,1635,8910
2021,Nottingham 039,E02006904,8965,3981,4984
2021,Nottingham 040,E02006905,7425,2147,5278
2021,Broxtowe 016,E02006906,11639,1951,9688
2021,Norwich 014,E02006907,6881,1018,5863
2021,Norwich 015,E02006908,5264,712,4552
2021,Hartlepool 014,E02006909,12212,1875,10337
2021,Redcar and Cleveland 022,E02006910,9997,1965,8032
2021,Manchester 055,E02006912,10056,3450,6606
2021,Manchester 056,E02006913,7347,1790,5557
2021,Manchester 057,E02006914,7741,5145,2596
2021,Manchester 058,E02006915,8644,2511,6133
2021,Manchester 059,E02006916,6709,1191,5518
2021,Manchester 060,E02006917,6320,1420,4900
2021,Hackney 028,E02006918,7722,2034,5688
2021,South Derbyshire 012,E02006919,9788,1919,7869
2021,South Derbyshire 013,E02006920,7579,1477,6102
2021,Hackney 029,E02006921,6960,2098,4862
2021,Colchester 022,E02006922,13387,2466,10921
2021,Redbridge 035,E02006924,12812,3063,9749
2021,Redbridge 036,E02006925,13739,3465,10274
2021,Thurrock 020,E02006926,7520,1831,5689
2021,Greenwich 034,E02006927,11536,2327,9209
2021,Greenwich 035,E02006928,11410,2932,8478
2021,Greenwich 037,E02006930,9149,1687,7462
2021,Greenwich 038,E02006931,8854,1752,7102
2021,Liverpool 060,E02006932,14016,10111,3905
2021,Liverpool 061,E02006933,7052,1471,5581
2021,Liverpool 062,E02006934,6570,2034,4536
2021,St. Helens 024,E02006935,7041,1352,5689
2021,St. Helens 025,E02006936,7318,1605,5713
2021,Luton 022,E02006937,8651,2029,6622
2021,Luton 023,E02006938,5938,1799,4139
2021,Reading 019,E02006939,6637,1004,5633
2021,Reading 020,E02006940,7777,1925,5852
2021,Southwark 035,E02006941,5176,601,4575
2021,Southwark 036,E02006942,6452,1153,5299
2021,Sandwell 040,E02006943,6923,2215,4708
2021,Sandwell 041,E02006944,7370,2471,4899
2021,Bradford 062,E02006945,8268,1254,7014
2021,Bradford 063,E02006946,4971,791,4180
2021,Bradford 064,E02006947,9080,2696,6384
2021,Bradford 065,E02006948,5972,1677,4295
2021,Bristol 058,E02006949,6337,1248,5089
2021,Bristol 059,E02006950,7180,1933,5247
2021,Bristol 060,E02006951,8373,4875,3498
2021,Bristol 061,E02006952,7878,3910,3968
2021,Barnet 042,E02006953,8518,2030,6488
2021,Barnet 043,E02006954,9397,2238,7159
2021,Brent 035,E02006955,7097,2346,4751
2021,Brent 036,E02006956,8388,2535,5853
2021,Salford 031,E02006957,7264,2738,4526
2021,Salford 032,E02006958,7415,2186,5229
2021,Salford 033,E02006959,7823,1366,6457
2021,Salford 034,E02006960,8974,3128,5846
2021,Salford 035,E02006961,6243,1379,4864
2021,Salford 036,E02006962,4960,942,4018
2021,Salford 037,E02006963,5805,743,5062
2021,Leicester 042,E02006964,6249,1778,4471
2021,Leicester 043,E02006965,7920,1968,5952
2021,Oadby and Wigston 010,E02006966,7173,2564,4609
2021,Oadby and Wigston 011,E02006967,7359,1710,5649
2021,Ealing 041,E02006968,7919,1560,6359
2021,Ealing 042,E02006969,6010,942,5068
2021,Ealing 043,E02006970,6856,1823,5033
2021,Ealing 044,E02006971,7833,2013,5820
2021,Hounslow 030,E02006972,5010,1033,3977
2021,Hounslow 031,E02006973,7969,1660,6309
2021,Stoke-on-Trent 035,E02006974,10368,1897,8471
2021,Portsmouth 027,E02006975,9948,6217,3731
2021,Portsmouth 028,E02006976,4969,1370,3599
2021,Chelmsford 022,E02006978,6828,1287,5541
2021,Chelmsford 023,E02006979,6026,841,5185
2021,Rochford 011,E02006980,7152,1211,5941
2021,Rochford 012,E02006981,7547,1255,6292
2021,South Staffordshire 015,E02006982,11590,1815,9775
2021,Manchester 061,E02006983,6691,1340,5351
2021,Manchester 062,E02006984,5451,781,4670
2021,Manchester 063,E02006985,8490,3036,5454
2021,Manchester 064,E02006986,5812,1778,4034
2021,Croydon 046,E02006987,6899,956,5943
2021,Croydon 047,E02006988,6598,1220,5378
2021,Plymouth 033,E02006989,5143,1192,3951
2021,Plymouth 034,E02006990,6452,906,5546
2021,Greenwich 039,E02006991,5976,678,5298
2021,Greenwich 040,E02006992,7605,1315,6290
2021,Greenwich 041,E02006993,7813,1765,6048
2021,Greenwich 042,E02006994,7037,1585,5452
2021,Newham 038,E02006995,8197,2057,6140
2021,Newham 039,E02006996,7956,2106,5850
2021,Newham 040,E02006997,6542,1155,5387
2021,Newham 041,E02006998,6552,1689,4863
2021,Newham 042,E02006999,10344,1731,8613
2021,Oldham 036,E02007000,7002,2380,4622
2021,Oldham 037,E02007001,7802,2521,5281
2021,Rotherham 034,E02007002,11045,1898,9147
2021,Pendle 014,E02007003,10198,2025,8173
2021,Thurrock 021,E02007004,6086,1531,4555
2021,Thurrock 022,E02007005,7719,1902,5817
2021,Dorset 031,E02007006,5517,659,4858
2021,Dorset 032,E02007007,6500,1195,5305
2021,Lewisham 040,E02007008,5438,1157,4281
2021,Lewisham 041,E02007009,8547,1573,6974
2021,Bedford 021,E02007010,7911,1527,6384
2021,Bedford 022,E02007011,6929,1674,5255
2021,Milton Keynes 033,E02007012,7595,2189,5406
2021,Milton Keynes 034,E02007013,9139,2688,6451
2021,Milton Keynes 035,E02007014,6673,1560,5113
2021,Milton Keynes 036,E02007015,8861,2115,6746
2021,Milton Keynes 037,E02007016,8526,1950,6576
2021,Redbridge 037,E02007017,8232,2364,5868
2021,Redbridge 038,E02007018,6646,1846,4800
2021,Redbridge 039,E02007019,6482,1772,4710
2021,Redbridge 040,E02007020,9045,2533,6512
2021,Oxford 020,E02007021,8030,2577,5453
2021,County Durham 067,E02007022,11737,1731,10006
2021,Wiltshire 063,E02007023,7352,1455,5897
2021,Wiltshire 064,E02007024,6614,1087,5527
2021,Wiltshire 065,E02007025,7941,1763,6178
2021,Wiltshire 066,E02007026,7927,1787,6140
2021,East Devon 021,E02007027,10146,1882,8264
2021,East Devon 022,E02007028,5416,1342,4074
2021,Derbyshire Dales 011,E02007029,10659,1498,9161
2021,Cheshire East 052,E02007030,6980,1681,5299
2021,Cheshire East 053,E02007031,8242,1772,6470
2021,North Norfolk 015,E02007032,6531,929,5602
2021,North Norfolk 016,E02007033,5924,871,5053
2021,Tewkesbury 010,E02007034,7569,1595,5974
2021,Tewkesbury 011,E02007035,7441,1240,6201
2021,Birmingham 141,E02007038,12732,3328,9404
2021,Birmingham 142,E02007039,7564,2402,5162
2021,Birmingham 143,E02007040,6936,2581,4355
2021,Craven 009,E02007041,9838,1442,8396
2021,Hambleton 012,E02007042,6690,1128,5562
2021,Hambleton 013,E02007043,5978,1073,4905
2021,Ryedale 009,E02007044,7301,1310,5991
2021,Ryedale 010,E02007045,6448,982,5466
2021,Ashford 015,E02007046,6618,1250,5368
2021,Ashford 016,E02007047,8234,1838,6396
2021,Rugby 013,E02007048,7160,1054,6106
2021,Rugby 014,E02007049,7330,1560,5770
2021,Telford and Wrekin 024,E02007050,7660,1704,5956
2021,Telford and Wrekin 025,E02007051,7900,1816,6084
2021,Norwich 016,E02007052,6123,900,5223
2021,Norwich 017,E02007053,5936,1914,4022
2021,South Norfolk 016,E02007054,8002,1682,6320
2021,South Norfolk 017,E02007055,7241,1130,6111
2021,Colchester 023,E02007056,7896,1767,6129
2021,Colchester 024,E02007057,7063,1555,5508
2021,Darlington 016,E02007058,10868,1741,9127
2021,Hartlepool 015,E02007059,10085,1826,8259
2021,Stockton-on-Tees 025,E02007060,5588,1144,4444
2021,Stockton-on-Tees 026,E02007061,7696,2074,5622
2021,Stockton-on-Tees 027,E02007062,7114,1992,5122
2021,Stockton-on-Tees 028,E02007063,8658,2328,6330
2021,South Gloucestershire 033,E02007064,7428,1279,6149
2021,South Gloucestershire 034,E02007065,7176,1524,5652
2021,South Gloucestershire 035,E02007066,8718,4612,4106
2021,South Gloucestershire 036,E02007067,6513,1400,5113
2021,Slough 015,E02007068,6442,1576,4866
2021,Slough 016,E02007069,7525,1892,5633
2021,North Northamptonshire 020,E02007070,6104,1267,4837
2021,North Northamptonshire 023,E02007071,9753,1985,7768
2021,West Northamptonshire 035,E02007072,7054,1898,5156
2021,West Northamptonshire 039,E02007073,7172,1484,5688
2021,Southampton 033,E02007074,8240,3496,4744
2021,Southampton 034,E02007075,5087,619,4468
2021,Test Valley 016,E02007076,6945,1435,5510
2021,Test Valley 017,E02007077,6681,1424,5257
2021,Test Valley 018,E02007078,4823,663,4160
2021,Kingston upon Hull 034,E02007079,7712,1841,5871
2021,Kingston upon Hull 035,E02007080,7827,1822,6005
2021,North East Lincolnshire 024,E02007081,9670,1625,8045
2021,Nottingham 041,E02007082,16217,7859,8358
2021,Wandsworth 038,E02007083,7248,1296,5952
2021,Wandsworth 039,E02007084,9402,1856,7546
2021,South Cambridgeshire 022,E02007085,11345,2228,9117
2021,Cambridge 015,E02007086,10151,2590,7561
2021,Cambridge 014,E02007087,6050,2322,3728
2021,North Hertfordshire 016,E02007088,7328,1329,5999
2021,North Hertfordshire 017,E02007089,6929,1519,5410
2021,St Albans 021,E02007090,5916,1410,4506
2021,Stevenage 013,E02007091,6078,1001,5077
2021,Welwyn Hatfield 017,E02007092,5240,1152,4088
2021,East Hertfordshire 019,E02007093,7721,1285,6436
2021,Gateshead 029,E02007094,6566,1064,5502
2021,Newcastle upon Tyne 032,E02007095,9074,1848,7226
2021,Newcastle upon Tyne 033,E02007096,5664,1178,4486
2021,Newcastle upon Tyne 034,E02007097,8501,5025,3476
2021,Newcastle upon Tyne 035,E02007098,6110,1228,4882
2021,Newcastle upon Tyne 036,E02007099,10136,6551,3585
2021,Newcastle upon Tyne 037,E02007100,8325,5631,2694
2021,Newcastle upon Tyne 038,E02007101,8668,2843,5825
2021,Newcastle upon Tyne 039,E02007102,7245,3675,3570
2021,Newcastle upon Tyne 040,E02007103,6066,1380,4686
2021,Newcastle upon Tyne 041,E02007104,5157,1443,3714
2021,Northumberland 041,E02007105,11886,1857,10029
2021,Northumberland 042,E02007106,13865,2517,11348
2021,Northumberland 043,E02007107,8488,1310,7178
2021,Hackney 030,E02007108,5682,646,5036
2021,Hackney 031,E02007109,7223,1187,6036
2021,Hackney 032,E02007110,7000,1646,5354
2021,Hackney 033,E02007111,5807,1224,4583
2021,Tower Hamlets 034,E02007112,5625,897,4728
2021,Tower Hamlets 035,E02007113,6968,1456,5512
2021,Tower Hamlets 036,E02007114,7168,2175,4993
2021,Camden 029,E02007115,11207,4558,6649
2021,Oxford 019,E02007116,7756,2070,5686
2021,Isle of Anglesey 001,W02000001,8010,1323,6687
2021,Isle of Anglesey 002,W02000002,6115,848,5267
2021,Isle of Anglesey 003,W02000003,9999,2165,7834
2021,Isle of Anglesey 004,W02000004,7116,1142,5974
2021,Isle of Anglesey 005,W02000005,7898,1165,6733
2021,Isle of Anglesey 006,W02000006,6615,1396,5219
2021,Isle of Anglesey 007,W02000007,6523,1190,5333
2021,Isle of Anglesey 008,W02000008,5731,986,4745
2021,Isle of Anglesey 009,W02000009,7660,1325,6335
2021,Gwynedd 001,W02000010,8375,5082,3293
2021,Gwynedd 002,W02000011,7882,2124,5758
2021,Gwynedd 003,W02000012,7783,1549,6234
2021,Gwynedd 004,W02000013,6097,1177,4920
2021,Gwynedd 005,W02000014,6422,1211,5211
2021,Gwynedd 006,W02000015,7976,1639,6337
2021,Gwynedd 007,W02000016,6042,1101,4941
2021,Gwynedd 008,W02000017,7185,1365,5820
2021,Gwynedd 009,W02000018,5775,1076,4699
2021,Gwynedd 010,W02000019,6392,1012,5380
2021,Gwynedd 011,W02000020,6188,988,5200
2021,Gwynedd 012,W02000021,7424,1280,6144
2021,Gwynedd 013,W02000022,5354,774,4580
2021,Gwynedd 014,W02000023,5069,829,4240
2021,Gwynedd 015,W02000024,5444,928,4516
2021,Gwynedd 016,W02000025,5884,950,4934
2021,Gwynedd 017,W02000026,6751,877,5874
2021,Conwy 001,W02000027,8152,1106,7046
2021,Conwy 002,W02000028,6429,1206,5223
2021,Conwy 003,W02000029,5763,816,4947
2021,Conwy 004,W02000030,5670,794,4876
2021,Conwy 005,W02000031,7851,1352,6499
2021,Conwy 006,W02000032,8036,1240,6796
2021,Conwy 007,W02000033,6565,1222,5343
2021,Conwy 008,W02000034,7347,1303,6044
2021,Conwy 009,W02000035,8437,1730,6707
2021,Conwy 010,W02000036,10780,1598,9182
2021,Conwy 011,W02000037,6767,1230,5537
2021,Conwy 012,W02000038,5983,991,4992
2021,Conwy 013,W02000039,7482,1274,6208
2021,Conwy 014,W02000040,6321,1028,5293
2021,Conwy 015,W02000041,8130,1336,6794
2021,Denbighshire 001,W02000042,5598,897,4701
2021,Denbighshire 002,W02000043,4997,884,4113
2021,Denbighshire 003,W02000044,5088,808,4280
2021,Denbighshire 004,W02000045,9001,1702,7299
2021,Denbighshire 006,W02000047,5157,1405,3752
2021,Denbighshire 008,W02000049,6343,1167,5176
2021,Denbighshire 009,W02000050,6099,1032,5067
2021,Denbighshire 010,W02000051,5087,761,4326
2021,Denbighshire 011,W02000052,4706,903,3803
2021,Denbighshire 012,W02000053,6050,1092,4958
2021,Denbighshire 013,W02000054,5891,925,4966
2021,Denbighshire 014,W02000055,5399,1046,4353
2021,Denbighshire 015,W02000056,4955,920,4035
2021,Denbighshire 016,W02000057,5981,894,5087
2021,Flintshire 001,W02000058,4904,715,4189
2021,Flintshire 002,W02000059,6251,1125,5126
2021,Flintshire 003,W02000060,10129,1974,8155
2021,Flintshire 004,W02000061,7137,1376,5761
2021,Flintshire 005,W02000062,5841,991,4850
2021,Flintshire 006,W02000063,7849,1184,6665
2021,Flintshire 007,W02000064,5782,1135,4647
2021,Flintshire 008,W02000065,6881,1243,5638
2021,Flintshire 009,W02000066,9270,1757,7513
2021,Flintshire 010,W02000067,6488,1217,5271
2021,Flintshire 011,W02000068,4964,766,4198
2021,Flintshire 012,W02000069,5978,1032,4946
2021,Flintshire 013,W02000070,10193,1910,8283
2021,Flintshire 014,W02000071,6759,1060,5699
2021,Flintshire 015,W02000072,11011,2036,8975
2021,Flintshire 016,W02000073,9682,1815,7867
2021,Flintshire 017,W02000074,9318,1643,7675
2021,Flintshire 018,W02000075,6063,1137,4926
2021,Flintshire 019,W02000076,7011,1128,5883
2021,Flintshire 020,W02000077,5828,1089,4739
2021,Wrexham 003,W02000080,7427,1563,5864
2021,Wrexham 004,W02000081,5560,1147,4413
2021,Wrexham 005,W02000082,7193,1489,5704
2021,Wrexham 006,W02000083,8168,1650,6518
2021,Wrexham 008,W02000085,8556,1506,7050
2021,Wrexham 010,W02000087,6372,1752,4620
2021,Wrexham 011,W02000088,8217,1611,6606
2021,Wrexham 012,W02000089,8054,1624,6430
2021,Wrexham 013,W02000090,5417,1092,4325
2021,Wrexham 014,W02000091,5871,1057,4814
2021,Wrexham 015,W02000092,6378,1312,5066
2021,Wrexham 016,W02000093,6235,1163,5072
2021,Wrexham 017,W02000094,8378,1740,6638
2021,Wrexham 018,W02000095,6151,1040,5111
2021,Wrexham 019,W02000096,6184,1084,5100
2021,Powys 001,W02000097,8925,1399,7526
2021,Powys 002,W02000098,5984,906,5078
2021,Powys 003,W02000099,6325,1039,5286
2021,Powys 004,W02000100,5947,865,5082
2021,Powys 005,W02000101,5287,766,4521
2021,Powys 006,W02000102,5911,929,4982
2021,Powys 007,W02000103,5527,807,4720
2021,Powys 008,W02000104,5926,934,4992
2021,Powys 009,W02000105,4822,1120,3702
2021,Powys 010,W02000106,6232,928,5304
2021,Powys 011,W02000107,9394,1294,8100
2021,Powys 012,W02000108,6907,989,5918
2021,Powys 013,W02000109,5381,827,4554
2021,Powys 014,W02000110,6560,982,5578
2021,Powys 015,W02000111,8139,1200,6939
2021,Powys 017,W02000113,7860,1325,6535
2021,Powys 018,W02000114,6699,993,5706
2021,Ceredigion 001,W02000116,7082,1227,5855
2021,Ceredigion 002,W02000117,8822,5047,3775
2021,Ceredigion 003,W02000118,6156,1802,4354
2021,Ceredigion 005,W02000120,6773,927,5846
2021,Ceredigion 007,W02000122,6084,805,5279
2021,Ceredigion 008,W02000123,7360,1433,5927
2021,Ceredigion 009,W02000124,8297,1351,6946
2021,Ceredigion 010,W02000125,7156,1036,6120
2021,Pembrokeshire 001,W02000126,7898,1296,6602
2021,Pembrokeshire 002,W02000127,9225,1458,7767
2021,Pembrokeshire 003,W02000128,6978,987,5991
2021,Pembrokeshire 004,W02000129,6893,1161,5732
2021,Pembrokeshire 005,W02000130,6293,1275,5018
2021,Pembrokeshire 006,W02000131,6824,1304,5520
2021,Pembrokeshire 007,W02000132,6699,1062,5637
2021,Pembrokeshire 008,W02000133,7961,1272,6689
2021,Pembrokeshire 009,W02000134,7963,1297,6666
2021,Pembrokeshire 010,W02000135,6940,1307,5633
2021,Pembrokeshire 011,W02000136,8026,1113,6913
2021,Pembrokeshire 012,W02000137,7012,1341,5671
2021,Pembrokeshire 013,W02000138,9144,1729,7415
2021,Pembrokeshire 014,W02000139,7434,1106,6328
2021,Pembrokeshire 015,W02000140,6882,1323,5559
2021,Pembrokeshire 016,W02000141,5601,801,4800
2021,Carmarthenshire 001,W02000142,5297,834,4463
2021,Carmarthenshire 002,W02000143,5371,849,4522
2021,Carmarthenshire 003,W02000144,7337,1074,6263
2021,Carmarthenshire 004,W02000145,6833,1082,5751
2021,Carmarthenshire 005,W02000146,6297,956,5341
2021,Carmarthenshire 006,W02000147,8061,1813,6248
2021,Carmarthenshire 007,W02000148,4935,1014,3921
2021,Carmarthenshire 008,W02000149,6137,916,5221
2021,Carmarthenshire 010,W02000151,7008,1257,5751
2021,Carmarthenshire 011,W02000152,8264,1525,6739
2021,Carmarthenshire 012,W02000153,8319,1330,6989
2021,Carmarthenshire 013,W02000154,7431,1422,6009
2021,Carmarthenshire 015,W02000156,8001,1452,6549
2021,Carmarthenshire 016,W02000157,9547,1666,7881
2021,Carmarthenshire 017,W02000158,5554,979,4575
2021,Carmarthenshire 018,W02000159,5918,1119,4799
2021,Carmarthenshire 019,W02000160,7301,1356,5945
2021,Carmarthenshire 020,W02000161,4954,1021,3933
2021,Carmarthenshire 021,W02000162,7932,1304,6628
2021,Carmarthenshire 022,W02000163,5057,1026,4031
2021,Carmarthenshire 023,W02000164,7074,1199,5875
2021,Carmarthenshire 024,W02000165,6212,1249,4963
2021,Carmarthenshire 025,W02000166,8581,1763,6818
2021,Carmarthenshire 026,W02000167,9689,1887,7802
2021,Swansea 001,W02000168,6199,1311,4888
2021,Swansea 002,W02000169,8708,1673,7035
2021,Swansea 003,W02000170,8306,1485,6821
2021,Swansea 004,W02000171,7978,1571,6407
2021,Swansea 005,W02000172,9713,1963,7750
2021,Swansea 006,W02000173,7516,1586,5930
2021,Swansea 007,W02000174,9138,1683,7455
2021,Swansea 008,W02000175,6980,1226,5754
2021,Swansea 009,W02000176,8456,1561,6895
2021,Swansea 010,W02000177,6596,1294,5302
2021,Swansea 011,W02000178,8222,2266,5956
2021,Swansea 012,W02000179,6218,1116,5102
2021,Swansea 013,W02000180,7511,1745,5766
2021,Swansea 014,W02000181,6952,1287,5665
2021,Swansea 015,W02000182,7145,1306,5839
2021,Swansea 016,W02000183,9703,2541,7162
2021,Swansea 017,W02000184,6438,1206,5232
2021,Swansea 018,W02000185,4840,795,4045
2021,Swansea 019,W02000186,8014,2194,5820
2021,Swansea 021,W02000188,7653,1924,5729
2021,Swansea 022,W02000189,7903,1514,6389
2021,Swansea 024,W02000191,8490,3046,5444
2021,Swansea 025,W02000192,8830,2603,6227
2021,Swansea 026,W02000193,8612,4466,4146
2021,Swansea 027,W02000194,6316,2053,4263
2021,Swansea 028,W02000195,5617,1008,4609
2021,Swansea 029,W02000196,6018,1065,4953
2021,Swansea 030,W02000197,5896,980,4916
2021,Swansea 031,W02000198,7013,1204,5809
2021,Neath Port Talbot 002,W02000200,4887,885,4002
2021,Neath Port Talbot 003,W02000201,5049,892,4157
2021,Neath Port Talbot 004,W02000202,11862,2188,9674
2021,Neath Port Talbot 006,W02000204,6360,1027,5333
2021,Neath Port Talbot 007,W02000205,5508,901,4607
2021,Neath Port Talbot 008,W02000206,6292,1033,5259
2021,Neath Port Talbot 009,W02000207,5020,780,4240
2021,Neath Port Talbot 010,W02000208,12034,3914,8120
2021,Neath Port Talbot 012,W02000210,5844,1215,4629
2021,Neath Port Talbot 013,W02000211,7321,1345,5976
2021,Neath Port Talbot 014,W02000212,7349,1298,6051
2021,Neath Port Talbot 015,W02000213,6434,1080,5354
2021,Neath Port Talbot 016,W02000214,9185,1892,7293
2021,Neath Port Talbot 017,W02000215,8924,1693,7231
2021,Neath Port Talbot 018,W02000216,6819,1176,5643
2021,Neath Port Talbot 019,W02000217,6076,1199,4877
2021,Bridgend 001,W02000218,6263,1267,4996
2021,Bridgend 002,W02000219,6868,1228,5640
2021,Bridgend 003,W02000220,7569,1418,6151
2021,Bridgend 004,W02000221,7277,1419,5858
2021,Bridgend 005,W02000222,5917,1079,4838
2021,Bridgend 006,W02000223,5687,987,4700
2021,Bridgend 007,W02000224,6122,1134,4988
2021,Bridgend 008,W02000225,8433,1648,6785
2021,Bridgend 009,W02000226,9565,1761,7804
2021,Bridgend 010,W02000227,6942,1410,5532
2021,Bridgend 011,W02000228,11332,1860,9472
2021,Bridgend 012,W02000229,5830,1057,4773
2021,Bridgend 013,W02000230,5433,877,4556
2021,Bridgend 014,W02000231,7880,1386,6494
2021,Bridgend 015,W02000232,5442,927,4515
2021,Bridgend 016,W02000233,5852,1173,4679
2021,Bridgend 017,W02000234,10111,2145,7966
2021,Bridgend 018,W02000235,8896,1197,7699
2021,Bridgend 019,W02000236,6723,983,5740
2021,Vale of Glamorgan 001,W02000237,5848,1038,4810
2021,Vale of Glamorgan 002,W02000238,6306,1148,5158
2021,Vale of Glamorgan 003,W02000239,7630,1310,6320
2021,Vale of Glamorgan 004,W02000240,8555,1802,6753
2021,Vale of Glamorgan 005,W02000241,9767,1774,7993
2021,Vale of Glamorgan 006,W02000242,7779,1259,6520
2021,Vale of Glamorgan 007,W02000243,8706,1943,6763
2021,Vale of Glamorgan 008,W02000244,9663,1918,7745
2021,Vale of Glamorgan 009,W02000245,7785,1556,6229
2021,Vale of Glamorgan 010,W02000246,5128,735,4393
2021,Vale of Glamorgan 011,W02000247,8336,1581,6755
2021,Vale of Glamorgan 012,W02000248,9906,2038,7868
2021,Vale of Glamorgan 013,W02000249,8302,1587,6715
2021,Vale of Glamorgan 014,W02000250,11017,2174,8843
2021,Vale of Glamorgan 015,W02000251,10359,1832,8527
2021,Rhondda Cynon Taf 001,W02000252,8735,1803,6932
2021,Rhondda Cynon Taf 002,W02000253,6425,1124,5301
2021,Rhondda Cynon Taf 003,W02000254,7509,1349,6160
2021,Rhondda Cynon Taf 004,W02000255,6570,1202,5368
2021,Rhondda Cynon Taf 005,W02000256,9325,1717,7608
2021,Rhondda Cynon Taf 006,W02000257,6868,1235,5633
2021,Rhondda Cynon Taf 007,W02000258,5376,968,4408
2021,Rhondda Cynon Taf 008,W02000259,5435,1174,4261
2021,Rhondda Cynon Taf 009,W02000260,5418,970,4448
2021,Rhondda Cynon Taf 010,W02000261,7274,1283,5991
2021,Rhondda Cynon Taf 011,W02000262,4986,971,4015
2021,Rhondda Cynon Taf 012,W02000263,5999,1164,4835
2021,Rhondda Cynon Taf 013,W02000264,5379,1084,4295
2021,Rhondda Cynon Taf 014,W02000265,8692,1659,7033
2021,Rhondda Cynon Taf 015,W02000266,7072,1366,5706
2021,Rhondda Cynon Taf 016,W02000267,6021,1217,4804
2021,Rhondda Cynon Taf 017,W02000268,8491,1494,6997
2021,Rhondda Cynon Taf 018,W02000269,7779,1490,6289
2021,Rhondda Cynon Taf 019,W02000270,6258,1122,5136
2021,Rhondda Cynon Taf 020,W02000271,5142,949,4193
2021,Rhondda Cynon Taf 021,W02000272,9416,1704,7712
2021,Rhondda Cynon Taf 022,W02000273,9893,3806,6087
2021,Rhondda Cynon Taf 023,W02000274,9661,1931,7730
2021,Rhondda Cynon Taf 024,W02000275,5750,1017,4733
2021,Rhondda Cynon Taf 025,W02000276,6163,1147,5016
2021,Rhondda Cynon Taf 026,W02000277,6634,1120,5514
2021,Rhondda Cynon Taf 027,W02000278,8520,1689,6831
2021,Rhondda Cynon Taf 028,W02000279,7311,1364,5947
2021,Rhondda Cynon Taf 029,W02000280,8966,1868,7098
2021,Rhondda Cynon Taf 030,W02000281,7156,1290,5866
2021,Rhondda Cynon Taf 031,W02000282,10892,2297,8595
2021,Merthyr Tydfil 002,W02000284,8762,1580,7182
2021,Merthyr Tydfil 003,W02000285,7902,1449,6453
2021,Merthyr Tydfil 004,W02000286,6384,1217,5167
2021,Merthyr Tydfil 005,W02000287,7870,1484,6386
2021,Merthyr Tydfil 006,W02000288,7651,1312,6339
2021,Merthyr Tydfil 007,W02000289,8210,1479,6731
2021,Caerphilly 001,W02000290,8104,1387,6717
2021,Caerphilly 002,W02000291,6681,1194,5487
2021,Caerphilly 003,W02000292,5490,1087,4403
2021,Caerphilly 004,W02000293,5644,1043,4601
2021,Caerphilly 005,W02000294,5366,890,4476
2021,Caerphilly 006,W02000295,9016,1759,7257
2021,Caerphilly 007,W02000296,7010,1273,5737
2021,Caerphilly 008,W02000297,7062,1204,5858
2021,Caerphilly 009,W02000298,6832,1327,5505
2021,Caerphilly 010,W02000299,5946,1118,4828
2021,Caerphilly 011,W02000300,7958,1461,6497
2021,Caerphilly 012,W02000301,7518,1474,6044
2021,Caerphilly 013,W02000302,9461,1743,7718
2021,Caerphilly 014,W02000303,6738,1212,5526
2021,Caerphilly 015,W02000304,5217,929,4288
2021,Caerphilly 016,W02000305,5812,1016,4796
2021,Caerphilly 017,W02000306,4846,762,4084
2021,Caerphilly 018,W02000307,6088,1321,4767
2021,Caerphilly 019,W02000308,8312,1598,6714
2021,Caerphilly 020,W02000309,6441,1200,5241
2021,Caerphilly 021,W02000310,5013,1052,3961
2021,Caerphilly 022,W02000311,9232,1823,7409
2021,Caerphilly 023,W02000312,6904,1299,5605
2021,Caerphilly 024,W02000313,10046,1950,8096
2021,Blaenau Gwent 001,W02000314,6270,1066,5204
2021,Blaenau Gwent 002,W02000315,4980,847,4133
2021,Blaenau Gwent 003,W02000316,6307,1070,5237
2021,Blaenau Gwent 004,W02000317,7343,1279,6064
2021,Blaenau Gwent 005,W02000318,8588,1575,7013
2021,Blaenau Gwent 006,W02000319,7647,1337,6310
2021,Blaenau Gwent 007,W02000320,7736,1371,6365
2021,Blaenau Gwent 008,W02000321,8153,1386,6767
2021,Blaenau Gwent 009,W02000322,6336,1036,5300
2021,Torfaen 001,W02000323,5673,1102,4571
2021,Torfaen 002,W02000324,6659,1332,5327
2021,Torfaen 003,W02000325,6856,1483,5373
2021,Torfaen 004,W02000326,8411,1446,6965
2021,Torfaen 005,W02000327,5637,834,4803
2021,Torfaen 006,W02000328,7119,1244,5875
2021,Torfaen 007,W02000329,7635,1374,6261
2021,Torfaen 008,W02000330,6738,1134,5604
2021,Torfaen 009,W02000331,6052,1380,4672
2021,Torfaen 010,W02000332,7158,1255,5903
2021,Torfaen 011,W02000333,5920,1108,4812
2021,Torfaen 012,W02000334,6271,1097,5174
2021,Torfaen 013,W02000335,7145,1181,5964
2021,Monmouthshire 001,W02000336,8162,1070,7092
2021,Monmouthshire 002,W02000337,7234,1385,5849
2021,Monmouthshire 003,W02000338,8140,1262,6878
2021,Monmouthshire 004,W02000339,10574,1938,8636
2021,Monmouthshire 005,W02000340,6921,1025,5896
2021,Monmouthshire 006,W02000341,8055,1037,7018
2021,Monmouthshire 007,W02000342,9016,1479,7537
2021,Monmouthshire 008,W02000343,7780,1263,6517
2021,Monmouthshire 009,W02000344,8140,1325,6815
2021,Monmouthshire 010,W02000345,7623,1339,6284
2021,Monmouthshire 011,W02000346,7348,1293,6055
2021,Newport 001,W02000347,7617,1257,6360
2021,Newport 002,W02000348,7217,1211,6006
2021,Newport 003,W02000349,7755,1609,6146
2021,Newport 004,W02000350,9331,1671,7660
2021,Newport 005,W02000351,5832,1182,4650
2021,Newport 006,W02000352,6372,1322,5050
2021,Newport 007,W02000353,6825,1343,5482
2021,Newport 008,W02000354,5520,930,4590
2021,Newport 009,W02000355,9620,1959,7661
2021,Newport 010,W02000356,4910,1178,3732
2021,Newport 011,W02000357,7726,1518,6208
2021,Newport 012,W02000358,6151,1055,5096
2021,Newport 013,W02000359,10843,2531,8312
2021,Newport 014,W02000360,6458,1048,5410
2021,Newport 015,W02000361,10999,2430,8569
2021,Newport 016,W02000362,6587,1268,5319
2021,Newport 017,W02000363,5466,942,4524
2021,Newport 018,W02000364,8631,2351,6280
2021,Newport 019,W02000365,7972,1943,6029
2021,Newport 020,W02000366,8024,1650,6374
2021,Cardiff 001,W02000367,5851,1034,4817
2021,Cardiff 002,W02000368,5389,935,4454
2021,Cardiff 003,W02000369,9025,1813,7212
2021,Cardiff 004,W02000370,6274,1080,5194
2021,Cardiff 005,W02000371,8597,1682,6915
2021,Cardiff 006,W02000372,7875,1746,6129
2021,Cardiff 007,W02000373,6587,1630,4957
2021,Cardiff 008,W02000374,5609,1230,4379
2021,Cardiff 009,W02000375,6830,1860,4970
2021,Cardiff 010,W02000376,6295,1232,5063
2021,Cardiff 011,W02000377,7267,1598,5669
2021,Cardiff 012,W02000378,7104,1459,5645
2021,Cardiff 013,W02000379,5986,1756,4230
2021,Cardiff 014,W02000380,7515,1388,6127
2021,Cardiff 015,W02000381,6147,1396,4751
2021,Cardiff 016,W02000382,5596,1418,4178
2021,Cardiff 017,W02000383,7086,1822,5264
2021,Cardiff 018,W02000384,5387,1036,4351
2021,Cardiff 019,W02000385,6582,1985,4597
2021,Cardiff 020,W02000386,7223,1293,5930
2021,Cardiff 021,W02000387,5563,1215,4348
2021,Cardiff 022,W02000388,5495,994,4501
2021,Cardiff 023,W02000389,7954,1760,6194
2021,Cardiff 024,W02000390,5991,1541,4450
2021,Cardiff 025,W02000391,9098,4838,4260
2021,Cardiff 026,W02000392,8440,1790,6650
2021,Cardiff 027,W02000393,6165,1319,4846
2021,Cardiff 028,W02000394,9378,6188,3190
2021,Cardiff 029,W02000395,6285,1346,4939
2021,Cardiff 030,W02000396,7257,2493,4764
2021,Cardiff 031,W02000397,6150,1237,4913
2021,Cardiff 032,W02000398,12091,9367,2724
2021,Cardiff 033,W02000399,10452,3879,6573
2021,Cardiff 034,W02000400,6031,945,5086
2021,Cardiff 035,W02000401,5641,1064,4577
2021,Cardiff 036,W02000402,11011,4166,6845
2021,Cardiff 037,W02000403,7269,1864,5405
2021,Cardiff 038,W02000404,5973,1188,4785
2021,Cardiff 039,W02000405,7063,2159,4904
2021,Cardiff 040,W02000406,9518,1980,7538
2021,Cardiff 041,W02000407,6178,1651,4527
2021,Cardiff 042,W02000408,7018,1911,5107
2021,Cardiff 043,W02000409,5676,1292,4384
2021,Cardiff 044,W02000410,8138,2513,5625
2021,Cardiff 045,W02000411,6205,1465,4740
2021,Cardiff 046,W02000412,6413,1488,4925
2021,Powys 020,W02000414,5763,843,4920
2021,Merthyr Tydfil 008,W02000415,8760,2047,6713
2021,Powys 021,W02000416,9850,1554,8296
2021,Neath Port Talbot 020,W02000417,9643,1704,7939
2021,Carmarthenshire 027,W02000418,11729,1878,9851
2021,Denbighshire 017,W02000419,10694,1956,8738
2021,Ceredigion 011,W02000421,11038,1854,9184
2021,Cardiff 048,W02000422,7021,932,6089
2021,Cardiff 049,W02000423,9538,2754,6784
2021,Wrexham 021,W02000424,6440,973,5467
2021,Wrexham 022,W02000425,8071,1218,6853
2021,Wrexham 023,W02000426,9445,1684,7761
2021,Neath Port Talbot 021,W02000427,10638,1965,8673
2021,Swansea 032,W02000428,10082,2172,7910
