"date","geography","geography code","Living arrangements: Total; measures: Value","Living arrangements: Living in a couple; measures: Value","Living arrangements: Living in a couple: Married or in a civil partnership; measures: Value","Living arrangements: Living in a couple: Married or in a civil partnership: Opposite-sex couple; measures: Value","Living arrangements: Living in a couple: Married or in a civil partnership: Same-sex couple; measures: Value","Living arrangements: Living in a couple: Separated, but still married or in a civil partnership; measures: Value","Living arrangements: Living in a couple: Cohabiting; measures: Value","Living arrangements: Living in a couple: Cohabiting: Opposite-sex couple; measures: Value","Living arrangements: Living in a couple: Cohabiting: Same-sex couple; measures: Value","Living arrangements: Not living in a couple; measures: Value","Living arrangements: Not living in a couple: Single (never married and never registered a same-sex civil partnership); measures: Value","Living arrangements: Not living in a couple: Married or in a registered civil partnership; measures: Value","Living arrangements: Not living in a couple: Separated (including those who are married and those who are in civil partnerships); measures: Value","Living arrangements: Not living in a couple: Divorced or formerly in a civil partnership which is now legally dissolved; measures: Value","Living arrangements: Not living in a couple: Widowed or surviving partner from a civil partnership; measures: Value"
"2021","Hartlepool","E06000001",73833,41802,30578,30406,172,48,11176,10736,440,32031,19902,547,1615,5186,4781
"2021","Middlesbrough","E06000002",111446,57828,42485,42245,240,89,15254,14490,764,53618,35523,1641,2519,7363,6572
"2021","Redcar and Cleveland","E06000003",111122,64428,48226,47990,236,79,16123,15483,640,46694,27505,690,2230,8348,7921
"2021","Stockton-on-Tees","E06000004",155216,92292,69508,69095,413,133,22651,21627,1024,62924,38194,1567,3320,10538,9305
"2021","Darlington","E06000005",87143,51008,37755,37503,252,73,13180,12614,566,36135,21311,707,1983,6779,5355
"2021","County Durham","E06000047",420776,244139,183323,182227,1096,263,60553,58260,2293,176637,106281,2941,8950,30651,27814
"2021","Northumberland","E06000057",264462,164248,129507,128715,792,153,34588,33308,1280,100214,55812,1684,5627,18515,18576
"2021","Newcastle upon Tyne","E08000021",231265,115693,83423,82688,735,179,32091,30139,1952,115572,82392,2901,4824,14155,11300
"2021","North Tyneside","E08000022",170264,99993,74449,73791,658,116,25428,24192,1236,70271,41697,1128,3654,12768,11024
"2021","South Tyneside","E08000023",120118,65835,49021,48708,313,100,16714,16020,694,54283,32846,846,2882,9521,8188
"2021","Sunderland","E08000024",222305,126283,93532,93047,485,138,32613,31264,1349,96022,59866,1599,4768,14931,14858
"2021","Gateshead","E08000037",159212,90526,66277,65731,546,97,24152,22864,1288,68686,42693,1224,3362,11152,10255
"2021","Halton","E06000006",103082,58622,42688,42417,271,84,15850,15226,624,44460,28206,675,2139,7215,6225
"2021","Warrington","E06000007",169609,103692,78670,78232,438,122,24900,23946,954,65917,40159,1375,2830,11513,10040
"2021","Blackburn with Darwen","E06000008",118116,65215,51016,50767,249,81,14118,13610,508,52901,34071,2312,2500,7697,6321
"2021","Blackpool","E06000009",113423,58170,39571,38791,780,95,18504,17262,1242,55253,33024,1047,2783,10753,7646
"2021","Cheshire East","E06000049",325121,206925,159325,158356,969,242,47358,45192,2166,118196,68085,2795,5322,21893,20101
"2021","Cheshire West and Chester","E06000050",290357,177901,134905,133958,947,252,42744,40942,1802,112456,67974,2225,4711,19558,17988
"2021","Allerdale","E07000026",79568,49019,38020,37820,200,36,10963,10614,349,30549,17550,532,1284,5512,5671
"2021","Barrow-in-Furness","E07000027",55307,32006,23513,23391,122,21,8472,8198,274,23301,13820,415,1002,4261,3803
"2021","Carlisle","E07000028",90171,53874,40381,40119,262,46,13447,12935,512,36297,21581,664,1781,6432,5839
"2021","Copeland","E07000029",55322,33406,26033,25889,144,26,7347,7125,222,21916,12905,382,913,3791,3925
"2021","Eden","E07000030",46327,30121,23908,23799,109,21,6192,5944,248,16206,9306,394,643,2700,3163
"2021","South Lakeland","E07000031",87566,56423,44637,44341,296,66,11720,11330,390,31143,17143,724,1216,5761,6299
"2021","Burnley","E07000117",74306,41262,30054,29912,142,45,11163,10740,423,33044,20295,1126,1716,5489,4418
"2021","Chorley","E07000118",93674,59381,44969,44703,266,60,14352,13792,560,34293,20438,597,1613,6419,5226
"2021","Fylde","E07000119",67676,41832,32879,32587,292,57,8896,8512,384,25844,13736,535,1175,5363,5035
"2021","Hyndburn","E07000120",64881,36507,26520,26372,148,40,9947,9604,343,28374,17329,846,1593,4724,3882
"2021","Lancaster","E07000121",111678,64182,47852,47440,412,76,16254,15526,728,47496,29651,1032,2126,7804,6883
"2021","Pendle","E07000122",74684,43511,33441,33271,170,53,10017,9661,356,31173,18368,1812,1591,5042,4360
"2021","Preston","E07000123",112703,61641,46064,45844,220,72,15505,14777,728,51062,34089,1762,2105,7249,5857
"2021","Ribble Valley","E07000124",50666,33209,26429,26327,102,25,6755,6558,197,17457,9812,350,793,3163,3339
"2021","Rossendale","E07000125",56540,34048,24692,24474,218,46,9310,8990,320,22492,13537,459,1198,4041,3257
"2021","South Ribble","E07000126",90731,56734,43145,42881,264,57,13532,12950,582,33997,19798,540,1471,6271,5917
"2021","West Lancashire","E07000127",93735,55924,43190,42992,198,87,12647,12240,407,37811,23516,725,1453,6066,6051
"2021","Wyre","E07000128",92806,57140,44428,44032,396,60,12652,12146,506,35666,19077,661,1537,6937,7454
"2021","Bolton","E08000001",230093,130867,100643,100139,504,181,30043,28800,1243,99226,61705,3782,4614,15644,13481
"2021","Bury","E08000002",153160,89267,67526,67051,475,135,21606,20502,1104,63893,39623,1919,2970,10443,8938
"2021","Manchester","E08000003",416255,183203,123590,121680,1910,410,59203,53987,5216,233052,174459,10449,9204,23608,15332
"2021","Oldham","E08000004",185621,101675,78540,78207,333,178,22957,22028,929,83946,53390,3915,4185,11680,10776
"2021","Rochdale","E08000005",173069,95620,71502,71148,354,172,23946,23026,920,77449,48831,2857,4054,11852,9855
"2021","Salford","E08000006",211259,107772,70013,69135,878,156,37603,34737,2866,103487,73401,2813,4198,13075,10000
"2021","Stockport","E08000007",236778,141992,107693,106859,834,219,34080,32296,1784,94786,58791,2052,3902,15321,14720
"2021","Tameside","E08000008",183795,102702,72704,72069,635,166,29832,28592,1240,81093,50690,1996,4013,13049,11345
"2021","Trafford","E08000009",184768,110623,87174,86494,680,178,23271,22125,1146,74145,47033,1902,3041,11625,10544
"2021","Wigan","E08000010",266231,159320,114657,114004,653,163,44500,42622,1878,106911,65340,1889,4971,18155,16556
"2021","Knowsley","E08000011",123477,63564,44782,44488,294,136,18646,17926,720,59913,40960,916,2718,7787,7532
"2021","Liverpool","E08000012",380867,174002,120724,119670,1054,358,52920,49964,2956,206865,150017,4432,7790,24181,20445
"2021","St. Helens","E08000013",149362,86696,63566,63105,461,125,23005,22031,974,62666,38312,1025,2984,10348,9997
"2021","Sefton","E08000014",228905,126767,96870,96286,584,172,29725,28597,1128,102138,62591,1842,4110,17097,16498
"2021","Wirral","E08000015",259333,142918,108560,107776,784,216,34142,32657,1485,116415,70906,1906,5403,20442,17758
"2021","Kingston upon Hull, City of","E06000010",209318,112865,72474,71898,576,173,40218,38324,1894,96453,63253,2210,4659,15449,10882
"2021","East Riding of Yorkshire","E06000011",282011,183986,143728,142965,763,197,40061,38566,1495,98025,52918,2032,4619,18716,19740
"2021","North East Lincolnshire","E06000012",126019,73836,52898,52598,300,96,20842,20164,678,52183,30469,1020,2649,9944,8101
"2021","North Lincolnshire","E06000013",137806,86014,63851,63489,362,91,22072,21304,768,51792,29532,1322,2460,9521,8957
"2021","York","E06000014",160919,93414,69092,68418,674,108,24214,22930,1284,67505,44808,1229,2285,10127,9056
"2021","Craven","E07000163",47654,31114,24549,24367,182,31,6534,6326,208,16540,8851,364,821,3259,3245
"2021","Hambleton","E07000164",75883,50325,40683,40485,198,27,9615,9328,287,25558,13693,541,1211,4740,5373
"2021","Harrogate","E07000165",131311,84700,67689,67271,418,81,16930,16238,692,46611,25957,1001,2152,9357,8144
"2021","Richmondshire","E07000166",39022,25895,21153,21017,136,38,4704,4490,214,13127,7045,297,748,2562,2475
"2021","Ryedale","E07000167",45703,30202,23653,23515,138,39,6510,6300,210,15501,8333,350,732,2894,3192
"2021","Scarborough","E07000168",90723,54315,41108,40782,326,60,13147,12596,551,36408,19750,829,1784,7392,6653
"2021","Selby","E07000169",74881,50292,38343,38123,220,65,11884,11502,382,24589,14105,453,1251,4557,4223
"2021","Barnsley","E08000016",198097,120327,84837,84278,559,125,35365,33913,1452,77770,46133,1418,3882,14239,12098
"2021","Doncaster","E08000017",246026,145931,105485,104845,640,198,40248,38628,1620,100095,58969,2225,5032,18206,15663
"2021","Rotherham","E08000018",213729,129323,94576,94026,550,143,34604,33434,1170,84406,51041,1884,3916,13939,13626
"2021","Sheffield","E08000019",435667,241017,174980,173715,1265,321,65716,62515,3201,194650,131298,5399,7823,26067,24063
"2021","Bradford","E08000032",416168,229622,180485,179577,908,382,48755,46633,2122,186546,117309,9693,9830,27118,22596
"2021","Calderdale","E08000033",165378,96307,70922,70170,752,126,25259,24208,1051,69071,41577,1854,3557,12392,9691
"2021","Kirklees","E08000034",340811,200004,152731,151833,898,244,47029,45043,1986,140807,87429,4748,6685,22613,19332
"2021","Leeds","E08000035",637169,348896,249538,247565,1973,606,98752,93550,5202,288273,196500,7745,12081,39198,32749
"2021","Wakefield","E08000036",284037,173386,124192,123298,894,208,48986,47045,1941,110651,65635,2219,5526,20159,17112
"2021","Derby","E06000015",204812,113877,84847,84391,456,195,28835,27523,1312,90935,58576,3450,3914,13591,11404
"2021","Leicester","E06000016",277868,142421,114410,113910,500,278,27733,26238,1495,135447,92481,9413,4868,15106,13579
"2021","Rutland","E06000017",31274,21119,17343,17234,109,10,3766,3604,162,10155,5301,215,555,2000,2084
"2021","Nottingham","E06000018",241859,109984,75485,74766,719,222,34277,32435,1842,131875,97139,4256,4638,15067,10775
"2021","North Northamptonshire","E06000061",286266,177076,129080,128275,805,312,47684,45972,1712,109190,65410,2950,5910,19462,15458
"2021","West Northamptonshire","E06000062",337180,207712,155237,154245,992,331,52144,50022,2122,129468,80149,4565,6342,21518,16894
"2021","Amber Valley","E07000032",104068,66043,48983,48635,348,85,16975,16333,642,38025,21928,647,1840,7097,6513
"2021","Bolsover","E07000033",65636,41270,29156,28945,211,44,12070,11566,504,24366,13975,476,1213,4534,4168
"2021","Chesterfield","E07000034",85084,50518,36417,36173,244,59,14042,13414,628,34566,20022,593,1600,6813,5538
"2021","Derbyshire Dales","E07000035",59992,39613,31651,31432,219,34,7928,7626,302,20379,10949,445,970,3843,4172
"2021","Erewash","E07000036",92775,57401,41091,40818,273,78,16232,15582,650,35374,20977,563,1641,6469,5724
"2021","High Peak","E07000037",75019,46458,34659,34383,276,48,11751,11296,455,28561,16644,477,1388,5479,4573
"2021","North East Derbyshire","E07000038",84566,53994,41231,41001,230,65,12698,12276,422,30572,16923,514,1469,5809,5857
"2021","South Derbyshire","E07000039",85833,56353,41713,41430,283,78,14562,14022,540,29480,17446,619,1561,5237,4617
"2021","Blaby","E07000129",83255,53779,40738,40457,281,83,12958,12478,480,29476,17544,690,1334,4874,5034
"2021","Charnwood","E07000130",144440,86736,66684,66256,428,136,19916,19106,810,57704,37319,1292,2378,8689,8026
"2021","Harborough","E07000131",79131,52610,41661,41395,266,53,10896,10484,412,26521,15489,652,1229,4611,4540
"2021","Hinckley and Bosworth","E07000132",93178,60510,45600,45326,274,64,14846,14366,480,32668,18813,623,1615,6104,5513
"2021","Melton","E07000133",42582,27805,21516,21412,104,35,6254,6026,228,14777,8308,305,721,2765,2678
"2021","North West Leicestershire","E07000134",85723,55022,40532,40258,274,51,14439,13877,562,30701,18424,561,1466,5430,4820
"2021","Oadby and Wigston","E07000135",45376,27464,22551,22471,80,39,4874,4678,196,17912,10646,595,769,2709,3193
"2021","Boston","E07000136",56810,34557,24477,24345,132,49,10031,9639,392,22253,12676,804,1022,4090,3661
"2021","East Lindsey","E07000137",119080,76972,59371,58975,396,93,17508,16764,744,42108,21581,991,2078,8093,9365
"2021","Lincoln","E07000138",79833,41106,26736,26512,224,66,14304,13564,740,38727,26683,796,1474,6030,3744
"2021","North Kesteven","E07000139",96003,64476,50510,50184,326,68,13898,13400,498,31527,16935,589,1672,6205,6126
"2021","South Holland","E07000140",78226,50570,37541,37355,186,85,12944,12536,408,27656,14983,852,1288,5105,5428
"2021","South Kesteven","E07000141",116913,75548,58075,57765,310,93,17380,16780,600,41365,22901,760,2129,8268,7307
"2021","West Lindsey","E07000142",78007,50714,39239,38995,244,59,11416,11034,382,27293,14650,538,1488,5375,5242
"2021","Ashfield","E07000170",101732,62394,44347,44040,307,75,17972,17228,744,39338,23467,690,1918,6957,6306
"2021","Bassetlaw","E07000171",95153,60193,44921,44647,274,73,15199,14627,572,34960,19674,759,1764,6589,6174
"2021","Broxtowe","E07000172",90529,55850,42006,41776,230,76,13768,13224,544,34679,21316,723,1462,5573,5605
"2021","Gedling","E07000173",95854,59194,43706,43312,394,84,15404,14768,636,36660,22027,694,1642,6338,5959
"2021","Mansfield","E07000174",89387,54506,39001,38793,208,69,15436,14818,618,34881,20385,766,1693,6455,5582
"2021","Newark and Sherwood","E07000175",99656,63353,47373,47065,308,81,15899,15256,643,36303,20466,789,1794,6850,6404
"2021","Rushcliffe","E07000176",95177,62234,49244,48912,332,76,12914,12370,544,32943,19903,627,1393,5415,5605
"2021","Herefordshire, County of","E06000019",154838,97482,76042,75580,462,156,21284,20500,784,57356,32108,1449,2577,10938,10284
"2021","Telford and Wrekin","E06000020",146851,88516,64345,63913,432,125,24046,23044,1002,58335,35608,1553,2873,10353,7948
"2021","Stoke-on-Trent","E06000021",202378,114024,80679,80215,464,151,33194,31591,1603,88354,54925,2690,4517,14097,12125
"2021","Shropshire","E06000051",265483,169116,130691,129825,866,211,38214,36731,1483,96367,54639,2324,4282,17439,17683
"2021","Cannock Chase","E07000192",81991,51381,36678,36482,196,64,14639,14047,592,30610,18180,511,1470,5444,5005
"2021","East Staffordshire","E07000193",98600,61026,45835,45577,258,105,15086,14482,604,37574,22607,1104,1790,6232,5841
"2021","Lichfield","E07000194",87209,56916,44378,44154,224,56,12482,11974,508,30293,17378,603,1350,5294,5668
"2021","Newcastle-under-Lyme","E07000195",99977,60586,45010,44774,236,70,15506,14832,674,39391,23860,746,1723,6496,6566
"2021","South Staffordshire","E07000196",89564,58473,46678,46464,214,67,11728,11328,400,31091,17544,625,1311,5117,6494
"2021","Stafford","E07000197",111424,72160,55164,54828,336,88,16908,16194,714,39264,22403,737,1879,7310,6935
"2021","Staffordshire Moorlands","E07000198",79987,51999,40530,40345,185,69,11400,11022,378,27988,15674,589,1197,4733,5795
"2021","Tamworth","E07000199",63464,39310,28639,28509,130,55,10616,10236,380,24154,14634,433,1162,4323,3602
"2021","North Warwickshire","E07000218",53251,33487,24895,24729,166,33,8559,8232,327,19764,11820,357,949,3342,3296
"2021","Nuneaton and Bedworth","E07000219",107865,64861,48356,48082,274,94,16411,15801,610,43004,25969,1120,2147,7124,6644
"2021","Rugby","E07000220",90768,57062,43241,43011,230,77,13744,13192,552,33706,20362,1059,1558,5810,4917
"2021","Stratford-on-Avon","E07000221",111505,72950,57648,57346,302,98,15204,14612,592,38555,21209,964,1817,7407,7158
"2021","Warwick","E07000222",119417,71588,55092,54736,356,118,16378,15756,622,47829,31110,1125,1723,7484,6387
"2021","Bromsgrove","E07000234",79316,51523,41045,40841,204,63,10415,9958,457,27793,16094,533,1281,4823,5062
"2021","Malvern Hills","E07000235",65663,42588,33872,33648,224,50,8666,8318,348,23075,12683,542,1042,4302,4506
"2021","Redditch","E07000236",69928,42784,31468,31272,196,66,11250,10816,434,27144,16544,666,1335,4863,3736
"2021","Worcester","E07000237",83827,49009,34961,34720,241,64,13984,13338,646,34818,22255,751,1427,5930,4455
"2021","Wychavon","E07000238",109251,71980,56156,55820,336,108,15716,15118,598,37271,20885,781,1636,6991,6978
"2021","Wyre Forest","E07000239",83696,51325,38250,38047,203,69,13006,12520,486,32371,18121,613,1589,6276,5772
"2021","Birmingham","E08000025",863226,414572,326809,324752,2057,972,86791,81934,4857,448654,310273,21840,20317,52408,43816
"2021","Coventry","E08000026",264156,137586,104261,103743,518,254,33071,31403,1668,126570,85125,5183,5333,16941,13988
"2021","Dudley","E08000027",260607,153697,116330,115679,651,204,37163,35532,1631,106910,65628,2605,5044,16446,17187
"2021","Sandwell","E08000028",264046,139908,108079,107691,388,312,31517,30011,1506,124138,80258,5955,5985,16145,15795
"2021","Solihull","E08000029",173232,103910,84004,83666,338,188,19718,18940,778,69322,42853,1714,2784,10508,11463
"2021","Walsall","E08000030",221389,125012,95105,94695,410,234,29673,28436,1237,96377,60608,3494,4388,13462,14425
"2021","Wolverhampton","E08000031",205091,109329,83203,82787,416,190,25936,24786,1150,95762,61397,4065,4256,13373,12671
"2021","Peterborough","E06000031",165384,94525,69195,68861,334,226,25104,24120,984,70859,44008,3141,3533,12099,8078
"2021","Luton","E06000032",170400,89651,72412,72208,204,210,17029,16304,725,80749,53225,5541,3667,10149,8167
"2021","Southend-on-Sea","E06000033",144373,81393,58947,58479,468,140,22306,21234,1072,62980,38640,1376,3121,11580,8263
"2021","Thurrock","E06000034",135690,78816,58331,58146,185,227,20258,19588,670,56874,37124,2296,2730,8321,6403
"2021","Bedford","E06000055",145851,86470,65844,65446,398,176,20450,19575,875,59381,36914,2131,2848,9715,7773
"2021","Central Bedfordshire","E06000056",234297,151652,114503,113797,706,271,36878,35686,1192,82645,50181,1852,4143,14486,11983
"2021","Cambridge","E07000008",105695,53704,38048,37584,464,50,15606,14702,904,51991,38895,2177,1432,5852,3635
"2021","East Cambridgeshire","E07000009",70747,46673,36126,35870,256,54,10493,10136,357,24074,13771,616,1214,4465,4008
"2021","Fenland","E07000010",83445,51969,37307,37095,212,112,14550,13988,562,31476,17601,707,1570,5860,5738
"2021","Huntingdonshire","E07000011",145819,94230,72132,71685,447,138,21960,21226,734,51589,30015,1291,2553,9557,8173
"2021","South Cambridgeshire","E07000012",129065,85614,68578,68113,465,132,16904,16284,620,43451,26034,1178,2095,7406,6738
"2021","Basildon","E07000066",147877,87449,64948,64677,271,190,22311,21579,732,60428,37411,1515,3027,10157,8318
"2021","Braintree","E07000067",125345,79854,59962,59616,346,104,19788,19078,710,45491,26845,900,1999,8616,7131
"2021","Brentwood","E07000068",62260,38378,29849,29719,130,77,8452,8146,306,23882,14652,619,1068,3875,3668
"2021","Castle Point","E07000069",73981,45982,35772,35645,127,76,10134,9826,308,27999,16278,504,1132,4490,5595
"2021","Chelmsford","E07000070",145411,91097,70344,70022,322,159,20594,19768,826,54314,33410,1282,2246,9377,7999
"2021","Colchester","E07000071",151262,91057,67974,67484,490,166,22917,21922,995,60205,37492,1373,2873,10625,7842
"2021","Epping Forest","E07000072",108964,65439,50762,50458,304,148,14529,13947,582,43525,27357,1325,1739,6784,6320
"2021","Harlow","E07000073",72746,40858,29242,29066,176,110,11506,11082,424,31888,20049,1042,1398,5547,3852
"2021","Maldon","E07000074",54939,35866,28102,27970,132,54,7710,7478,232,19073,10829,378,842,3507,3517
"2021","Rochford","E07000075",70418,45284,35759,35599,160,91,9434,9192,242,25134,14604,439,989,4300,4802
"2021","Tendring","E07000076",123238,73218,55982,55640,342,132,17104,16436,668,50020,26468,1127,2458,9754,10213
"2021","Uttlesford","E07000077",72714,48308,38257,38063,194,85,9966,9643,323,24406,14306,609,1174,4391,3926
"2021","Broxbourne","E07000095",79204,45095,34807,34683,124,133,10155,9854,301,34109,21778,903,1460,5311,4657
"2021","Dacorum","E07000096",121651,74513,57320,57000,320,146,17047,16400,647,47138,28787,1235,2307,8319,6490
"2021","Hertsmere","E07000098",85237,50017,41351,41174,177,118,8548,8204,344,35220,22361,1205,1314,5633,4707
"2021","North Hertfordshire","E07000099",106716,67086,51321,50999,322,94,15671,15049,622,39630,24097,827,1833,6781,6092
"2021","Three Rivers","E07000102",74361,45870,37810,37656,154,94,7966,7634,332,28491,17950,910,1072,4418,4141
"2021","Watford","E07000103",80251,45892,35948,35782,166,94,9850,9408,442,34359,22868,1872,1479,4743,3397
"2021","Breckland","E07000143",115449,75323,56453,56083,370,135,18735,18013,722,40126,22127,965,1991,7734,7309
"2021","Broadland","E07000144",109195,72340,56014,55664,350,84,16242,15670,572,36855,20153,689,1668,7129,7216
"2021","Great Yarmouth","E07000145",81767,47416,33972,33758,214,56,13388,12890,498,34351,19824,765,1518,6762,5482
"2021","King's Lynn and West Norfolk","E07000146",127156,81220,61136,60731,405,103,19981,19290,691,45936,25059,1115,2103,8587,9072
"2021","North Norfolk","E07000147",87198,55662,43400,42964,436,49,12213,11726,487,31536,15631,767,1496,6424,7218
"2021","Norwich","E07000148",114361,55660,34735,34215,520,89,20836,19640,1196,58701,40695,1144,2408,9339,5115
"2021","South Norfolk","E07000149",115765,77247,59344,58852,492,103,17800,17192,608,38518,21269,791,1825,7555,7078
"2021","Babergh","E07000200",76420,50093,39128,38866,262,78,10887,10478,409,26327,14552,538,1272,5022,4943
"2021","Ipswich","E07000202",110214,62963,44282,43944,338,110,18571,17762,809,47251,29902,1206,2246,8282,5615
"2021","Mid Suffolk","E07000203",85117,57156,44399,44113,286,77,12680,12234,446,27961,15692,597,1362,5133,5177
"2021","St Albans","E07000240",114937,74154,60342,60051,291,130,13682,13170,512,40783,25691,1087,1749,6388,5868
"2021","Welwyn Hatfield","E07000241",92434,52708,40605,40383,222,115,11988,11560,428,39726,26205,1463,1612,5717,4729
"2021","East Hertfordshire","E07000242",119652,76490,58916,58604,312,120,17454,16802,652,43162,26882,962,1826,7239,6253
"2021","Stevenage","E07000243",70581,40932,30157,29979,178,93,10682,10311,371,29649,18823,776,1452,4969,3629
"2021","East Suffolk","E07000244",203277,127644,98837,98145,692,157,28650,27574,1076,75633,40934,1628,3611,14819,14641
"2021","West Suffolk","E07000245",143770,89828,68316,67850,466,142,21370,20542,828,53942,30896,1540,2782,10458,8266
"2021","City of London","E09000001",7821,3632,2157,1983,174,5,1470,1256,214,4189,3155,223,139,435,237
"2021","Barking and Dagenham","E09000002",160872,78586,61983,61733,250,309,16294,15572,722,82286,55421,5733,3867,10636,6629
"2021","Barnet","E09000003",306038,164065,135464,134688,776,504,28097,26403,1694,141973,94801,8622,5791,18900,13859
"2021","Bexley","E09000004",194624,110350,86124,85744,380,304,23922,22958,964,84274,54417,3052,3803,11994,11008
"2021","Brent","E09000005",271156,125727,102673,102031,642,391,22663,21111,1552,145429,98569,14288,5773,15354,11445
"2021","Bromley","E09000006",263449,156572,122404,121294,1110,366,33802,32014,1788,106877,69364,3162,4478,15856,14017
"2021","Camden","E09000007",170534,74109,50719,49303,1416,208,23182,21034,2148,96425,72187,4005,3394,11082,5757
"2021","Croydon","E09000008",307115,156201,119911,118812,1099,507,35783,33706,2077,150914,103113,7216,6973,20135,13477
"2021","Ealing","E09000009",291194,146852,118051,117083,968,471,28330,26296,2034,144342,97381,12072,5406,17177,12306
"2021","Enfield","E09000010",255308,125097,102017,101542,475,563,22517,21332,1185,130211,86668,6825,6443,18053,12222
"2021","Greenwich","E09000011",225343,112319,79442,78228,1214,347,32530,30034,2496,113024,77771,6188,5670,14951,8444
"2021","Hackney","E09000012",207142,83922,51132,49743,1389,330,32460,29430,3030,123220,95506,4513,5171,12346,5684
"2021","Hammersmith and Fulham","E09000013",152070,64832,43571,42621,950,175,21086,19560,1526,87238,66742,3411,2927,9606,4552
"2021","Haringey","E09000014",213843,95216,65405,64292,1113,399,29412,26925,2487,118627,85106,6161,5092,14907,7361
"2021","Harrow","E09000015",207750,116963,103576,103328,248,310,13077,12424,653,90787,58717,8061,3211,9917,10881
"2021","Havering","E09000016",208234,119518,93976,93658,318,266,25276,24302,974,88716,57548,3370,3279,12164,12355
"2021","Hillingdon","E09000017",236400,131137,108852,108441,411,351,21934,20852,1082,105263,68684,7293,4105,13641,11540
"2021","Hounslow","E09000018",226957,118913,96948,96190,758,346,21619,20112,1507,108044,70020,9817,4667,13744,9796
"2021","Islington","E09000019",178373,75209,43586,41882,1704,198,31425,28673,2752,103164,80906,2963,3519,10665,5111
"2021","Kensington and Chelsea","E09000020",120808,51673,39064,38266,798,148,12461,11408,1053,69135,48993,4137,2394,9148,4463
"2021","Kingston upon Thames","E09000021",132112,77312,60705,60173,532,176,16431,15577,854,54800,37299,2368,2030,7537,5566
"2021","Lambeth","E09000022",264584,105176,61192,58661,2531,319,43665,39090,4575,159408,125052,6157,5842,15502,6855
"2021","Lewisham","E09000023",239751,110925,72101,70632,1469,423,38401,35207,3194,128826,94704,5245,5499,15629,7749
"2021","Merton","E09000024",171704,94350,72014,71243,771,278,22058,20785,1273,77354,53537,4427,2861,9757,6772
"2021","Newham","E09000025",273556,125896,96465,95658,807,464,28967,26409,2558,147660,104488,13673,5830,14632,9037
"2021","Redbridge","E09000026",240276,130842,112647,112189,458,363,17832,16898,934,109434,72770,9198,4220,12189,11057
"2021","Richmond upon Thames","E09000027",154006,94120,74392,73525,867,181,19547,18496,1051,59886,38745,2242,2512,9721,6666
"2021","Southwark","E09000028",251037,102499,60839,58713,2126,440,41220,36928,4292,148538,113149,6390,6147,15735,7117
"2021","Sutton","E09000029",164445,96868,76901,76447,454,271,19696,18752,944,67577,44240,2460,2834,9861,8182
"2021","Tower Hamlets","E09000030",246800,108297,71188,69479,1709,201,36908,33184,3724,138503,109704,7331,4439,10462,6567
"2021","Waltham Forest","E09000031",220455,111475,79309,78093,1216,340,31826,29506,2320,108980,75869,7331,4526,13321,7933
"2021","Wandsworth","E09000032",269066,129294,83810,82063,1747,238,45246,42320,2926,139772,108531,5203,4169,14150,7719
"2021","Westminster","E09000033",173396,70232,49599,48354,1245,269,20364,18454,1910,103164,75760,6404,3599,11524,5877
"2021","Medway","E06000035",219042,128729,94338,93692,646,255,34136,32788,1348,90313,56058,2456,4684,15231,11884
"2021","Bracknell Forest","E06000036",97974,61646,46725,46436,289,89,14832,14232,600,36328,22535,1068,1638,6606,4481
"2021","West Berkshire","E06000037",128721,83405,65783,65437,346,125,17497,16907,590,45316,27039,1091,2024,8193,6969
"2021","Reading","E06000038",136489,73780,53634,53224,410,165,19981,18973,1008,62709,43764,3300,2290,7712,5643
"2021","Slough","E06000039",118363,64491,54234,54086,148,174,10083,9665,418,53872,34397,4985,2469,7173,4848
"2021","Windsor and Maidenhead","E06000040",120775,75173,60774,60316,458,136,14263,13566,697,45602,27410,1942,1938,7759,6553
"2021","Wokingham","E06000041",138219,92448,75478,75135,343,188,16782,16112,670,45771,28150,1480,1809,7418,6914
"2021","Milton Keynes","E06000042",222785,131440,99156,98539,617,274,32010,30677,1333,91345,58227,3555,4734,15045,9784
"2021","Brighton and Hove","E06000043",227178,114411,73891,70444,3447,204,40316,35810,4506,112767,82077,2359,3887,15510,8934
"2021","Portsmouth","E06000044",164187,85663,59230,58568,662,181,26252,24898,1354,78524,52564,1908,3319,12682,8051
"2021","Southampton","E06000045",194227,101665,70557,69945,612,237,30871,29146,1725,92562,63392,2939,3715,13775,8741
"2021","Isle of Wight","E06000046",116695,70010,53485,53047,438,91,16434,15840,594,46685,24822,1077,2283,9846,8657
"2021","Buckinghamshire","E06000060",436887,278324,224095,223021,1074,502,53727,51652,2075,158563,96368,5660,6866,26037,23632
"2021","Eastbourne","E07000061",82692,46128,33778,33236,542,82,12268,11568,700,36564,20802,890,1790,7422,5660
"2021","Hastings","E07000062",73373,39841,27486,26978,508,105,12250,11634,616,33532,20154,748,1745,6852,4033
"2021","Lewes","E07000063",81742,50069,38644,37896,748,90,11335,10647,688,31673,17456,711,1516,6188,5802
"2021","Rother","E07000064",77861,48040,37969,37531,438,69,10002,9584,418,29821,15348,781,1324,5984,6384
"2021","Wealden","E07000065",131524,86137,68839,68233,606,162,17136,16466,670,45387,24751,940,2071,8918,8707
"2021","Basingstoke and Deane","E07000084",148642,95340,72668,72205,463,134,22538,21706,832,53302,32670,1599,2391,9270,7372
"2021","East Hampshire","E07000085",102316,67775,54564,54217,347,117,13094,12652,442,34541,19493,779,1665,6548,6056
"2021","Eastleigh","E07000086",109352,70924,54000,53625,375,82,16842,16210,632,38428,22400,776,1899,7367,5986
"2021","Fareham","E07000087",93914,62274,49890,49518,372,102,12282,11800,482,31640,17414,643,1315,6106,6162
"2021","Gosport","E07000088",66105,39363,29588,29334,254,57,9718,9316,402,26742,14813,509,1447,5721,4252
"2021","Hart","E07000089",78640,52882,42962,42714,248,66,9854,9518,336,25758,14966,652,1124,4669,4347
"2021","Havant","E07000090",101772,62231,47237,46949,288,88,14906,14394,512,39541,22254,782,1879,7568,7058
"2021","New Forest","E07000091",146486,94778,75957,75533,424,134,18687,18011,676,51708,27173,1241,2281,10251,10762
"2021","Rushmoor","E07000092",79421,47984,36869,36631,238,97,11018,10504,514,31437,19369,1572,1514,5268,3714
"2021","Test Valley","E07000093",105299,69749,54882,54567,315,100,14767,14212,555,35550,20108,890,1708,6824,6020
"2021","Winchester","E07000094",99674,63942,51501,51211,290,73,12368,11826,542,35732,21778,950,1485,5860,5659
"2021","Ashford","E07000105",105870,66507,50842,50491,351,119,15546,14890,656,39363,23850,1359,1702,6630,5822
"2021","Canterbury","E07000106",123929,70204,53181,52627,554,102,16921,16129,792,53725,34507,1275,2104,8303,7536
"2021","Dartford","E07000107",89983,54849,40545,40336,209,126,14178,13674,504,35134,22639,1206,1720,5435,4134
"2021","Dover","E07000108",94498,57298,42721,42219,502,93,14484,13874,610,37200,21028,844,1883,7138,6307
"2021","Gravesham","E07000109",84068,49250,37778,37583,195,130,11342,10926,416,34818,21692,1268,1695,5212,4951
"2021","Maidstone","E07000110",139837,88208,66698,66290,408,134,21376,20516,860,51629,31174,1674,2412,8711,7658
"2021","Sevenoaks","E07000111",95646,61477,49128,48856,272,129,12220,11780,440,34169,19877,904,1534,5970,5884
"2021","Folkestone and Hythe","E07000112",89675,53648,40285,39921,364,90,13273,12703,570,36027,20271,891,1692,7044,6129
"2021","Swale","E07000113",119003,73124,52764,52364,400,119,20241,19466,775,45879,27656,1121,2366,7814,6922
"2021","Thanet","E07000114",113855,64892,46906,46417,489,116,17870,17090,780,48963,28001,975,2616,9738,7633
"2021","Tonbridge and Malling","E07000115",104600,67320,52131,51851,280,129,15060,14584,476,37280,21985,805,1778,6686,6026
"2021","Tunbridge Wells","E07000116",90888,57422,45066,44798,268,92,12264,11810,454,33466,19797,856,1553,6238,5022
"2021","Cherwell","E07000177",128669,81811,61245,60739,506,146,20420,19606,814,46858,28598,1570,2102,8149,6439
"2021","Oxford","E07000178",116273,56086,41201,40747,454,123,14762,13782,980,60187,44323,3008,1671,6623,4562
"2021","South Oxfordshire","E07000179",119285,78516,61550,61183,367,124,16842,16176,666,40769,24302,1054,1749,7102,6562
"2021","Vale of White Horse","E07000180",110118,72333,56705,56329,376,92,15536,14992,544,37785,22762,1052,1692,6326,5953
"2021","West Oxfordshire","E07000181",91529,59629,46589,46274,315,72,12968,12492,476,31900,18474,741,1476,5948,5261
"2021","Elmbridge","E07000207",107385,69376,56867,56551,316,131,12378,11860,518,38009,22714,1173,1681,6790,5651
"2021","Epsom and Ewell","E07000208",63832,40012,32823,32669,154,81,7108,6782,326,23820,15151,811,868,3535,3455
"2021","Guildford","E07000209",111062,67594,53718,53366,352,118,13758,13180,578,43468,28876,1221,1599,6265,5507
"2021","Mole Valley","E07000210",71192,45520,37074,36879,195,92,8354,8040,314,25672,14771,613,1153,4587,4548
"2021","Reigate and Banstead","E07000211",117105,74364,58703,58341,362,161,15500,14862,638,42741,26337,1335,1802,7039,6228
"2021","Runnymede","E07000212",68907,40382,31002,30802,200,64,9316,8904,412,28525,18483,909,1084,4417,3632
"2021","Spelthorne","E07000213",82591,49598,38784,38508,276,100,10714,10246,468,32993,20275,1195,1440,5408,4675
"2021","Surrey Heath","E07000214",72359,46688,37897,37689,208,79,8712,8358,354,25671,15339,928,1085,4349,3970
"2021","Tandridge","E07000215",69464,43908,34734,34526,208,92,9082,8778,304,25556,15261,661,1179,4426,4029
"2021","Waverley","E07000216",100488,65466,53582,53326,256,86,11798,11344,454,35022,20339,899,1580,6176,6028
"2021","Woking","E07000217",82278,51466,40937,40675,262,95,10434,10026,408,30812,19074,1348,1346,4955,4089
"2021","Adur","E07000223",52392,31698,23482,23132,350,64,8152,7774,378,20694,11651,426,954,4037,3626
"2021","Arun","E07000224",136115,83652,64072,63499,573,140,19440,18546,894,52463,28037,1254,2427,10610,10135
"2021","Chichester","E07000225",101009,62886,49912,49504,408,76,12898,12356,542,38123,20925,943,1732,7313,7210
"2021","Crawley","E07000226",93018,53606,39878,39641,237,127,13601,12958,643,39412,25244,1630,1766,6380,4392
"2021","Horsham","E07000227",118890,78323,61956,61491,465,115,16252,15620,632,40567,23289,873,1815,7596,6994
"2021","Mid Sussex","E07000228",121697,79341,62373,61857,516,139,16829,16106,723,42356,24694,1020,1953,7837,6852
"2021","Worthing","E07000229",90692,53432,39433,38875,558,81,13918,13166,752,37260,21447,758,1819,7571,5665
"2021","Bath and North East Somerset","E06000022",153990,89724,68209,67633,576,142,21373,20432,941,64266,43429,1290,2153,9214,8180
"2021","Bristol, City of","E06000023",375295,193311,125544,124097,1447,389,67378,63802,3576,181984,135350,4565,5860,21341,14868
"2021","North Somerset","E06000024",176162,111110,85953,85367,586,173,24984,23938,1046,65052,36453,1457,3085,12906,11151
"2021","South Gloucestershire","E06000025",231986,146549,110642,110004,638,193,35714,34224,1490,85437,53959,1889,3479,13738,12372
"2021","Plymouth","E06000026",211482,120152,85476,84782,694,198,34478,32626,1852,91330,56498,1739,4442,16847,11804
"2021","Torbay","E06000027",115015,66510,49793,49173,620,107,16610,15772,838,48505,26671,1131,2245,10379,8079
"2021","Swindon","E06000030",185978,114091,86894,86386,508,218,26979,25814,1165,71887,43765,3095,3421,12429,9177
"2021","Cornwall","E06000052",469633,289875,218747,216981,1766,416,70712,67762,2950,179758,100822,3833,7803,36295,31005
"2021","Isles of Scilly","E06000053",1705,1151,889,889,0,2,260,260,0,554,282,29,28,93,122
"2021","Wiltshire","E06000054",408094,264490,208741,207441,1300,417,55332,53246,2086,143604,81256,3296,7062,28015,23975
"2021","Bournemouth, Christchurch and Poole","E06000058",324636,187278,139787,138085,1702,312,47179,44633,2546,137358,83085,3132,5602,25903,19636
"2021","Dorset","E06000059",315170,202763,161711,160643,1068,282,40770,39182,1588,112407,58478,2621,5185,22937,23186
"2021","East Devon","E07000040",124961,81372,64186,63786,400,98,17088,16386,702,43589,22654,1077,2030,8751,9077
"2021","Exeter","E07000041",101590,53968,38488,38144,344,76,15404,14558,846,47622,33085,884,1622,7088,4943
"2021","Mid Devon","E07000042",67605,43758,33774,33512,262,65,9919,9583,336,23847,13365,531,1254,4437,4260
"2021","North Devon","E07000043",80738,50920,39187,38947,240,61,11672,11250,422,29818,16364,632,1462,5803,5557
"2021","South Hams","E07000044",74066,48172,38351,38033,318,39,9782,9440,342,25894,13736,620,1198,5497,4843
"2021","Teignbridge","E07000045",111395,70691,54237,53825,412,107,16347,15685,662,40704,21707,851,1954,8707,7485
"2021","Torridge","E07000046",56820,36574,28362,28150,212,56,8156,7832,324,20246,10685,422,1029,4116,3994
"2021","West Devon","E07000047",47039,30796,24656,24510,146,54,6086,5842,244,16243,8593,422,767,3265,3196
"2021","Cheltenham","E07000078",95592,56006,40848,40556,292,60,15098,14450,648,39586,25050,835,1506,6826,5369
"2021","Cotswold","E07000079",75313,49448,39678,39368,310,50,9720,9332,388,25865,14171,631,1184,4991,4888
"2021","Forest of Dean","E07000080",71152,45841,35491,35251,240,54,10296,9958,338,25311,14250,482,1112,4746,4721
"2021","Gloucester","E07000081",105147,61372,44924,44644,280,91,16357,15571,786,43775,28084,1030,1888,7455,5318
"2021","Stroud","E07000082",99113,63819,49308,48947,361,119,14392,13858,534,35294,20257,671,1623,6811,5932
"2021","Tewkesbury","E07000083",76743,50495,38909,38691,218,64,11522,11056,466,26248,14730,495,1155,5181,4687
"2021","Mendip","E07000187",94381,59455,45109,44749,360,57,14289,13786,503,34926,19773,772,1744,6941,5696
"2021","Sedgemoor","E07000188",102480,64505,48730,48439,291,97,15678,15064,614,37975,21395,1110,1971,7007,6492
"2021","South Somerset","E07000189",141439,90642,69788,69395,393,108,20746,19959,787,50797,28043,1141,2421,10034,9158
"2021","Somerset West and Taunton","E07000246",128531,80201,61411,60979,432,105,18685,17888,797,48330,26502,1236,2290,9714,8588
"2021","Isle of Anglesey","W06000001",56462,33405,25706,25588,118,38,7661,7335,326,23057,13133,569,895,4260,4200
"2021","Gwynedd","W06000002",94302,53168,38863,38611,252,51,14254,13592,662,41134,25701,1009,1439,6466,6519
"2021","Conwy","W06000003",94594,55318,42360,42044,316,44,12914,12282,632,39276,21788,945,1699,7570,7274
"2021","Denbighshire","W06000004",77369,44810,33960,33744,216,48,10802,10296,506,32559,18743,633,1503,6208,5472
"2021","Flintshire","W06000005",126613,77114,58380,58052,328,129,18605,17836,769,49499,28902,1053,2129,9238,8177
"2021","Wrexham","W06000006",107369,63261,46679,46415,264,63,16519,15771,748,44108,26622,972,1837,7929,6748
"2021","Ceredigion","W06000008",57763,33810,25578,25356,222,40,8192,7804,388,23953,14655,574,814,3920,3990
"2021","Pembrokeshire","W06000009",100999,60440,46943,46653,290,81,13416,12846,570,40559,22607,928,1801,7692,7531
"2021","Carmarthenshire","W06000010",153225,92139,71219,70730,489,126,20794,19795,999,61086,34816,1379,2544,11510,10837
"2021","Swansea","W06000011",192715,103329,78606,78036,570,137,24586,23334,1252,89386,56295,1932,3716,14784,12659
"2021","Neath Port Talbot","W06000012",114046,64254,48992,48614,378,84,15178,14432,746,49792,29386,779,2169,9466,7992
"2021","Bridgend","W06000013",116893,69539,52545,52213,332,95,16899,16068,831,47354,27774,862,2029,8910,7779
"2021","Vale of Glamorgan","W06000014",105837,64027,49610,49114,496,92,14325,13546,779,41810,24453,824,1838,7845,6850
"2021","Cardiff","W06000015",280989,144242,104305,103228,1077,259,39678,36858,2820,136747,97372,3427,4687,17744,13517
"2021","Rhondda Cynon Taff","W06000016",191815,109429,79829,79201,628,134,29466,28132,1334,82386,51546,1421,3333,13570,12516
"2021","Caerphilly","W06000018",142592,83350,61777,61401,376,121,21452,20450,1002,59242,36050,951,2416,10440,9385
"2021","Blaenau Gwent","W06000019",54804,30433,21863,21735,128,30,8540,8164,376,24371,14696,418,1101,4264,3892
"2021","Torfaen","W06000020",74562,43911,32386,32166,220,70,11455,10837,618,30651,18207,465,1286,5696,4997
"2021","Monmouthshire","W06000021",76893,48843,39106,38850,256,52,9685,9345,340,28050,15319,637,1243,5476,5375
"2021","Newport","W06000022",126060,72079,53324,52906,418,146,18609,17620,989,53981,34037,1786,2310,8672,7176
"2021","Powys","W06000023",111168,69153,53333,52985,348,64,15756,15164,592,42015,23195,1043,1906,7755,8116
"2021","Merthyr Tydfil","W06000024",47235,26100,19252,19156,96,42,6806,6516,290,21135,13308,391,902,3380,3154
