"date","geography","geography code","Living arrangements: Total; measures: Value","Living arrangements: Living in a couple; measures: Value","Living arrangements: Living in a couple: Married or in a civil partnership; measures: Value","Living arrangements: Living in a couple: Married or in a civil partnership: Opposite-sex couple; measures: Value","Living arrangements: Living in a couple: Married or in a civil partnership: Same-sex couple; measures: Value","Living arrangements: Living in a couple: Separated, but still married or in a civil partnership; measures: Value","Living arrangements: Living in a couple: Cohabiting; measures: Value","Living arrangements: Living in a couple: Cohabiting: Opposite-sex couple; measures: Value","Living arrangements: Living in a couple: Cohabiting: Same-sex couple; measures: Value","Living arrangements: Not living in a couple; measures: Value","Living arrangements: Not living in a couple: Single (never married and never registered a same-sex civil partnership); measures: Value","Living arrangements: Not living in a couple: Married or in a registered civil partnership; measures: Value","Living arrangements: Not living in a couple: Separated (including those who are married and those who are in civil partnerships); measures: Value","Living arrangements: Not living in a couple: Divorced or formerly in a civil partnership which is now legally dissolved; measures: Value","Living arrangements: Not living in a couple: Widowed or surviving partner from a civil partnership; measures: Value"
"2021","Hartlepool 001","E02002483",8177,5190,3809,3799,10,7,1374,1324,50,2987,1841,45,148,464,489
"2021","Hartlepool 002","E02002484",7945,3993,2689,2665,24,5,1299,1250,49,3952,2498,50,232,661,511
"2021","Hartlepool 003","E02002485",6185,3145,2164,2142,22,0,981,930,51,3040,1907,46,147,511,429
"2021","Hartlepool 007","E02002489",5571,2492,1791,1769,22,5,696,670,26,3079,2055,56,168,492,308
"2021","Hartlepool 008","E02002490",4592,2406,1628,1610,18,4,774,750,24,2186,1407,45,117,370,247
"2021","Hartlepool 009","E02002491",5074,2680,1925,1915,10,5,750,728,22,2394,1509,40,114,339,392
"2021","Hartlepool 010","E02002492",5384,3119,2212,2200,12,4,903,879,24,2265,1389,27,106,382,361
"2021","Hartlepool 011","E02002493",5577,3684,2888,2880,8,2,794,758,36,1893,1023,29,82,319,440
"2021","Hartlepool 012","E02002494",5788,2802,1836,1820,16,2,964,922,42,2986,1993,43,149,458,343
"2021","Hartlepool 014","E02006909",10752,7416,6012,5992,20,12,1392,1352,40,3336,1862,65,161,508,740
"2021","Hartlepool 015","E02007059",8791,4877,3624,3614,10,1,1252,1176,76,3914,2417,101,191,682,523
"2021","Middlesbrough 001","E02002496",8569,2952,2270,2252,18,4,678,616,62,5617,4160,389,215,550,303
"2021","Middlesbrough 002","E02002497",4605,1924,1158,1146,12,6,760,704,56,2681,1893,69,149,324,246
"2021","Middlesbrough 003","E02002498",6615,2318,1568,1562,6,6,744,686,58,4297,2950,316,264,511,256
"2021","Middlesbrough 004","E02002499",5547,2536,1622,1610,12,4,910,862,48,3011,2185,37,108,378,303
"2021","Middlesbrough 005","E02002500",4564,2260,1729,1715,14,5,526,486,40,2304,1569,66,105,327,237
"2021","Middlesbrough 006","E02002501",4616,2310,1643,1619,24,1,666,638,28,2306,1572,39,116,336,243
"2021","Middlesbrough 007","E02002502",7480,3252,2165,2153,12,5,1082,1034,48,4228,2856,61,231,579,501
"2021","Middlesbrough 008","E02002503",5079,2598,1758,1750,8,4,836,800,36,2481,1700,49,124,337,271
"2021","Middlesbrough 009","E02002504",7601,4262,3296,3278,18,4,962,904,58,3339,2191,137,139,486,386
"2021","Middlesbrough 010","E02002505",4678,2028,1257,1255,2,3,768,742,26,2650,1868,50,147,328,257
"2021","Middlesbrough 011","E02002506",4099,1729,1139,1137,2,10,580,552,28,2370,1667,46,88,306,263
"2021","Middlesbrough 012","E02002507",5042,3091,2480,2472,8,2,609,588,21,1951,1197,55,89,253,357
"2021","Middlesbrough 013","E02002508",4461,2688,2164,2148,16,12,512,494,18,1773,1004,66,70,224,409
"2021","Middlesbrough 014","E02002509",4077,2216,1580,1574,6,2,634,610,24,1861,1177,35,91,282,276
"2021","Middlesbrough 015","E02002510",5859,3929,2967,2948,19,4,958,904,54,1930,1058,38,82,297,455
"2021","Middlesbrough 017","E02002512",4461,3054,2479,2473,6,3,572,564,8,1407,805,25,64,217,296
"2021","Middlesbrough 018","E02002513",8061,4592,3100,3078,22,2,1490,1432,58,3469,2154,42,173,633,467
"2021","Middlesbrough 019","E02002514",6805,3832,2964,2954,10,6,862,826,36,2973,1752,44,155,574,448
"2021","Middlesbrough 020","E02006811",9234,6257,5145,5122,23,6,1106,1050,56,2977,1767,78,111,421,600
"2021","Redcar and Cleveland 001","E02002515",5118,2298,1556,1540,16,6,736,702,34,2820,1705,44,175,568,328
"2021","Redcar and Cleveland 002","E02002516",4654,2634,1852,1844,8,2,780,756,24,2020,1208,32,89,363,328
"2021","Redcar and Cleveland 003","E02002517",4284,2324,1655,1640,15,2,667,652,15,1960,1151,26,90,363,330
"2021","Redcar and Cleveland 004","E02002518",9100,5945,4601,4581,20,9,1335,1274,61,3155,1775,48,137,574,621
"2021","Redcar and Cleveland 005","E02002519",5891,3111,2287,2269,18,6,818,774,44,2780,1555,35,127,579,484
"2021","Redcar and Cleveland 006","E02002520",11042,6933,5479,5459,20,14,1440,1378,62,4109,2205,55,171,762,916
"2021","Redcar and Cleveland 007","E02002521",4880,2754,2167,2141,26,1,586,556,30,2126,1106,51,92,458,419
"2021","Redcar and Cleveland 009","E02002523",4604,2069,1229,1220,9,4,836,798,38,2535,1743,30,134,367,261
"2021","Redcar and Cleveland 010","E02002524",4403,2797,2119,2113,6,5,673,664,9,1606,976,27,90,254,259
"2021","Redcar and Cleveland 011","E02002525",6635,3530,2583,2577,6,3,944,900,44,3105,1829,24,150,527,575
"2021","Redcar and Cleveland 012","E02002526",6302,3902,2914,2896,18,0,988,940,48,2400,1434,38,118,435,375
"2021","Redcar and Cleveland 013","E02002527",3952,2130,1460,1456,4,4,666,638,28,1822,1140,23,79,329,251
"2021","Redcar and Cleveland 015","E02002529",4745,2740,2116,2112,4,4,620,592,28,2005,1240,37,94,330,304
"2021","Redcar and Cleveland 016","E02002530",5222,3154,2354,2342,12,2,798,764,34,2068,1189,42,90,369,378
"2021","Redcar and Cleveland 018","E02002532",5437,2885,2085,2069,16,2,798,786,12,2552,1428,24,165,561,374
"2021","Redcar and Cleveland 019","E02002533",5356,3570,2903,2897,6,5,662,646,16,1786,1053,22,86,318,307
"2021","Redcar and Cleveland 020","E02002534",4788,3384,2863,2853,10,3,518,504,14,1404,730,32,54,240,348
"2021","Redcar and Cleveland 021","E02006812",6239,3512,2610,2602,8,0,902,872,30,2727,1674,29,98,422,504
"2021","Redcar and Cleveland 022","E02006910",8467,4750,3392,3378,14,2,1356,1284,72,3717,2364,71,190,531,561
"2021","Stockton-on-Tees 001","E02002535",7684,5073,4131,4112,19,2,940,902,38,2611,1493,52,118,457,491
"2021","Stockton-on-Tees 002","E02002536",7564,4259,3162,3144,18,6,1091,1038,53,3305,1897,41,182,610,575
"2021","Stockton-on-Tees 003","E02002537",6408,3274,2184,2162,22,8,1082,1040,42,3134,1983,48,175,515,413
"2021","Stockton-on-Tees 004","E02002538",4470,2640,1920,1886,34,6,714,694,20,1830,1034,32,106,366,292
"2021","Stockton-on-Tees 005","E02002539",8597,6182,5102,5072,30,12,1068,1024,44,2415,1442,64,106,353,450
"2021","Stockton-on-Tees 006","E02002540",5154,3462,2758,2742,16,0,704,674,30,1692,847,40,61,299,445
"2021","Stockton-on-Tees 007","E02002541",4980,2747,1827,1813,14,5,915,884,31,2233,1276,36,133,423,365
"2021","Stockton-on-Tees 008","E02002542",6197,3116,2044,2038,6,4,1068,1008,60,3081,1996,42,155,442,446
"2021","Stockton-on-Tees 009","E02002543",6926,3567,2413,2385,28,0,1154,1070,84,3359,2157,46,178,566,412
"2021","Stockton-on-Tees 010","E02002544",6167,3215,1983,1970,13,4,1228,1158,70,2952,1870,50,227,478,327
"2021","Stockton-on-Tees 011","E02002545",4264,2730,2146,2142,4,0,584,558,26,1534,816,29,72,276,341
"2021","Stockton-on-Tees 012","E02002546",5716,2862,1978,1948,30,8,876,842,34,2854,1879,99,141,464,271
"2021","Stockton-on-Tees 013","E02002547",5158,3324,2754,2744,10,0,570,562,8,1834,957,36,73,314,454
"2021","Stockton-on-Tees 015","E02002549",6251,4023,3253,3242,11,6,764,728,36,2228,1203,40,95,358,532
"2021","Stockton-on-Tees 016","E02002550",4883,3021,2325,2309,16,2,694,678,16,1862,1114,42,85,298,323
"2021","Stockton-on-Tees 017","E02002551",4240,1760,1151,1139,12,3,606,582,24,2480,1601,84,155,433,207
"2021","Stockton-on-Tees 018","E02002552",5546,3180,2264,2260,4,2,914,870,44,2366,1554,36,131,335,310
"2021","Stockton-on-Tees 019","E02002553",4588,2702,1960,1950,10,0,742,718,24,1886,1168,45,78,269,326
"2021","Stockton-on-Tees 020","E02002554",4021,2132,1498,1494,4,4,630,556,74,1889,1128,20,93,309,339
"2021","Stockton-on-Tees 021","E02002555",8248,5347,4316,4300,16,8,1023,1004,19,2901,1627,46,134,549,545
"2021","Stockton-on-Tees 022","E02002556",6002,4058,3364,3348,16,16,678,658,20,1944,1223,49,94,317,261
"2021","Stockton-on-Tees 024","E02002558",8919,6010,4860,4842,18,14,1136,1098,38,2909,1564,88,153,557,547
"2021","Stockton-on-Tees 025","E02007060",4746,2048,1348,1334,14,8,692,634,58,2698,1780,101,164,453,200
"2021","Stockton-on-Tees 026","E02007061",6048,3000,2073,2047,26,1,926,878,48,3048,1934,325,168,449,172
"2021","Stockton-on-Tees 027","E02007062",5489,3676,2697,2686,11,10,969,929,40,1813,1196,31,124,337,125
"2021","Stockton-on-Tees 028","E02007063",6948,4880,3993,3983,10,5,882,838,44,2068,1455,49,114,313,137
"2021","Darlington 001","E02002559",7868,5374,4113,4093,20,15,1246,1192,54,2494,1446,63,139,441,405
"2021","Darlington 002","E02002560",5038,3082,2311,2289,22,1,770,736,34,1956,1208,24,106,338,280
"2021","Darlington 003","E02002561",4592,2977,2354,2348,6,8,615,600,15,1615,933,31,62,306,283
"2021","Darlington 004","E02002562",4550,2190,1474,1462,12,0,716,678,38,2360,1412,26,160,489,273
"2021","Darlington 005","E02002563",4464,2681,1942,1930,12,7,732,710,22,1783,973,31,98,379,302
"2021","Darlington 006","E02002564",7815,4342,3155,3135,20,3,1184,1140,44,3473,1982,49,217,705,520
"2021","Darlington 009","E02002567",7251,4004,2607,2593,14,15,1382,1328,54,3247,1985,68,179,576,439
"2021","Darlington 010","E02002568",4974,3211,2695,2681,14,2,514,486,28,1763,966,35,88,320,354
"2021","Darlington 011","E02002569",7671,5290,4548,4534,14,2,740,724,16,2381,1165,49,85,392,690
"2021","Darlington 012","E02002570",5998,2922,1951,1925,26,3,968,914,54,3076,1843,74,177,613,369
"2021","Darlington 013","E02002571",4913,2831,1931,1911,20,3,897,870,27,2082,1327,46,112,337,260
"2021","Darlington 014","E02002572",4904,2528,1734,1717,17,4,790,730,60,2376,1514,38,129,444,251
"2021","Darlington 015","E02002573",7528,5112,4108,4078,30,6,998,964,34,2416,1366,36,123,434,457
"2021","Darlington 016","E02007058",9577,4464,2833,2807,26,5,1626,1542,84,5113,3191,138,309,1004,471
"2021","County Durham 002","E02004290",4865,3244,2633,2627,6,3,608,588,20,1621,937,24,85,274,301
"2021","County Durham 005","E02004291",5866,3358,2382,2372,10,6,970,942,28,2508,1495,44,152,454,363
"2021","County Durham 007","E02004292",6706,4298,3363,3349,14,3,932,894,38,2408,1297,53,102,421,535
"2021","County Durham 011","E02004293",7730,3952,2782,2766,16,6,1164,1102,62,3778,2216,77,204,732,549
"2021","County Durham 013","E02004294",6728,4450,3725,3701,24,1,724,698,26,2278,1272,32,103,401,470
"2021","County Durham 015","E02004295",6049,3754,2989,2975,14,1,764,732,32,2295,1338,43,113,386,415
"2021","County Durham 019","E02004296",6910,4020,2914,2882,32,8,1098,1052,46,2890,1794,52,164,501,379
"2021","County Durham 001","E02004297",6530,4144,3117,3103,14,3,1024,998,26,2386,1368,56,126,426,410
"2021","County Durham 003","E02004298",8258,5357,4238,4206,32,8,1111,1056,55,2901,1623,55,170,505,548
"2021","County Durham 004","E02004299",6720,4075,3037,3021,16,6,1032,1002,30,2645,1536,37,138,499,435
"2021","County Durham 006","E02004300",6266,3439,2536,2516,20,1,902,866,36,2827,1628,36,157,507,499
"2021","County Durham 008","E02004301",7508,4102,2734,2724,10,6,1362,1316,46,3406,2087,44,248,604,423
"2021","County Durham 009","E02004302",6375,3398,2384,2364,20,6,1008,960,48,2977,1832,43,178,521,403
"2021","County Durham 010","E02004303",9243,5150,3760,3740,20,2,1388,1320,68,4093,2369,55,253,791,625
"2021","County Durham 012","E02004304",7111,4129,3076,3056,20,8,1045,1012,33,2982,1786,43,159,521,473
"2021","County Durham 014","E02004305",8032,4814,3432,3414,18,4,1378,1326,52,3218,1963,68,145,608,434
"2021","County Durham 020","E02004306",4931,3160,2546,2536,10,0,614,604,10,1771,897,31,87,366,390
"2021","County Durham 024","E02004307",5303,3220,2464,2448,16,4,752,728,24,2083,1261,27,95,388,312
"2021","County Durham 022","E02004308",5651,3833,3292,3271,21,1,540,502,38,1818,972,42,67,336,401
"2021","County Durham 023","E02004309",5080,2915,2271,2262,9,4,640,618,22,2165,1288,51,93,396,337
"2021","County Durham 026","E02004310",6398,3795,2803,2780,23,2,990,924,66,2603,1572,46,113,459,413
"2021","County Durham 027","E02004311",7618,4668,3481,3453,28,7,1180,1122,58,2950,1730,48,160,511,501
"2021","County Durham 028","E02004312",6315,4127,3374,3358,16,4,749,711,38,2188,1137,45,84,390,532
"2021","County Durham 029","E02004313",5552,2213,1453,1443,10,3,757,705,52,3339,2500,84,114,332,309
"2021","County Durham 030","E02004314",6098,1111,809,795,14,0,302,280,22,4987,4552,46,37,177,175
"2021","County Durham 033","E02004315",9830,5459,4334,4308,26,7,1118,1062,56,4371,3429,89,107,376,370
"2021","County Durham 031","E02004316",5267,3060,2238,2226,12,10,812,782,30,2207,1358,34,125,365,325
"2021","County Durham 038","E02004317",6070,3365,2576,2562,14,2,787,771,16,2705,1524,39,161,535,446
"2021","County Durham 041","E02004318",5382,3307,2528,2508,20,2,777,731,46,2075,1174,43,98,463,297
"2021","County Durham 044","E02004319",6570,4106,2983,2957,26,5,1118,1078,40,2464,1472,40,142,406,404
"2021","County Durham 016","E02004320",7069,4492,3555,3536,19,7,930,888,42,2577,1485,44,113,487,448
"2021","County Durham 017","E02004321",6497,3550,2636,2628,8,0,914,890,24,2947,1775,55,160,493,464
"2021","County Durham 018","E02004322",6794,3564,2485,2465,20,5,1074,1044,30,3230,2007,40,171,527,485
"2021","County Durham 021","E02004323",5998,3532,2595,2589,6,3,934,912,22,2466,1497,33,105,441,390
"2021","County Durham 025","E02004324",4768,2758,2040,2026,14,4,714,698,16,2010,1231,18,89,354,318
"2021","County Durham 032","E02004325",6900,3370,2183,2163,20,6,1181,1134,47,3530,2240,30,184,593,483
"2021","County Durham 034","E02004326",5417,3005,2147,2137,10,0,858,832,26,2412,1457,46,149,403,357
"2021","County Durham 036","E02004327",4599,2286,1672,1662,10,2,612,590,22,2313,1342,43,131,409,388
"2021","County Durham 035","E02004328",5722,3050,2108,2102,6,0,942,906,36,2672,1649,47,142,471,363
"2021","County Durham 037","E02004329",5420,3292,2629,2629,0,1,662,644,18,2128,1331,31,96,350,320
"2021","County Durham 039","E02004330",4919,2696,2045,2029,16,5,646,618,28,2223,1260,25,120,398,420
"2021","County Durham 040","E02004331",5850,3431,2467,2456,11,4,960,924,36,2419,1447,37,132,413,390
"2021","County Durham 043","E02004332",5976,3560,2613,2595,18,3,944,928,16,2416,1490,45,123,392,366
"2021","County Durham 047","E02004333",5737,3582,2852,2832,20,4,726,702,24,2155,1160,41,102,419,433
"2021","County Durham 048","E02004334",5733,3301,2433,2421,12,2,866,844,22,2432,1417,48,118,433,416
"2021","County Durham 049","E02004335",6218,3445,2294,2276,18,6,1145,1084,61,2773,1671,63,133,566,340
"2021","County Durham 050","E02004336",5581,3142,2297,2285,12,13,832,806,26,2439,1365,43,144,447,440
"2021","County Durham 052","E02004337",8574,5156,3810,3776,34,4,1342,1290,52,3418,2065,44,198,587,524
"2021","County Durham 053","E02004338",6075,3510,2529,2515,14,3,978,952,26,2565,1540,31,156,452,386
"2021","County Durham 054","E02004339",5865,3888,3169,3151,18,1,718,696,22,1977,1059,37,91,382,408
"2021","County Durham 059","E02004340",8417,4535,3154,3142,12,10,1371,1328,43,3882,2320,53,245,668,596
"2021","County Durham 060","E02004341",7288,5011,3908,3879,29,5,1098,1062,36,2277,1298,28,114,427,410
"2021","County Durham 061","E02004342",4140,1946,1279,1269,10,3,664,638,26,2194,1354,37,136,438,229
"2021","County Durham 062","E02004343",4478,2534,1896,1888,8,4,634,608,26,1944,1046,20,112,419,347
"2021","County Durham 063","E02004344",5715,3258,2464,2454,10,4,790,766,24,2457,1316,41,113,472,515
"2021","County Durham 064","E02004345",10690,6738,5327,5289,38,1,1410,1382,28,3952,2101,86,195,792,778
"2021","County Durham 042","E02004348",6743,4358,3486,3458,28,2,870,836,34,2385,1242,64,96,468,515
"2021","County Durham 045","E02004349",7471,4140,2948,2930,18,6,1186,1140,46,3331,2018,50,183,586,494
"2021","County Durham 046","E02004350",8043,4953,3745,3712,33,6,1202,1154,48,3090,1750,44,155,592,549
"2021","County Durham 051","E02004351",5726,3158,2310,2304,6,6,842,808,34,2568,1560,39,141,463,365
"2021","County Durham 055","E02004352",6611,3511,2524,2500,24,0,987,943,44,3100,1875,47,227,535,416
"2021","County Durham 056","E02004353",5951,3652,2928,2916,12,0,724,682,42,2299,1317,38,92,405,447
"2021","County Durham 057","E02004354",7291,4448,3244,3226,18,6,1198,1158,40,2843,1699,60,185,486,413
"2021","County Durham 058","E02004355",5559,2842,2042,2036,6,6,794,770,24,2717,1655,40,148,492,382
"2021","County Durham 067","E02007022",9987,6430,5261,5233,28,5,1164,1120,44,3557,1830,71,169,739,748
"2021","Northumberland 004","E02005702",5517,3922,3362,3334,28,0,560,538,22,1595,825,39,83,265,383
"2021","Northumberland 005","E02005703",5763,3210,2387,2371,16,3,820,788,32,2553,1416,28,141,525,443
"2021","Northumberland 006","E02005704",10839,7146,5790,5748,42,4,1352,1292,60,3693,1983,74,196,669,771
"2021","Northumberland 007","E02005705",6583,4606,3912,3892,20,0,694,670,24,1977,999,41,92,342,503
"2021","Northumberland 001","E02005706",7394,4062,3005,2988,17,3,1054,1012,42,3332,1790,54,210,656,622
"2021","Northumberland 002","E02005707",6055,4088,3368,3346,22,2,718,684,34,1967,1014,55,92,349,457
"2021","Northumberland 003","E02005708",8766,5792,4752,4714,38,2,1038,986,52,2974,1450,63,191,560,710
"2021","Northumberland 022","E02005709",5106,2428,1560,1542,18,0,868,834,34,2678,1643,34,153,530,318
"2021","Northumberland 023","E02005710",7554,4022,2829,2789,40,3,1190,1140,50,3532,1975,53,232,715,557
"2021","Northumberland 024","E02005711",6278,3356,2424,2418,6,4,928,894,34,2922,1691,51,165,534,481
"2021","Northumberland 025","E02005712",7396,4604,3266,3240,26,8,1330,1280,50,2792,1766,34,186,441,365
"2021","Northumberland 026","E02005713",5320,3730,3094,3076,18,6,630,620,10,1590,870,25,65,281,349
"2021","Northumberland 029","E02005715",7256,4032,2788,2770,18,4,1240,1192,48,3224,1921,48,215,592,448
"2021","Northumberland 030","E02005717",6318,3942,3229,3213,16,7,706,690,16,2376,1186,43,122,469,556
"2021","Northumberland 031","E02005718",5450,3446,2842,2828,14,4,600,574,26,2004,1019,26,103,363,493
"2021","Northumberland 032","E02005719",6911,4008,2950,2932,18,4,1054,1002,52,2903,1725,32,143,554,449
"2021","Northumberland 008","E02005720",9144,5732,4343,4307,36,5,1384,1332,52,3412,1841,55,207,679,630
"2021","Northumberland 011","E02005721",4452,2728,2172,2151,21,2,554,536,18,1724,933,22,112,333,324
"2021","Northumberland 015","E02005722",7816,5650,4609,4589,20,11,1030,982,48,2166,1270,38,125,374,359
"2021","Northumberland 016","E02005723",5110,2760,2132,2124,8,0,628,610,18,2350,1152,41,119,526,512
"2021","Northumberland 018","E02005724",5463,3901,3443,3427,16,6,452,442,10,1562,800,28,60,260,414
"2021","Northumberland 033","E02005725",5783,3796,3290,3273,17,3,503,474,29,1987,1036,58,85,297,511
"2021","Northumberland 034","E02005726",6382,4644,4084,4066,18,2,558,540,18,1738,996,61,65,206,410
"2021","Northumberland 019","E02005727",5196,3564,2917,2895,22,3,644,630,14,1632,892,25,82,274,359
"2021","Northumberland 037","E02005728",5747,3630,2853,2837,16,3,774,754,20,2117,1154,45,90,413,415
"2021","Northumberland 036","E02005729",4646,3052,2558,2542,16,2,492,480,12,1594,887,26,96,280,305
"2021","Northumberland 035","E02005730",10572,6396,5169,5143,26,9,1218,1194,24,4176,2257,69,218,777,855
"2021","Northumberland 038","E02005731",8793,5330,4214,4198,16,6,1110,1080,30,3463,1976,53,187,666,581
"2021","Northumberland 040","E02005733",6957,4770,3844,3816,28,4,922,900,22,2187,1179,43,114,416,435
"2021","Northumberland 009","E02005734",4849,2575,1902,1890,12,1,672,632,40,2274,1196,54,150,470,404
"2021","Northumberland 010","E02005735",5675,2653,1797,1783,14,3,853,795,58,3022,1868,42,188,581,343
"2021","Northumberland 013","E02005736",6884,3928,2868,2846,22,2,1058,1030,28,2956,1821,34,223,516,362
"2021","Northumberland 017","E02005739",7567,4540,3489,3473,16,5,1046,1006,40,3027,1644,51,163,590,579
"2021","Northumberland 020","E02005740",8174,4455,3203,3183,20,6,1246,1204,42,3719,2202,55,231,696,535
"2021","Northumberland 021","E02005741",7005,4522,3662,3642,20,8,852,826,26,2483,1390,38,163,424,468
"2021","Northumberland 041","E02007105",10369,6300,4843,4831,12,4,1453,1389,64,4069,2327,51,239,765,687
"2021","Northumberland 042","E02007106",11995,7900,6228,6186,42,8,1664,1604,60,4095,2551,47,220,706,571
"2021","Northumberland 043","E02007107",7372,5024,4324,4304,20,4,696,674,22,2348,1168,53,95,424,608
"2021","Newcastle upon Tyne 002","E02001709",8381,5612,4588,4556,32,10,1014,968,46,2769,1701,80,94,388,506
"2021","Newcastle upon Tyne 003","E02001710",8068,3944,2851,2825,26,3,1090,1044,46,4124,2645,97,195,719,468
"2021","Newcastle upon Tyne 004","E02001711",7754,4114,2914,2886,28,2,1198,1154,44,3640,2329,63,207,577,464
"2021","Newcastle upon Tyne 005","E02001712",7536,4544,3426,3390,36,4,1114,1046,68,2992,2000,70,98,427,397
"2021","Newcastle upon Tyne 006","E02001713",8123,5140,4138,4104,34,0,1002,940,62,2983,1865,67,130,463,458
"2021","Newcastle upon Tyne 007","E02001714",7842,5152,4167,4139,28,11,974,924,50,2690,1781,82,100,325,402
"2021","Newcastle upon Tyne 008","E02001715",8959,4696,3492,3456,36,12,1192,1146,46,4263,2781,95,246,705,436
"2021","Newcastle upon Tyne 011","E02001718",5239,2774,1899,1887,12,1,874,852,22,2465,1509,38,136,439,343
"2021","Newcastle upon Tyne 012","E02001719",7246,4337,3212,3172,40,8,1117,1039,78,2909,1963,71,105,384,386
"2021","Newcastle upon Tyne 013","E02001720",8976,2186,1402,1388,14,0,784,722,62,6790,6315,40,63,204,168
"2021","Newcastle upon Tyne 014","E02001721",8777,4906,3586,3540,46,6,1314,1272,42,3871,2382,44,225,626,594
"2021","Newcastle upon Tyne 015","E02001722",7488,4061,2938,2916,22,8,1115,1076,39,3427,2109,84,172,507,555
"2021","Newcastle upon Tyne 016","E02001723",5421,2911,2176,2158,18,10,725,680,45,2510,1702,100,124,340,244
"2021","Newcastle upon Tyne 017","E02001724",8205,2308,1252,1224,28,0,1056,972,84,5897,5358,40,64,260,175
"2021","Newcastle upon Tyne 018","E02001725",8287,3025,1333,1302,31,4,1688,1564,124,5262,4402,65,145,415,235
"2021","Newcastle upon Tyne 019","E02001726",9280,4956,3816,3798,18,10,1130,1068,62,4324,2837,142,175,653,517
"2021","Newcastle upon Tyne 020","E02001727",7259,4068,3087,3067,20,1,980,922,58,3191,2006,134,156,433,462
"2021","Newcastle upon Tyne 021","E02001728",7676,4290,3127,3101,26,7,1156,1104,52,3386,2135,53,212,536,450
"2021","Newcastle upon Tyne 022","E02001729",8783,3865,3021,2995,26,9,835,743,92,4918,3684,347,230,388,269
"2021","Newcastle upon Tyne 025","E02001732",4429,2462,1678,1660,18,4,780,738,42,1967,1242,52,100,323,250
"2021","Newcastle upon Tyne 027","E02001734",6145,3056,2277,2260,17,5,774,726,48,3089,2069,115,158,435,312
"2021","Newcastle upon Tyne 028","E02001735",5021,2141,1432,1425,7,1,708,688,20,2880,1953,41,162,412,312
"2021","Newcastle upon Tyne 030","E02001737",4741,1964,1332,1324,8,6,626,600,26,2777,1838,39,178,455,267
"2021","Newcastle upon Tyne 031","E02006893",9186,5851,4642,4620,22,14,1195,1145,50,3335,1841,51,147,554,742
"2021","Newcastle upon Tyne 032","E02007095",7559,4972,3477,3451,26,7,1488,1414,74,2587,1607,66,149,457,308
"2021","Newcastle upon Tyne 033","E02007096",4782,3108,2474,2466,8,2,632,602,30,1674,1053,45,67,293,216
"2021","Newcastle upon Tyne 034","E02007097",5936,1665,808,790,18,1,856,798,58,4271,3786,40,74,267,104
"2021","Newcastle upon Tyne 035","E02007098",5161,2318,1540,1528,12,2,776,734,42,2843,1990,54,125,378,296
"2021","Newcastle upon Tyne 036","E02007099",5449,1748,826,802,24,0,922,746,176,3701,3133,80,99,262,127
"2021","Newcastle upon Tyne 037","E02007100",3291,1042,514,498,16,0,528,474,54,2249,1780,44,101,247,77
"2021","Newcastle upon Tyne 038","E02007101",6538,3320,2632,2624,8,16,672,644,28,3218,2261,285,161,279,232
"2021","Newcastle upon Tyne 039","E02007102",4720,1613,1050,1040,10,3,560,480,80,3107,2427,98,141,277,164
"2021","Newcastle upon Tyne 040","E02007103",4984,1904,1030,1018,12,6,868,810,58,3080,2242,67,151,437,183
"2021","Newcastle upon Tyne 041","E02007104",4026,1643,1285,1277,8,8,350,306,44,2383,1666,110,135,292,180
"2021","North Tyneside 001","E02001738",5088,3593,3224,3216,8,2,367,358,9,1495,795,29,40,193,438
"2021","North Tyneside 002","E02001739",6084,3518,2709,2695,14,7,802,778,24,2566,1475,40,143,494,414
"2021","North Tyneside 003","E02001740",4606,3263,2844,2822,22,2,417,400,17,1343,791,18,53,229,252
"2021","North Tyneside 004","E02001741",6551,4056,3170,3150,20,6,880,844,36,2495,1258,42,117,451,627
"2021","North Tyneside 005","E02001742",4800,3113,2592,2581,11,3,518,494,24,1687,872,23,77,369,346
"2021","North Tyneside 006","E02001743",5991,3591,2733,2694,39,6,852,796,56,2400,1478,46,143,452,281
"2021","North Tyneside 007","E02001744",6558,4107,2897,2861,36,4,1206,1138,68,2451,1384,41,145,509,372
"2021","North Tyneside 008","E02001745",5393,3162,2254,2236,18,0,908,874,34,2231,1339,29,126,400,337
"2021","North Tyneside 009","E02001746",6650,3912,2987,2969,18,3,922,886,36,2738,1601,39,119,528,451
"2021","North Tyneside 010","E02001747",5259,3418,2830,2820,10,0,588,558,30,1841,892,24,68,336,521
"2021","North Tyneside 011","E02001748",6841,4262,3102,3068,34,6,1154,1096,58,2579,1579,27,148,475,350
"2021","North Tyneside 012","E02001749",5246,3253,2522,2496,26,4,727,687,40,1993,1119,22,114,402,336
"2021","North Tyneside 013","E02001750",5548,3664,2945,2925,20,5,714,696,18,1884,1033,32,78,319,422
"2021","North Tyneside 014","E02001751",5399,3272,2333,2321,12,3,936,885,51,2127,1218,35,114,389,371
"2021","North Tyneside 015","E02001752",5043,2613,1883,1867,16,6,724,698,26,2430,1508,31,129,429,333
"2021","North Tyneside 016","E02001753",5240,3008,2254,2202,52,6,748,692,56,2232,1196,44,140,472,380
"2021","North Tyneside 017","E02001754",4857,3104,2376,2350,26,4,724,684,40,1753,1010,22,80,311,330
"2021","North Tyneside 018","E02001755",7944,5192,3936,3894,42,4,1252,1192,60,2752,1707,65,106,430,444
"2021","North Tyneside 019","E02001756",7531,4084,2637,2603,34,3,1444,1348,96,3447,2148,71,186,620,422
"2021","North Tyneside 020","E02001757",4946,2950,2302,2294,8,0,648,626,22,1996,1126,44,101,350,375
"2021","North Tyneside 021","E02001758",4561,2744,2176,2168,8,2,566,530,36,1817,1120,25,85,306,281
"2021","North Tyneside 022","E02001759",5274,2660,1778,1747,31,1,881,834,47,2614,1557,42,140,541,334
"2021","North Tyneside 023","E02001760",5889,2700,1723,1709,14,3,974,938,36,3189,2099,52,191,507,340
"2021","North Tyneside 024","E02001761",4563,2644,2002,1996,6,4,638,622,16,1919,1109,24,107,334,345
"2021","North Tyneside 025","E02001762",5535,3564,2564,2538,26,0,1000,980,20,1971,1209,34,94,347,287
"2021","North Tyneside 026","E02001763",5251,2726,1839,1831,8,5,882,836,46,2525,1564,23,151,458,329
"2021","North Tyneside 027","E02001764",6157,2848,1908,1876,32,8,932,874,58,3309,2070,63,202,656,318
"2021","North Tyneside 028","E02001765",5959,3046,2008,1972,36,4,1034,980,54,2913,1830,41,172,501,369
"2021","North Tyneside 029","E02001766",5828,3021,1976,1959,17,7,1038,976,62,2807,1878,60,149,461,259
"2021","North Tyneside 030","E02001767",5679,2912,1955,1939,16,6,951,892,59,2767,1732,40,140,497,358
"2021","South Tyneside 001","E02001768",6523,3320,2529,2509,20,1,790,750,40,3203,1925,123,171,592,392
"2021","South Tyneside 002","E02001769",6158,2636,1804,1796,8,4,828,774,54,3522,2224,90,214,647,347
"2021","South Tyneside 003","E02001770",5020,2706,1970,1958,12,4,732,700,32,2314,1379,35,124,451,325
"2021","South Tyneside 004","E02001771",4949,2797,2230,2220,10,3,564,540,24,2152,1249,23,119,338,423
"2021","South Tyneside 005","E02001772",4192,2294,1739,1725,14,7,548,528,20,1898,1097,32,110,336,323
"2021","South Tyneside 006","E02001773",4486,3002,2512,2500,12,4,486,474,12,1484,825,37,68,198,356
"2021","South Tyneside 007","E02001774",4229,2060,1438,1426,12,0,622,590,32,2169,1353,26,128,410,252
"2021","South Tyneside 008","E02001775",4346,2222,1662,1656,6,2,558,540,18,2124,1273,12,105,377,357
"2021","South Tyneside 009","E02001776",7199,3916,2654,2636,18,8,1254,1220,34,3283,2065,50,193,534,441
"2021","South Tyneside 010","E02001777",5494,3325,2339,2319,20,1,985,954,31,2169,1406,34,100,373,256
"2021","South Tyneside 011","E02001778",4630,2121,1424,1412,12,8,689,652,37,2509,1552,36,137,504,280
"2021","South Tyneside 012","E02001779",4313,2174,1575,1563,12,1,598,578,20,2139,1328,37,124,351,299
"2021","South Tyneside 013","E02001780",4892,2801,2146,2134,12,12,643,612,31,2091,1276,18,115,350,332
"2021","South Tyneside 014","E02001781",4247,2048,1348,1344,4,10,690,658,32,2199,1420,20,108,374,277
"2021","South Tyneside 015","E02001782",8045,4589,3246,3228,18,8,1335,1298,37,3456,2087,39,187,571,572
"2021","South Tyneside 016","E02001783",5424,2706,1837,1827,10,5,864,846,18,2718,1778,41,159,427,313
"2021","South Tyneside 017","E02001784",5335,2792,2056,2048,8,6,730,706,24,2543,1518,36,140,436,413
"2021","South Tyneside 018","E02001785",6354,3714,2987,2967,20,3,724,688,36,2640,1436,29,121,543,511
"2021","South Tyneside 019","E02001786",5439,2913,2195,2181,14,0,718,696,22,2526,1527,24,105,467,403
"2021","South Tyneside 020","E02001787",4352,2470,1957,1947,10,5,508,474,34,1882,1115,34,92,347,294
"2021","South Tyneside 021","E02001788",4735,2779,2072,2048,24,0,707,663,44,1956,1186,24,121,371,254
"2021","South Tyneside 022","E02001789",4884,3369,2906,2884,22,3,460,426,34,1515,822,23,57,217,396
"2021","South Tyneside 023","E02001790",4880,3080,2398,2382,16,2,680,652,28,1800,1007,27,84,308,374
"2021","Sunderland 001","E02001791",4700,3151,2553,2550,3,2,596,574,22,1549,895,41,54,203,356
"2021","Sunderland 002","E02001792",5821,3830,3195,3175,20,1,634,612,22,1991,1142,26,77,305,441
"2021","Sunderland 003","E02001793",6537,3138,1936,1928,8,6,1196,1148,48,3399,2203,29,176,508,483
"2021","Sunderland 004","E02001794",6870,3400,2321,2301,20,3,1076,1048,28,3470,2326,38,150,482,474
"2021","Sunderland 005","E02001795",5949,2988,2070,2062,8,4,914,866,48,2961,1836,32,146,517,430
"2021","Sunderland 006","E02001796",7275,3849,2857,2842,15,4,988,928,60,3426,1965,64,198,616,583
"2021","Sunderland 007","E02001797",4941,3234,2584,2578,6,0,650,632,18,1707,1038,24,76,278,291
"2021","Sunderland 008","E02001798",6570,3696,2653,2648,5,13,1030,986,44,2874,1909,39,151,378,397
"2021","Sunderland 009","E02001799",7364,3668,2429,2413,16,1,1238,1186,52,3696,2313,40,202,635,506
"2021","Sunderland 010","E02001800",5540,3240,2417,2399,18,1,822,782,40,2300,1329,22,142,423,384
"2021","Sunderland 011","E02001801",4299,2152,1592,1584,8,2,558,524,34,2147,1394,97,110,293,253
"2021","Sunderland 012","E02001802",5678,2868,1816,1792,24,6,1046,1020,26,2810,1876,45,125,372,392
"2021","Sunderland 013","E02001803",6307,2732,1761,1748,13,1,970,870,100,3575,2439,109,168,563,296
"2021","Sunderland 014","E02001804",4996,2748,2004,1992,12,4,740,726,14,2248,1430,22,131,331,334
"2021","Sunderland 015","E02001805",4631,2758,2157,2147,10,1,600,572,28,1873,1137,51,75,259,351
"2021","Sunderland 016","E02001806",6202,2618,1735,1715,20,11,872,804,68,3584,2269,87,230,589,409
"2021","Sunderland 017","E02001807",6723,4186,3163,3149,14,5,1018,978,40,2537,1600,33,137,428,339
"2021","Sunderland 018","E02001808",4492,2423,1902,1890,12,4,517,491,26,2069,1351,90,82,263,283
"2021","Sunderland 019","E02001809",5406,3291,2561,2556,5,2,728,706,22,2115,1178,32,101,412,392
"2021","Sunderland 020","E02001810",6870,4218,3137,3121,16,3,1078,1042,36,2652,1619,19,137,494,383
"2021","Sunderland 021","E02001811",7047,3612,2491,2478,13,6,1115,1074,41,3435,2250,46,153,498,488
"2021","Sunderland 022","E02001812",8423,5590,4745,4727,18,7,838,786,52,2833,1657,86,113,333,644
"2021","Sunderland 023","E02001813",7558,3680,2422,2414,8,2,1256,1200,56,3878,2654,49,195,523,457
"2021","Sunderland 024","E02001814",4963,2722,2054,2046,8,4,664,640,24,2241,1462,26,104,307,342
"2021","Sunderland 025","E02001815",8218,5414,4503,4485,18,5,906,872,34,2804,1643,38,129,479,515
"2021","Sunderland 026","E02001816",5665,2835,1957,1942,15,4,874,844,30,2830,1649,34,149,540,458
"2021","Sunderland 027","E02001817",5421,3046,2238,2226,12,2,806,794,12,2375,1457,28,128,358,404
"2021","Sunderland 028","E02001818",7516,4372,3148,3128,20,4,1220,1182,38,3144,2027,32,160,449,476
"2021","Sunderland 029","E02001819",5963,3946,3254,3248,6,0,692,668,24,2017,1162,40,79,269,467
"2021","Sunderland 030","E02001820",7767,4936,3619,3599,20,5,1312,1258,54,2831,1782,39,121,448,441
"2021","Sunderland 031","E02001821",4747,3008,2374,2368,6,6,628,620,8,1739,1099,31,88,247,274
"2021","Sunderland 032","E02001822",6285,3903,2937,2908,29,6,960,922,38,2382,1516,40,118,364,344
"2021","Sunderland 033","E02001823",6438,3831,2705,2685,20,5,1121,1078,43,2607,1621,40,143,436,367
"2021","Sunderland 034","E02001824",6963,4064,3104,3088,16,6,954,920,34,2899,1671,42,139,494,553
"2021","Sunderland 035","E02001825",6341,3777,2776,2764,12,2,999,960,39,2564,1462,38,135,435,494
"2021","Sunderland 036","E02001826",5810,3360,2364,2352,12,0,996,954,42,2450,1502,49,141,400,358
"2021","Gateshead 001","E02001682",6985,4401,3329,3292,37,2,1070,1018,52,2584,1515,37,141,448,443
"2021","Gateshead 002","E02001683",7744,4976,3744,3712,32,3,1229,1156,73,2768,1615,45,156,519,433
"2021","Gateshead 003","E02001684",5346,2735,1758,1744,14,0,977,896,81,2611,1699,43,141,416,312
"2021","Gateshead 004","E02001685",6453,3486,2321,2295,26,3,1162,1120,42,2967,1825,42,156,514,430
"2021","Gateshead 005","E02001686",5655,3454,2700,2678,22,4,750,716,34,2201,1238,34,113,390,426
"2021","Gateshead 007","E02001688",6254,3153,1891,1867,24,4,1258,1150,108,3101,2098,40,172,482,309
"2021","Gateshead 008","E02001689",5612,2677,1962,1937,25,3,712,630,82,2935,1991,86,149,427,282
"2021","Gateshead 009","E02001690",5761,3362,2586,2571,15,1,775,746,29,2399,1487,52,130,403,327
"2021","Gateshead 010","E02001691",6678,3419,2131,2084,47,0,1288,1220,68,3259,2265,101,147,470,276
"2021","Gateshead 011","E02001692",4889,2444,1608,1594,14,2,834,788,46,2445,1694,36,128,346,241
"2021","Gateshead 012","E02001693",4363,2154,1568,1556,12,0,586,554,32,2209,1327,28,96,404,354
"2021","Gateshead 013","E02001694",5208,3107,2335,2317,18,8,764,734,30,2101,1305,30,108,320,338
"2021","Gateshead 014","E02001695",4893,3094,2456,2444,12,2,636,604,32,1799,1047,19,70,301,362
"2021","Gateshead 015","E02001696",7294,3990,2872,2848,24,8,1110,1068,42,3304,2072,40,179,520,493
"2021","Gateshead 016","E02001697",6139,3911,3006,2990,16,5,900,856,44,2228,1347,46,103,356,376
"2021","Gateshead 017","E02001698",5939,3997,3494,3482,12,6,497,475,22,1942,970,43,66,300,563
"2021","Gateshead 018","E02001699",5445,3070,2246,2234,12,2,822,804,18,2375,1368,35,124,411,437
"2021","Gateshead 019","E02001700",8449,5187,3926,3900,26,5,1256,1198,58,3262,1944,49,160,550,559
"2021","Gateshead 020","E02001701",5118,3294,2657,2643,14,1,636,602,34,1824,1067,33,84,275,365
"2021","Gateshead 021","E02001702",6163,2941,2044,2019,25,1,896,860,36,3222,2069,57,154,508,434
"2021","Gateshead 022","E02001703",4709,3030,2480,2470,10,4,546,532,14,1679,924,35,60,264,396
"2021","Gateshead 023","E02001704",5665,2882,2068,2056,12,6,808,768,40,2783,1675,46,130,476,456
"2021","Gateshead 025","E02001706",6195,3783,2780,2757,23,11,992,936,56,2412,1492,32,121,427,340
"2021","Gateshead 026","E02001707",6746,3960,3008,2984,24,6,946,902,44,2786,1609,56,137,487,497
"2021","Gateshead 027","E02006841",5863,2735,1484,1460,24,1,1250,1158,92,3128,2302,87,134,411,194
"2021","Gateshead 028","E02006842",3947,2032,1461,1451,10,3,568,536,32,1915,1305,40,68,280,222
"2021","Gateshead 029","E02007094",5690,3241,2357,2345,12,4,880,838,42,2449,1442,30,135,450,392
"2021","Halton 001","E02002574",7106,4824,3874,3854,20,6,944,910,34,2282,1406,39,91,328,418
"2021","Halton 002","E02002575",7788,5257,4356,4322,34,6,895,868,27,2531,1694,33,114,356,334
"2021","Halton 003","E02002576",5992,3304,2262,2244,18,4,1038,1010,28,2688,1633,41,116,479,419
"2021","Halton 004","E02002577",5700,2794,1958,1944,14,0,836,794,42,2906,1901,42,129,461,373
"2021","Halton 005","E02002578",6717,3842,2777,2755,22,5,1060,1034,26,2875,1873,35,116,422,429
"2021","Halton 006","E02002579",6128,3271,2293,2287,6,7,971,930,41,2857,1786,40,129,478,424
"2021","Halton 007","E02002580",6171,2745,1627,1609,18,0,1118,1062,56,3426,2258,71,226,545,326
"2021","Halton 008","E02002581",5924,3653,2770,2754,16,6,877,834,43,2271,1418,47,91,296,419
"2021","Halton 009","E02002582",7499,5367,4221,4189,32,2,1144,1104,40,2132,1374,50,58,356,294
"2021","Halton 010","E02002583",5874,2757,1845,1830,15,5,907,868,39,3117,1966,41,168,569,373
"2021","Halton 011","E02002584",5872,3440,2482,2474,8,4,954,924,30,2432,1576,41,114,345,356
"2021","Halton 012","E02002585",8797,4696,2981,2953,28,9,1706,1598,108,4101,2602,67,222,715,495
"2021","Halton 013","E02002586",7393,3525,2343,2326,17,8,1174,1132,42,3868,2496,37,233,621,481
"2021","Halton 014","E02002587",5147,2712,1849,1843,6,9,854,822,32,2435,1483,30,117,495,310
"2021","Halton 015","E02002588",5646,2752,1980,1974,6,8,764,744,20,2894,1805,35,165,498,391
"2021","Halton 016","E02002589",5330,3684,3071,3059,12,5,608,592,16,1646,935,26,52,251,382
"2021","Warrington 001","E02002590",5263,3556,2986,2968,18,8,562,550,12,1707,1000,28,47,284,348
"2021","Warrington 002","E02002591",5361,3394,2768,2760,8,4,622,608,14,1967,1059,35,81,351,441
"2021","Warrington 003","E02002592",5004,3162,2562,2548,14,4,596,564,32,1842,1082,27,62,264,407
"2021","Warrington 004","E02002593",4225,2527,1923,1906,17,0,604,578,26,1698,933,27,84,379,275
"2021","Warrington 005","E02002594",4548,2525,1782,1768,14,1,742,704,38,2023,1258,34,115,385,231
"2021","Warrington 006","E02002595",6246,3160,2013,2005,8,1,1146,1100,46,3086,2031,47,139,534,335
"2021","Warrington 007","E02002596",6707,4297,3372,3356,16,4,921,870,51,2410,1386,50,86,442,446
"2021","Warrington 008","E02002597",7080,3634,2466,2448,18,10,1158,1128,30,3446,2199,68,163,624,392
"2021","Warrington 009","E02002598",8620,5983,4623,4594,29,12,1348,1298,50,2637,1804,52,121,433,227
"2021","Warrington 010","E02002599",8849,5815,4770,4746,24,2,1043,1008,35,3034,1943,63,122,519,387
"2021","Warrington 011","E02002600",7459,3979,2630,2617,13,3,1346,1294,52,3480,2112,82,160,624,502
"2021","Warrington 012","E02002601",7422,4834,3682,3662,20,6,1146,1116,30,2588,1504,42,100,442,500
"2021","Warrington 013","E02002602",6244,3225,2115,2101,14,5,1105,1064,41,3019,2032,83,184,488,232
"2021","Warrington 014","E02002603",5798,3877,3217,3203,14,3,657,641,16,1921,1128,49,77,279,388
"2021","Warrington 015","E02002604",6442,4380,3487,3481,6,3,890,860,30,2062,1206,28,86,334,408
"2021","Warrington 016","E02002605",7261,4452,3453,3427,26,7,992,964,28,2809,1742,55,109,487,416
"2021","Warrington 017","E02002606",9081,4466,2570,2544,26,10,1886,1786,100,4615,3050,126,225,835,379
"2021","Warrington 018","E02002607",9438,4866,3034,3012,22,4,1828,1750,78,4572,2793,133,222,841,583
"2021","Warrington 019","E02002608",6918,4518,3680,3670,10,4,834,814,20,2400,1315,51,76,362,596
"2021","Warrington 020","E02002609",7541,3882,2406,2376,30,8,1468,1400,68,3659,2398,65,187,668,341
"2021","Warrington 021","E02002610",10050,6633,5492,5467,25,13,1128,1086,42,3417,1892,71,138,682,634
"2021","Warrington 022","E02002611",6355,4328,3522,3498,24,2,804,770,34,2027,1124,41,69,331,462
"2021","Warrington 023","E02002612",7422,4727,3707,3681,26,6,1014,968,46,2695,1488,52,95,526,534
"2021","Warrington 024","E02002613",5370,3859,3152,3142,10,1,706,680,26,1511,919,32,43,241,276
"2021","Warrington 025","E02002614",4918,3623,3263,3254,9,2,358,346,12,1295,763,35,39,155,303
"2021","Blackburn with Darwen 001","E02002615",8218,4800,3897,3889,8,7,896,864,32,3418,2109,147,148,512,502
"2021","Blackburn with Darwen 002","E02002616",7011,4367,3919,3908,11,4,444,434,10,2644,1812,186,82,266,298
"2021","Blackburn with Darwen 003","E02002617",7030,3744,3432,3428,4,6,306,286,20,3286,2215,278,142,313,338
"2021","Blackburn with Darwen 004","E02002618",5841,3232,3006,3002,4,1,225,221,4,2609,1819,203,116,221,250
"2021","Blackburn with Darwen 005","E02002619",6767,3533,3023,3015,8,4,506,490,16,3234,2123,293,162,381,275
"2021","Blackburn with Darwen 006","E02002620",6694,3045,2596,2586,10,8,441,426,15,3649,2353,237,182,523,354
"2021","Blackburn with Darwen 007","E02002621",6309,3198,2971,2971,0,3,224,204,20,3111,2090,248,150,334,289
"2021","Blackburn with Darwen 008","E02002622",7749,3744,2788,2774,14,6,950,928,22,4005,2622,169,201,620,393
"2021","Blackburn with Darwen 009","E02002623",7968,3621,2203,2174,29,4,1414,1350,64,4347,2811,134,207,764,431
"2021","Blackburn with Darwen 010","E02002624",7199,4774,3802,3788,14,4,968,940,28,2425,1430,66,92,325,512
"2021","Blackburn with Darwen 011","E02002625",7625,4041,2840,2825,15,9,1192,1154,38,3584,2360,71,178,582,393
"2021","Blackburn with Darwen 012","E02002626",5750,3032,2114,2100,14,6,912,890,22,2718,1736,30,125,427,400
"2021","Blackburn with Darwen 013","E02002627",5927,3868,2845,2835,10,5,1018,980,38,2059,1400,35,86,296,242
"2021","Blackburn with Darwen 014","E02002628",5502,2903,1980,1965,15,3,920,888,32,2599,1600,30,160,459,350
"2021","Blackburn with Darwen 015","E02002629",4713,2417,1567,1552,15,2,848,824,24,2296,1450,43,126,381,296
"2021","Blackburn with Darwen 016","E02002630",5029,2627,1716,1694,22,0,911,871,40,2402,1448,65,129,447,313
"2021","Blackburn with Darwen 017","E02002631",7433,4518,3305,3273,32,3,1210,1158,52,2915,1754,35,142,559,425
"2021","Blackburn with Darwen 018","E02002632",5338,3746,3012,2990,22,4,730,702,28,1592,939,39,71,287,256
"2021","Blackpool 001","E02002633",6399,3646,2789,2755,34,5,852,798,54,2753,1406,48,111,563,625
"2021","Blackpool 002","E02002634",6872,3704,2798,2760,38,2,904,856,48,3168,1626,43,128,718,653
"2021","Blackpool 003","E02002635",6515,3770,2795,2739,56,5,970,906,64,2745,1443,66,118,550,568
"2021","Blackpool 004","E02002636",6592,3674,2531,2495,36,5,1138,1068,70,2918,1722,47,147,589,413
"2021","Blackpool 005","E02002637",5123,2980,2114,2060,54,0,866,818,48,2143,1293,30,80,418,322
"2021","Blackpool 006","E02002638",4859,1984,1236,1158,78,2,746,646,100,2875,1839,60,157,590,229
"2021","Blackpool 007","E02002639",4651,1929,1181,1163,18,14,734,702,32,2722,1724,39,133,549,277
"2021","Blackpool 008","E02002640",5433,2261,1239,1185,54,5,1017,931,86,3172,2076,62,176,597,261
"2021","Blackpool 009","E02002641",6514,3518,2337,2281,56,5,1176,1090,86,2996,1877,86,137,516,380
"2021","Blackpool 010","E02002642",5397,2018,1270,1216,54,0,748,664,84,3379,2131,136,230,599,283
"2021","Blackpool 011","E02002643",6089,2863,1676,1644,32,6,1181,1088,93,3226,2072,68,198,563,325
"2021","Blackpool 012","E02002644",6401,3691,2571,2536,35,6,1114,1060,54,2710,1641,32,147,509,381
"2021","Blackpool 013","E02002645",4666,1806,1086,1052,34,4,716,650,66,2860,1777,73,191,594,225
"2021","Blackpool 014","E02002646",5816,3064,2072,2048,24,2,990,942,48,2752,1605,30,135,552,430
"2021","Blackpool 015","E02002647",6342,3064,1883,1847,36,19,1162,1076,86,3278,2124,56,155,555,388
"2021","Blackpool 016","E02002648",5620,2884,1843,1815,28,7,1034,984,50,2736,1631,31,134,552,388
"2021","Blackpool 017","E02002649",6715,3540,2433,2411,22,3,1104,1048,56,3175,1903,44,138,625,465
"2021","Blackpool 018","E02002650",6994,4101,3059,3015,44,5,1037,975,62,2893,1595,56,135,588,519
"2021","Blackpool 019","E02002651",6435,3678,2658,2610,48,2,1018,962,56,2757,1540,41,134,527,515
"2021","Cheshire East 022","E02003811",6271,4464,3723,3705,18,3,738,712,26,1807,1048,36,56,351,316
"2021","Cheshire East 023","E02003812",5382,3667,3014,3009,5,5,648,616,32,1715,888,42,66,332,387
"2021","Cheshire East 024","E02003813",5153,3260,2616,2610,6,6,638,610,28,1893,1049,33,81,353,377
"2021","Cheshire East 025","E02003814",6697,4363,3195,3182,13,4,1164,1128,36,2334,1438,34,101,437,324
"2021","Cheshire East 026","E02003815",5894,3452,2492,2476,16,6,954,902,52,2442,1488,38,132,470,314
"2021","Cheshire East 027","E02003816",6272,3624,2600,2580,20,0,1024,974,50,2648,1508,46,142,543,409
"2021","Cheshire East 028","E02003817",6362,4234,3376,3366,10,6,852,822,30,2128,1084,28,85,405,526
"2021","Cheshire East 029","E02003818",4799,3414,2848,2836,12,6,560,550,10,1385,751,26,45,226,337
"2021","Cheshire East 030","E02003819",5488,3676,2912,2900,12,2,762,720,42,1812,942,36,69,334,431
"2021","Cheshire East 031","E02003820",7708,5127,3779,3741,38,4,1344,1296,48,2581,1548,37,154,524,318
"2021","Cheshire East 032","E02003821",4754,2914,2262,2250,12,2,650,626,24,1840,933,26,90,396,395
"2021","Cheshire East 033","E02003822",9762,6807,5322,5286,36,10,1475,1412,63,2955,1631,62,136,534,592
"2021","Cheshire East 040","E02003823",5679,3623,2934,2932,2,9,680,664,16,2056,1070,35,71,402,478
"2021","Cheshire East 042","E02003824",5207,3536,2731,2713,18,5,800,750,50,1671,913,26,87,320,325
"2021","Cheshire East 034","E02003825",5194,3513,2668,2646,22,2,843,800,43,1681,1101,29,73,298,180
"2021","Cheshire East 035","E02003826",6758,3852,2438,2412,26,10,1404,1334,70,2906,1819,79,134,484,390
"2021","Cheshire East 036","E02003827",7452,3928,2403,2383,20,5,1520,1460,60,3524,2220,115,178,607,404
"2021","Cheshire East 037","E02003828",5001,2871,1960,1954,6,2,909,852,57,2130,1369,53,116,324,268
"2021","Cheshire East 038","E02003829",4581,2858,2149,2133,16,1,708,676,32,1723,905,32,59,293,434
"2021","Cheshire East 039","E02003830",6315,3255,1975,1963,12,1,1279,1218,61,3060,2003,79,200,503,275
"2021","Cheshire East 041","E02003831",8395,5816,4607,4569,38,11,1198,1128,70,2579,1481,52,93,467,486
"2021","Cheshire East 043","E02003832",5469,2650,1581,1571,10,7,1062,882,180,2819,1878,273,100,370,198
"2021","Cheshire East 044","E02003833",5124,3088,2263,2246,17,7,818,792,26,2036,1177,36,109,385,329
"2021","Cheshire East 045","E02003834",5627,3077,1863,1849,14,1,1213,1177,36,2550,1670,112,123,425,220
"2021","Cheshire East 046","E02003835",7078,5080,4244,4218,26,10,826,802,24,1998,1086,53,69,308,482
"2021","Cheshire East 047","E02003836",5944,3378,2523,2509,14,1,854,810,44,2566,1329,44,123,526,544
"2021","Cheshire East 048","E02003838",6690,4474,3196,3169,27,7,1271,1226,45,2216,1194,31,120,400,471
"2021","Cheshire East 050","E02003839",5972,3459,2616,2602,14,1,842,814,28,2513,1341,37,110,518,507
"2021","Cheshire East 051","E02003840",9120,6446,5399,5345,54,13,1034,974,60,2674,1479,64,113,436,582
"2021","Cheshire East 001","E02003853",5079,3518,2864,2846,18,0,654,630,24,1561,863,33,72,297,296
"2021","Cheshire East 002","E02003854",5263,3512,2967,2961,6,3,542,520,22,1751,946,36,70,320,379
"2021","Cheshire East 003","E02003855",5298,3622,3204,3194,10,0,418,404,14,1676,821,29,50,328,448
"2021","Cheshire East 004","E02003856",9247,5285,3898,3870,28,12,1375,1326,49,3962,2422,96,159,731,554
"2021","Cheshire East 005","E02003857",5436,3384,2658,2636,22,2,724,682,42,2052,1231,53,86,410,272
"2021","Cheshire East 006","E02003858",5717,3735,3006,2978,28,3,726,686,40,1982,1076,66,101,323,416
"2021","Cheshire East 007","E02003859",9860,6866,5784,5736,48,8,1074,1008,66,2994,1701,82,125,535,551
"2021","Cheshire East 008","E02003860",5715,3958,3334,3322,12,8,616,582,34,1757,962,43,62,324,366
"2021","Cheshire East 009","E02003861",5147,3072,2307,2289,18,1,764,726,38,2075,1148,49,111,428,339
"2021","Cheshire East 011","E02003862",4348,3082,2698,2690,8,4,380,370,10,1266,679,35,45,197,310
"2021","Cheshire East 010","E02003863",5578,3704,3121,3113,8,3,580,554,26,1874,954,76,75,310,459
"2021","Cheshire East 012","E02003864",7163,4537,3637,3607,30,6,894,858,36,2626,1389,84,114,497,542
"2021","Cheshire East 013","E02003865",6519,4113,3186,3164,22,1,926,904,22,2406,1287,40,126,563,390
"2021","Cheshire East 014","E02003866",5183,3586,3056,3048,8,2,528,504,24,1597,916,28,65,274,314
"2021","Cheshire East 015","E02003867",6083,3770,2931,2923,8,7,832,804,28,2313,1350,51,109,481,322
"2021","Cheshire East 016","E02003868",6947,3900,2740,2720,20,8,1152,1094,58,3047,1756,48,141,630,472
"2021","Cheshire East 017","E02003869",5937,3844,3020,3010,10,4,820,796,24,2093,1219,44,96,400,334
"2021","Cheshire East 018","E02003870",8846,4775,3061,3035,26,3,1711,1626,85,4071,2551,70,228,826,396
"2021","Cheshire East 019","E02003871",5596,3250,2494,2478,16,0,756,730,26,2346,1364,31,112,462,377
"2021","Cheshire East 020","E02003872",8732,6068,5075,5051,24,9,984,944,40,2664,1467,85,105,463,544
"2021","Cheshire East 021","E02003873",4896,2635,1719,1712,7,4,912,866,46,2261,1385,38,105,505,228
"2021","Cheshire East 052","E02007030",5516,3982,2921,2893,28,5,1056,1008,48,1534,931,43,60,273,227
"2021","Cheshire East 053","E02007031",6874,4822,3954,3924,30,2,866,846,20,2052,1328,41,72,340,271
"2021","Cheshire West and Chester 022","E02003794",7085,4597,3688,3668,20,13,896,856,40,2488,1444,71,119,444,410
"2021","Cheshire West and Chester 025","E02003795",4603,3102,2563,2549,14,1,538,518,20,1501,836,46,66,248,305
"2021","Cheshire West and Chester 027","E02003796",5969,3444,2755,2740,15,8,681,657,24,2525,1390,62,94,469,510
"2021","Cheshire West and Chester 028","E02003797",8070,5214,4091,4059,32,11,1112,1062,50,2856,1894,54,80,410,418
"2021","Cheshire West and Chester 029","E02003798",4825,2478,1668,1651,17,5,805,774,31,2347,1547,47,103,396,254
"2021","Cheshire West and Chester 031","E02003799",5772,3035,2125,2096,29,6,904,868,36,2737,1720,52,112,507,346
"2021","Cheshire West and Chester 030","E02003800",5827,4063,3418,3406,12,5,640,624,16,1764,950,26,76,298,414
"2021","Cheshire West and Chester 032","E02003801",5715,3693,2857,2843,14,4,832,806,26,2022,1143,27,86,361,405
"2021","Cheshire West and Chester 033","E02003802",7258,3208,1737,1712,25,9,1462,1366,96,4050,2732,75,153,739,351
"2021","Cheshire West and Chester 034","E02003803",8081,3016,1612,1560,52,0,1404,1306,98,5065,3972,140,142,488,323
"2021","Cheshire West and Chester 036","E02003804",5796,3248,2158,2138,20,0,1090,1016,74,2548,1528,60,102,524,334
"2021","Cheshire West and Chester 039","E02003805",5175,3492,3003,2993,10,1,488,476,12,1683,988,29,63,266,337
"2021","Cheshire West and Chester 041","E02003806",6474,4376,3438,3416,22,2,936,898,38,2098,1195,41,78,394,390
"2021","Cheshire West and Chester 043","E02003807",7505,4746,3731,3697,34,3,1012,952,60,2759,1544,62,82,468,603
"2021","Cheshire West and Chester 044","E02003808",5157,2921,2011,1999,12,7,903,877,26,2236,1436,32,108,466,194
"2021","Cheshire West and Chester 046","E02003809",6829,4624,3794,3774,20,8,822,788,34,2205,1245,56,83,392,429
"2021","Cheshire West and Chester 047","E02003810",8016,5320,4264,4252,12,4,1052,1016,36,2696,1508,58,123,527,480
"2021","Cheshire West and Chester 001","E02003841",6671,3979,3219,3189,30,4,756,726,30,2692,1512,49,107,502,522
"2021","Cheshire West and Chester 004","E02003842",4809,3338,2869,2853,16,9,460,440,20,1471,781,43,56,229,362
"2021","Cheshire West and Chester 005","E02003843",5353,3060,2334,2322,12,0,726,690,36,2293,1335,41,85,404,428
"2021","Cheshire West and Chester 006","E02003844",5681,3592,2955,2941,14,5,632,616,16,2089,1181,31,78,377,422
"2021","Cheshire West and Chester 007","E02003845",8584,4424,2445,2411,34,11,1968,1806,162,4160,2678,89,204,791,398
"2021","Cheshire West and Chester 008","E02003846",5283,2736,1856,1840,16,6,874,848,26,2547,1588,36,126,455,342
"2021","Cheshire West and Chester 009","E02003847",8270,5625,4530,4510,20,10,1085,1048,37,2645,1613,43,103,406,480
"2021","Cheshire West and Chester 010","E02003848",4203,2297,1618,1606,12,8,671,652,19,1906,1219,30,55,315,287
"2021","Cheshire West and Chester 011","E02003849",6557,3315,2091,2067,24,9,1215,1173,42,3242,2010,50,225,617,340
"2021","Cheshire West and Chester 013","E02003850",4249,2602,2018,2006,12,4,580,566,14,1647,913,19,81,311,323
"2021","Cheshire West and Chester 014","E02003851",4815,3282,2677,2659,18,1,604,578,26,1533,913,31,46,232,311
"2021","Cheshire West and Chester 016","E02003852",5465,3638,2964,2958,6,0,674,650,24,1827,1041,23,67,297,399
"2021","Cheshire West and Chester 002","E02003874",7603,4781,3904,3889,15,10,867,832,35,2822,1554,56,96,541,575
"2021","Cheshire West and Chester 003","E02003875",5556,3975,3395,3376,19,4,576,566,10,1581,869,35,49,247,381
"2021","Cheshire West and Chester 012","E02003876",4594,2921,2099,2088,11,4,818,772,46,1673,959,26,83,327,278
"2021","Cheshire West and Chester 015","E02003877",8070,5525,4450,4431,19,5,1070,1044,26,2545,1381,44,108,455,557
"2021","Cheshire West and Chester 017","E02003878",7502,5028,3971,3943,28,3,1054,1016,38,2474,1383,48,93,441,509
"2021","Cheshire West and Chester 018","E02003879",7290,4438,2702,2660,42,2,1734,1648,86,2852,1800,62,153,507,330
"2021","Cheshire West and Chester 019","E02003880",5388,3296,2514,2494,20,10,772,752,20,2092,1225,30,88,382,367
"2021","Cheshire West and Chester 020","E02003881",4810,2678,1868,1854,14,2,808,768,40,2132,1280,38,103,464,247
"2021","Cheshire West and Chester 021","E02003882",7677,4487,3170,3146,24,6,1311,1246,65,3190,1918,48,123,613,488
"2021","Cheshire West and Chester 023","E02003883",9242,6230,5196,5176,20,10,1024,990,34,3012,1801,50,125,536,500
"2021","Cheshire West and Chester 024","E02003884",7340,5162,4301,4275,26,7,854,828,26,2178,1199,48,95,385,451
"2021","Cheshire West and Chester 026","E02003885",5267,3544,2822,2804,18,2,720,696,24,1723,1003,39,80,301,300
"2021","Cheshire West and Chester 035","E02003886",5145,2972,2108,2100,8,14,850,828,22,2173,1381,45,97,340,310
"2021","Cheshire West and Chester 037","E02003887",5640,3673,2685,2643,42,5,983,952,31,1967,1249,30,111,305,272
"2021","Cheshire West and Chester 038","E02003888",5186,2840,1903,1889,14,7,930,886,44,2346,1456,50,120,399,321
"2021","Cheshire West and Chester 040","E02003889",4925,2760,1822,1806,16,6,932,898,34,2165,1377,39,107,343,299
"2021","Cheshire West and Chester 042","E02003890",5666,3498,2457,2425,32,5,1036,996,40,2168,1367,59,100,347,295
"2021","Cheshire West and Chester 045","E02003891",5367,3645,3054,3043,11,3,588,572,16,1722,918,47,77,291,389
"2021","Allerdale 001","E02003965",9187,5664,4426,4414,12,4,1234,1192,42,3523,1934,75,174,610,730
"2021","Allerdale 002","E02003966",6007,4098,3400,3390,10,2,696,658,38,1909,1121,38,59,287,404
"2021","Allerdale 003","E02003967",6728,4304,3354,3338,16,2,948,918,30,2424,1357,44,117,439,467
"2021","Allerdale 004","E02003968",7374,4664,3557,3539,18,5,1102,1078,24,2710,1589,44,110,467,500
"2021","Allerdale 005","E02003969",5191,2834,1964,1956,8,6,864,840,24,2357,1450,26,118,380,383
"2021","Allerdale 006","E02003970",6879,4431,3582,3562,20,2,847,818,29,2448,1327,48,114,514,445
"2021","Allerdale 007","E02003971",6532,4271,3560,3546,14,3,708,682,26,2261,1227,46,90,400,498
"2021","Allerdale 008","E02003972",7447,4459,3377,3366,11,2,1080,1042,38,2988,1746,41,116,570,515
"2021","Allerdale 009","E02003973",6917,3489,2384,2364,20,0,1105,1083,22,3428,2032,58,169,713,456
"2021","Allerdale 010","E02003974",6126,3612,2706,2682,24,8,898,868,30,2514,1525,25,83,441,440
"2021","Allerdale 011","E02003975",5863,3894,3052,3030,22,0,842,820,22,1969,1133,39,67,327,403
"2021","Allerdale 012","E02003976",5334,3304,2659,2633,26,3,642,618,24,2030,1112,50,69,366,433
"2021","Barrow-in-Furness 001","E02003977",5191,3232,2513,2501,12,1,718,706,12,1959,1154,31,90,357,327
"2021","Barrow-in-Furness 002","E02003978",4828,2885,2128,2120,8,4,753,728,25,1943,1127,31,85,347,353
"2021","Barrow-in-Furness 003","E02003979",6538,4459,3744,3738,6,1,714,698,16,2079,1098,50,64,270,597
"2021","Barrow-in-Furness 004","E02003980",5387,2656,1750,1732,18,4,902,866,36,2731,1669,36,140,545,341
"2021","Barrow-in-Furness 005","E02003981",5324,3159,2272,2258,14,0,887,857,30,2165,1329,44,73,428,291
"2021","Barrow-in-Furness 006","E02003982",6474,4329,3407,3393,14,0,922,898,24,2145,1271,40,81,359,394
"2021","Barrow-in-Furness 007","E02003983",5819,2970,1952,1941,11,2,1016,980,36,2849,1758,43,119,530,399
"2021","Barrow-in-Furness 008","E02003984",5088,2090,1187,1183,4,5,898,866,32,2998,1893,58,158,598,291
"2021","Barrow-in-Furness 009","E02003985",5578,3373,2475,2449,26,4,894,864,30,2205,1221,24,99,419,442
"2021","Barrow-in-Furness 010","E02003986",5079,2853,2086,2080,6,1,766,734,32,2226,1299,55,93,410,369
"2021","Carlisle 001","E02003987",5060,3188,2532,2526,6,2,654,642,12,1872,1080,47,109,290,346
"2021","Carlisle 002","E02003988",5488,3342,2686,2662,24,0,656,612,44,2146,1144,35,148,411,408
"2021","Carlisle 003","E02003989",6309,3944,3137,3129,8,7,800,786,14,2365,1324,47,93,408,493
"2021","Carlisle 004","E02003990",8888,6051,4808,4787,21,3,1240,1198,42,2837,1616,53,119,489,560
"2021","Carlisle 005","E02003991",6327,4454,3692,3674,18,2,760,740,20,1873,1068,27,53,302,423
"2021","Carlisle 006","E02003992",6813,3123,2088,2072,16,0,1035,980,55,3690,2429,112,168,632,349
"2021","Carlisle 007","E02003993",7514,5160,4280,4260,20,6,874,856,18,2354,1298,45,99,382,530
"2021","Carlisle 008","E02003994",5937,3046,2054,2032,22,4,988,936,52,2891,1813,56,140,516,366
"2021","Carlisle 009","E02003995",8014,4306,2900,2884,16,4,1402,1340,62,3708,2200,42,196,733,537
"2021","Carlisle 010","E02003996",7709,3954,2467,2429,38,7,1480,1416,64,3755,2416,66,204,689,380
"2021","Carlisle 011","E02003997",7312,3845,2558,2542,16,4,1283,1229,54,3467,2059,58,209,686,455
"2021","Carlisle 012","E02003998",5116,2789,1925,1913,12,3,861,831,30,2327,1408,32,111,393,383
"2021","Carlisle 013","E02003999",9687,6675,5255,5209,46,4,1416,1372,44,3012,1726,44,133,501,608
"2021","Copeland 001","E02004000",4271,2669,2101,2089,12,2,566,552,14,1602,982,27,63,257,273
"2021","Copeland 002","E02004001",4476,2258,1716,1712,4,0,542,518,24,2218,1319,52,87,448,312
"2021","Copeland 003","E02004002",7916,5084,4046,4036,10,5,1033,997,36,2832,1701,36,108,493,494
"2021","Copeland 004","E02004003",9632,5709,4459,4419,40,5,1245,1213,32,3923,2374,66,158,672,653
"2021","Copeland 005","E02004004",7724,4408,3196,3180,16,0,1212,1164,48,3316,2010,45,153,562,546
"2021","Copeland 006","E02004005",6329,3698,2843,2825,18,7,848,829,19,2631,1564,46,112,450,459
"2021","Copeland 007","E02004006",7108,4746,3926,3896,30,6,814,792,22,2362,1234,63,111,405,549
"2021","Copeland 008","E02004007",7860,4833,3747,3733,14,1,1085,1058,27,3027,1721,47,121,500,638
"2021","Eden 001","E02004008",5476,3730,3013,3007,6,1,716,700,16,1746,996,39,75,282,354
"2021","Eden 002","E02004009",5261,3650,3006,2986,20,4,640,618,22,1611,934,29,70,252,326
"2021","Eden 003","E02004010",6414,3450,2406,2400,6,4,1040,978,62,2964,1743,93,102,548,478
"2021","Eden 004","E02004011",9175,5986,4678,4652,26,2,1306,1270,36,3189,1797,85,122,505,680
"2021","Eden 005","E02004012",4727,3182,2616,2606,10,0,566,536,30,1545,890,44,52,255,304
"2021","Eden 006","E02004013",8695,5720,4613,4595,18,5,1102,1060,42,2975,1717,42,126,492,598
"2021","Eden 007","E02004014",6579,4404,3577,3553,24,5,822,782,40,2175,1229,61,98,365,422
"2021","South Lakeland 001","E02004015",4923,2914,2264,2232,32,2,648,608,40,2009,1089,67,69,341,443
"2021","South Lakeland 002","E02004016",6760,4196,3242,3226,16,12,942,904,38,2564,1497,74,83,446,464
"2021","South Lakeland 003","E02004017",7439,4532,3343,3321,22,5,1184,1134,50,2907,1706,49,131,532,489
"2021","South Lakeland 004","E02004018",6821,3740,2616,2596,20,4,1120,1082,38,3081,1883,73,142,613,370
"2021","South Lakeland 005","E02004019",6618,4496,3659,3639,20,5,832,808,24,2122,1214,50,69,353,436
"2021","South Lakeland 006","E02004020",7359,4764,3722,3700,22,8,1034,1014,20,2595,1470,42,91,529,463
"2021","South Lakeland 007","E02004021",4591,3218,2558,2546,12,6,654,640,14,1373,728,48,60,252,285
"2021","South Lakeland 008","E02004022",4782,3326,2658,2638,20,6,662,648,14,1456,800,42,62,231,321
"2021","South Lakeland 009","E02004023",4893,3162,2655,2649,6,7,500,476,24,1731,863,47,69,336,416
"2021","South Lakeland 010","E02004024",6341,4522,3795,3777,18,3,724,696,28,1819,966,38,77,306,432
"2021","South Lakeland 011","E02004025",6635,4444,3596,3572,24,2,846,826,20,2191,1093,45,92,405,556
"2021","South Lakeland 012","E02004026",6775,3902,2892,2862,30,0,1010,988,22,2873,1674,44,130,580,445
"2021","South Lakeland 013","E02004027",6895,4572,3755,3721,34,1,816,788,28,2323,1072,64,75,450,662
"2021","South Lakeland 014","E02004028",6736,4636,3882,3862,20,6,748,720,28,2100,1089,40,64,388,519
"2021","Burnley 001","E02005176",7248,4425,3350,3340,10,11,1064,1028,36,2823,1687,70,138,485,443
"2021","Burnley 002","E02005177",5065,2698,2059,2048,11,4,635,589,46,2367,1447,143,116,363,298
"2021","Burnley 003","E02005178",8492,4197,3596,3592,4,7,594,572,22,4295,2797,468,212,434,384
"2021","Burnley 004","E02005179",7353,3861,2542,2532,10,2,1317,1256,61,3492,2117,40,229,663,443
"2021","Burnley 005","E02005180",5781,3802,2914,2904,10,6,882,864,18,1979,1139,34,91,345,370
"2021","Burnley 006","E02005181",5303,2777,1790,1776,14,0,987,950,37,2526,1528,44,128,508,318
"2021","Burnley 007","E02005182",4889,2251,1480,1472,8,3,768,734,34,2638,1597,95,147,473,326
"2021","Burnley 008","E02005183",5021,2747,2001,1990,11,4,742,722,20,2274,1298,38,121,431,386
"2021","Burnley 009","E02005184",4379,2987,2378,2368,10,0,609,591,18,1392,772,23,56,238,303
"2021","Burnley 010","E02005185",7300,3506,2139,2127,12,1,1366,1320,46,3794,2472,73,199,665,385
"2021","Burnley 011","E02005186",5075,3302,2459,2439,20,1,842,810,32,1773,1097,20,87,301,268
"2021","Burnley 014","E02006881",8407,4715,3346,3325,21,11,1358,1304,54,3692,2344,79,192,581,496
"2021","Chorley 001","E02005189",4154,2236,1591,1579,12,1,644,622,22,1918,1128,24,99,413,254
"2021","Chorley 002","E02005190",5106,3454,2738,2720,18,6,710,676,34,1652,932,37,77,319,287
"2021","Chorley 003","E02005191",7903,5391,4223,4195,28,11,1157,1114,43,2512,1500,59,120,446,387
"2021","Chorley 004","E02005192",7090,4712,3602,3592,10,2,1108,1054,54,2378,1471,37,114,434,322
"2021","Chorley 005","E02005193",7165,4891,3902,3876,26,8,981,950,31,2274,1285,41,113,410,425
"2021","Chorley 006","E02005194",6516,3880,2749,2735,14,1,1130,1092,38,2636,1614,37,118,461,406
"2021","Chorley 007","E02005195",4972,3350,2741,2735,6,3,606,584,22,1622,907,31,69,322,293
"2021","Chorley 008","E02005196",8794,5724,4262,4232,30,8,1454,1402,52,3070,1799,44,166,577,484
"2021","Chorley 009","E02005197",5745,3186,2177,2165,12,5,1004,968,36,2559,1558,54,117,530,300
"2021","Chorley 010","E02005198",7805,4490,3220,3194,26,0,1270,1214,56,3315,2047,68,145,618,437
"2021","Chorley 011","E02005199",6336,4311,3594,3584,10,2,715,692,23,2025,1112,46,92,331,444
"2021","Chorley 012","E02005200",7113,4156,2886,2872,14,8,1262,1190,72,2957,1881,34,137,601,304
"2021","Chorley 013","E02005201",6696,4202,3064,3046,18,2,1136,1104,32,2494,1523,49,110,434,378
"2021","Chorley 014","E02005202",8287,5404,4223,4181,42,5,1176,1130,46,2883,1681,38,137,523,504
"2021","Fylde 001","E02005203",6899,4785,3785,3752,33,12,988,954,34,2114,1179,56,104,394,381
"2021","Fylde 002","E02005204",10235,6420,4746,4708,38,8,1666,1618,48,3815,2205,73,192,743,602
"2021","Fylde 003","E02005205",5166,3401,2710,2699,11,3,688,658,30,1765,1008,46,69,332,310
"2021","Fylde 004","E02005206",6235,3632,2738,2696,42,4,890,852,38,2603,1422,42,108,580,451
"2021","Fylde 005","E02005207",7253,4643,3793,3761,32,5,845,804,41,2610,1340,51,122,515,582
"2021","Fylde 006","E02005208",8520,4402,3385,3327,58,9,1008,950,58,4118,2213,102,200,857,746
"2021","Fylde 007","E02005209",7335,4708,3562,3528,34,4,1142,1088,54,2627,1409,33,121,556,508
"2021","Fylde 008","E02005210",8706,5394,4538,4510,28,6,850,806,44,3312,1517,74,133,750,838
"2021","Fylde 009","E02005211",7324,4446,3624,3606,18,6,816,782,34,2878,1443,59,126,635,615
"2021","Hyndburn 001","E02005212",8955,5096,3743,3727,16,4,1349,1286,63,3859,2264,92,219,668,616
"2021","Hyndburn 002","E02005213",9070,5474,4048,4022,26,8,1418,1386,32,3596,2269,46,201,630,450
"2021","Hyndburn 003","E02005214",5441,3100,2206,2192,14,0,894,862,32,2341,1420,36,134,395,356
"2021","Hyndburn 004","E02005215",9886,5165,3500,3466,34,9,1656,1594,62,4721,2861,137,282,848,593
"2021","Hyndburn 005","E02005216",4211,2320,1572,1564,8,4,744,714,30,1891,1146,43,98,326,278
"2021","Hyndburn 006","E02005217",9398,4781,3867,3855,12,8,906,868,38,4617,3042,335,283,533,424
"2021","Hyndburn 007","E02005218",5797,3195,2133,2125,8,0,1062,1040,22,2602,1516,49,158,491,388
"2021","Hyndburn 008","E02005219",7106,4202,3081,3065,16,5,1116,1082,34,2904,1795,58,144,496,411
"2021","Hyndburn 009","E02005220",5014,3173,2370,2355,15,3,800,772,28,1841,1016,50,75,336,364
"2021","Lancaster 001","E02005221",8288,5450,4271,4231,40,13,1166,1122,44,2838,1487,45,130,595,581
"2021","Lancaster 002","E02005222",5071,3506,2957,2943,14,3,546,516,30,1565,820,47,91,250,357
"2021","Lancaster 003","E02005223",6186,4246,3532,3518,14,0,714,690,24,1940,1030,34,70,315,491
"2021","Lancaster 004","E02005224",4378,2641,2179,2165,14,1,461,446,15,1737,792,39,68,365,473
"2021","Lancaster 005","E02005225",4988,3330,2614,2600,14,0,716,682,34,1658,921,37,64,274,362
"2021","Lancaster 006","E02005226",5733,2728,1798,1782,16,0,930,888,42,3005,1813,46,189,590,367
"2021","Lancaster 008","E02005228",4538,2698,1900,1888,12,2,796,770,26,1840,1080,38,92,351,279
"2021","Lancaster 009","E02005229",4500,2042,1307,1295,12,5,730,694,36,2458,1517,36,169,540,196
"2021","Lancaster 010","E02005230",5439,2922,2153,2141,12,13,756,724,32,2517,1353,55,162,517,430
"2021","Lancaster 011","E02005231",6658,3431,2297,2273,24,2,1132,1078,54,3227,2121,66,156,546,338
"2021","Lancaster 013","E02005233",5999,3520,2545,2515,30,3,972,940,32,2479,1640,48,105,422,264
"2021","Lancaster 014","E02005234",6708,2240,1312,1278,34,4,924,852,72,4468,3606,115,140,412,195
"2021","Lancaster 015","E02005235",4450,1610,978,964,14,2,630,572,58,2840,2341,73,57,238,131
"2021","Lancaster 016","E02005236",10826,6868,5190,5136,54,12,1666,1606,60,3958,2269,75,206,701,707
"2021","Lancaster 017","E02005237",8225,4736,3450,3414,36,4,1282,1200,82,3489,2400,97,143,474,375
"2021","Lancaster 018","E02005238",4536,2618,2008,1980,28,4,606,570,36,1918,1224,52,65,271,306
"2021","Lancaster 019","E02005239",5255,3470,2756,2734,22,2,712,696,16,1785,1061,54,65,275,330
"2021","Lancaster 020","E02006871",9915,6130,4609,4587,22,6,1515,1479,36,3785,2177,75,158,671,704
"2021","Pendle 001","E02005240",4459,2790,1969,1959,10,7,814,790,24,1669,944,28,96,312,289
"2021","Pendle 002","E02005241",4616,2832,2082,2072,10,0,750,732,18,1784,1024,47,91,349,273
"2021","Pendle 003","E02005242",5109,3272,2395,2387,8,5,872,860,12,1837,1016,19,109,353,340
"2021","Pendle 006","E02005245",5777,3936,2946,2932,14,8,982,946,36,1841,1033,34,91,329,354
"2021","Pendle 007","E02005246",4307,2288,1470,1460,10,4,814,778,36,2019,1293,42,101,375,208
"2021","Pendle 008","E02005247",8311,5509,4327,4310,17,4,1178,1126,52,2802,1500,71,132,547,552
"2021","Pendle 009","E02005248",5628,2756,2310,2304,6,0,446,430,16,2872,1696,275,177,434,290
"2021","Pendle 010","E02005249",7737,3958,3081,3069,12,7,870,838,32,3779,2308,312,178,579,402
"2021","Pendle 011","E02005250",6838,3609,3198,3190,8,5,406,382,24,3229,1970,410,155,349,345
"2021","Pendle 012","E02005251",5514,3266,2624,2606,18,2,640,614,26,2248,1336,165,106,313,328
"2021","Pendle 013","E02005252",7889,4532,3870,3842,28,8,654,628,26,3357,1971,355,166,415,450
"2021","Pendle 014","E02007003",8491,4762,3168,3140,28,4,1590,1536,54,3729,2276,53,189,682,529
"2021","Preston 001","E02005253",5612,3934,3138,3126,12,4,792,772,20,1678,1049,36,61,233,299
"2021","Preston 002","E02005254",7574,5420,4335,4317,18,1,1084,1048,36,2154,1340,73,77,288,376
"2021","Preston 003","E02005255",7673,4994,4172,4158,14,6,816,786,30,2679,1554,85,111,407,522
"2021","Preston 004","E02005256",5404,3344,2694,2672,22,4,646,616,30,2060,1260,59,80,371,290
"2021","Preston 005","E02005257",4552,2184,1478,1470,8,4,702,672,30,2368,1431,44,113,487,293
"2021","Preston 006","E02005258",6643,3922,3384,3374,10,0,538,510,28,2721,1628,149,104,381,459
"2021","Preston 007","E02005259",7867,4170,3155,3147,8,7,1008,982,26,3697,2386,93,161,551,506
"2021","Preston 008","E02005260",5472,3398,2686,2675,11,5,707,671,36,2074,1227,32,74,321,420
"2021","Preston 009","E02005261",7613,3794,2614,2606,8,10,1170,1140,30,3819,2620,99,168,555,377
"2021","Preston 010","E02005262",5938,3672,2602,2582,20,4,1066,1022,44,2266,1502,55,110,383,216
"2021","Preston 011","E02005263",5635,2597,1947,1935,12,3,647,592,55,3038,2255,161,99,309,214
"2021","Preston 012","E02005264",8610,3786,2244,2224,20,4,1538,1436,102,4824,3484,142,185,698,315
"2021","Preston 013","E02005265",8593,4665,3187,3165,22,7,1471,1393,78,3928,2548,75,189,641,475
"2021","Preston 014","E02005266",6292,2980,2095,2093,2,1,884,850,34,3312,2264,194,169,441,244
"2021","Preston 015","E02005267",4025,1829,1460,1456,4,0,369,345,24,2196,1581,139,81,215,180
"2021","Preston 016","E02005268",6997,3688,2862,2858,4,6,820,794,26,3309,2204,157,155,415,378
"2021","Preston 017","E02005269",8197,3257,2007,1985,22,6,1244,1146,98,4940,3752,170,169,556,293
"2021","Ribble Valley 001","E02005270",6077,4225,3500,3492,8,2,723,700,23,1852,1023,38,86,329,376
"2021","Ribble Valley 002","E02005271",6653,4144,3147,3141,6,3,994,950,44,2509,1386,44,120,484,475
"2021","Ribble Valley 003","E02005272",7214,4334,3146,3126,20,6,1182,1164,18,2880,1641,54,138,588,459
"2021","Ribble Valley 004","E02005273",4991,3338,2666,2656,10,0,672,646,26,1653,933,32,82,252,354
"2021","Ribble Valley 005","E02005274",6503,4423,3575,3551,24,0,848,818,30,2080,1182,36,93,412,357
"2021","Ribble Valley 006","E02005275",4705,2968,2240,2234,6,4,724,706,18,1737,993,33,76,333,302
"2021","Ribble Valley 007","E02005276",7275,4808,3910,3896,14,6,892,870,22,2467,1373,54,111,433,496
"2021","Ribble Valley 008","E02005277",7248,4966,4244,4230,14,2,720,704,16,2282,1281,60,87,334,520
"2021","Rossendale 001","E02005278",6342,4218,3210,3174,36,4,1004,970,34,2124,1248,34,102,384,356
"2021","Rossendale 002","E02005279",8083,4600,3342,3316,26,4,1254,1206,48,3483,2155,108,194,585,441
"2021","Rossendale 003","E02005280",8682,5141,3659,3642,17,6,1476,1436,40,3541,2253,72,198,596,422
"2021","Rossendale 004","E02005281",7085,4174,3016,2972,44,4,1154,1106,48,2911,1723,67,157,516,448
"2021","Rossendale 007","E02005284",4911,3214,2497,2483,14,5,712,684,28,1697,990,33,74,295,305
"2021","Rossendale 008","E02005285",5185,3344,2502,2486,16,10,832,794,38,1841,1040,33,93,364,311
"2021","Rossendale 009","E02005286",6315,3818,2648,2628,20,6,1164,1130,34,2497,1497,36,135,441,388
"2021","Rossendale 010","E02006884",9943,5542,3819,3773,46,7,1716,1664,52,4401,2631,78,247,860,585
"2021","South Ribble 001","E02005287",4352,2958,2496,2484,12,0,462,442,20,1394,800,19,49,228,298
"2021","South Ribble 002","E02005288",4982,3239,2572,2555,17,1,666,636,30,1743,978,28,59,307,371
"2021","South Ribble 003","E02005289",4971,3298,2806,2796,10,4,488,470,18,1673,922,23,63,297,368
"2021","South Ribble 004","E02005290",5882,3808,2915,2900,15,5,888,852,36,2074,1265,35,92,372,310
"2021","South Ribble 005","E02005291",4689,2863,2108,2092,16,4,751,729,22,1826,1068,34,51,369,304
"2021","South Ribble 006","E02005292",4497,2430,1750,1746,4,0,680,656,24,2067,1199,33,101,427,307
"2021","South Ribble 007","E02005293",4420,2466,1760,1756,4,4,702,676,26,1954,1064,44,92,370,384
"2021","South Ribble 008","E02005294",5620,3428,2406,2388,18,6,1016,974,42,2192,1403,36,93,374,286
"2021","South Ribble 009","E02005295",6201,3972,2906,2876,30,4,1062,1014,48,2229,1359,36,80,375,379
"2021","South Ribble 010","E02005296",5038,3448,2874,2856,18,4,570,550,20,1590,871,38,60,258,363
"2021","South Ribble 011","E02005297",7010,4610,3745,3731,14,9,856,814,42,2400,1309,38,105,420,528
"2021","South Ribble 012","E02005298",6799,4521,3304,3282,22,2,1215,1175,40,2278,1317,37,93,418,413
"2021","South Ribble 013","E02005299",6012,3486,2366,2344,22,11,1109,1047,62,2526,1529,39,129,520,309
"2021","South Ribble 014","E02005300",4084,2652,2078,2070,8,0,574,536,38,1432,865,15,78,255,219
"2021","South Ribble 015","E02005301",5050,2804,2036,2024,12,0,768,728,40,2246,1292,20,98,460,376
"2021","South Ribble 016","E02005302",6211,4122,3250,3216,34,2,870,832,38,2089,1167,39,100,382,401
"2021","South Ribble 017","E02005303",4916,2626,1774,1766,8,0,852,816,36,2290,1390,26,129,444,301
"2021","West Lancashire 001","E02005304",7547,5032,4073,4060,13,8,951,926,25,2515,1447,54,84,456,474
"2021","West Lancashire 002","E02005305",6730,4392,3547,3527,20,9,836,806,30,2338,1323,61,88,455,411
"2021","West Lancashire 003","E02005306",6362,4144,3330,3310,20,4,810,778,32,2218,1247,34,77,402,458
"2021","West Lancashire 004","E02005307",7827,4912,3740,3715,25,4,1168,1118,50,2915,1740,63,118,504,490
"2021","West Lancashire 005","E02005308",5449,3704,3079,3071,8,5,620,602,18,1745,969,28,64,301,383
"2021","West Lancashire 006","E02005309",7344,4529,3543,3533,10,5,981,955,26,2815,1773,35,89,389,529
"2021","West Lancashire 007","E02005310",6774,3009,2278,2272,6,6,725,692,33,3765,2705,50,83,479,448
"2021","West Lancashire 008","E02005311",4755,3202,2578,2560,18,6,618,592,26,1553,904,39,40,225,345
"2021","West Lancashire 009","E02005312",5303,3304,2460,2446,14,6,838,806,32,1999,1232,39,106,326,296
"2021","West Lancashire 010","E02005313",6771,3340,2221,2209,12,11,1108,1070,38,3431,2271,63,178,575,344
"2021","West Lancashire 011","E02005314",5251,2718,1866,1856,10,12,840,824,16,2533,1559,60,120,456,338
"2021","West Lancashire 012","E02005315",6652,4402,3846,3828,18,4,552,536,16,2250,1280,50,63,315,542
"2021","West Lancashire 013","E02005316",5066,2663,1806,1800,6,4,853,829,24,2403,1633,36,103,364,267
"2021","West Lancashire 014","E02005317",5647,2606,1615,1612,3,3,988,960,28,3041,2060,68,145,460,308
"2021","West Lancashire 015","E02005318",6271,3976,3212,3194,18,2,762,750,12,2295,1373,50,95,360,417
"2021","Wyre 001","E02005319",6720,3196,2090,2070,20,4,1102,1056,46,3524,2032,52,172,778,490
"2021","Wyre 002","E02005320",4603,2758,2125,2105,20,6,627,600,27,1845,1103,19,83,304,336
"2021","Wyre 003","E02005321",4790,2811,2098,2090,8,2,711,685,26,1979,1139,33,75,291,441
"2021","Wyre 004","E02005322",8753,5644,4532,4508,24,6,1106,1048,58,3109,1477,90,139,587,816
"2021","Wyre 005","E02005323",6048,3458,2577,2549,28,5,876,838,38,2590,1527,32,135,488,408
"2021","Wyre 006","E02005324",5650,3824,3085,3065,20,1,738,714,24,1826,1082,27,80,331,306
"2021","Wyre 007","E02005325",7969,5224,4277,4257,20,5,942,908,34,2745,1330,50,120,484,761
"2021","Wyre 008","E02005326",7140,4015,3048,3018,30,7,960,906,54,3125,1593,62,131,675,664
"2021","Wyre 009","E02005327",5571,3829,3053,3023,30,2,774,746,28,1742,980,51,58,299,354
"2021","Wyre 010","E02005328",6538,4290,3469,3437,32,5,816,792,24,2248,1074,54,102,436,582
"2021","Wyre 011","E02005329",7534,4392,3152,3092,60,2,1238,1184,54,3142,1717,59,149,669,548
"2021","Wyre 012","E02005330",7495,5004,4080,4036,44,10,914,894,20,2491,1276,42,88,502,583
"2021","Wyre 013","E02005331",6880,4064,3140,3104,36,4,920,880,40,2816,1433,44,125,664,550
"2021","Wyre 014","E02005332",7120,4631,3702,3678,24,1,928,894,34,2489,1312,49,86,429,613
"2021","Bolton 001","E02000984",6372,4374,3544,3522,22,4,826,800,26,1998,1220,51,90,303,334
"2021","Bolton 002","E02000985",6211,4118,3370,3352,18,4,744,712,32,2093,1196,32,75,344,446
"2021","Bolton 003","E02000986",6837,4202,3220,3208,12,2,980,945,35,2635,1496,73,124,494,448
"2021","Bolton 004","E02000987",6024,3274,2226,2201,25,2,1046,1006,40,2750,1612,48,127,565,398
"2021","Bolton 005","E02000988",7042,3734,2918,2904,14,4,812,776,36,3308,2104,121,145,499,439
"2021","Bolton 006","E02000989",7075,4644,3699,3679,20,9,936,906,30,2431,1267,43,96,402,623
"2021","Bolton 007","E02000990",6915,4371,3224,3205,19,3,1144,1092,52,2544,1566,48,127,423,380
"2021","Bolton 008","E02000991",6207,3832,2936,2922,14,4,892,844,48,2375,1449,78,118,372,358
"2021","Bolton 009","E02000992",5158,3308,2458,2444,14,2,848,816,32,1850,1043,28,79,346,354
"2021","Bolton 010","E02000993",6246,3058,1973,1965,8,9,1076,1034,42,3188,2121,46,142,579,300
"2021","Bolton 011","E02000994",6643,3309,2699,2691,8,7,603,544,59,3334,2108,241,162,507,316
"2021","Bolton 012","E02000995",6475,3786,2981,2961,20,7,798,770,28,2689,1633,57,105,497,397
"2021","Bolton 013","E02000996",6226,3043,1975,1966,9,12,1056,1008,48,3183,2152,43,143,517,328
"2021","Bolton 014","E02000997",5192,3257,2530,2516,14,2,725,698,27,1935,1150,46,94,347,298
"2021","Bolton 015","E02000998",7680,3794,3104,3092,12,6,684,650,34,3886,2620,276,181,483,326
"2021","Bolton 016","E02000999",6252,2583,2005,1997,8,6,572,522,50,3669,2376,187,181,562,363
"2021","Bolton 017","E02001000",7254,3752,2569,2553,16,9,1174,1112,62,3502,2134,156,175,572,465
"2021","Bolton 018","E02001001",6528,3758,3072,3064,8,0,686,646,40,2770,1723,177,150,389,331
"2021","Bolton 019","E02001002",7670,4380,3199,3175,24,5,1176,1138,38,3290,2101,59,153,538,439
"2021","Bolton 020","E02001003",6003,3917,3478,3466,12,11,428,410,18,2086,1208,147,77,242,412
"2021","Bolton 021","E02001004",6764,3339,2919,2917,2,5,415,386,29,3425,2214,274,140,421,376
"2021","Bolton 022","E02001005",7081,3674,2934,2920,14,4,736,678,58,3407,2214,333,133,372,355
"2021","Bolton 023","E02001006",6173,3435,3006,3004,2,4,425,416,9,2738,1854,197,107,296,284
"2021","Bolton 024","E02001007",8333,4961,3854,3840,14,7,1100,1074,26,3372,1899,48,185,588,652
"2021","Bolton 025","E02001008",6271,3272,2864,2858,6,2,406,390,16,2999,2007,178,149,360,305
"2021","Bolton 026","E02001009",5668,3157,2520,2511,9,3,634,608,26,2511,1561,102,121,395,332
"2021","Bolton 027","E02001010",4865,2552,1808,1798,10,4,740,712,28,2313,1513,119,120,323,238
"2021","Bolton 028","E02001011",8087,5262,4065,4043,22,3,1194,1150,44,2825,1600,60,137,561,467
"2021","Bolton 029","E02001012",7074,4070,3377,3365,12,1,692,670,22,3004,2001,152,122,369,360
"2021","Bolton 030","E02001013",4950,3206,2615,2611,4,7,584,574,10,1744,1010,65,90,247,332
"2021","Bolton 031","E02001014",6846,3858,2715,2687,28,5,1138,1094,44,2988,1785,55,136,619,393
"2021","Bolton 032","E02001015",6559,3217,2056,2026,30,8,1153,1102,51,3342,1929,66,199,683,465
"2021","Bolton 033","E02001016",6499,3327,2212,2190,22,6,1109,1082,27,3172,2166,74,167,439,326
"2021","Bolton 034","E02001017",8679,4941,3372,3349,23,15,1554,1516,38,3738,2326,62,168,620,562
"2021","Bolton 035","E02001018",6242,4098,3151,3137,14,1,946,918,28,2144,1349,46,97,368,284
"2021","Bury 001","E02001019",7291,4390,3144,3130,14,6,1240,1196,44,2901,1700,45,142,604,410
"2021","Bury 002","E02001020",4956,3406,2935,2929,6,3,468,458,10,1550,864,27,43,221,395
"2021","Bury 003","E02001021",6173,4119,3365,3337,28,8,746,720,26,2054,1211,31,99,360,353
"2021","Bury 004","E02001022",6446,3763,2854,2820,34,4,905,862,43,2683,1578,96,127,433,449
"2021","Bury 005","E02001023",4549,2794,2245,2236,9,3,546,526,20,1755,1055,51,79,279,291
"2021","Bury 006","E02001024",6558,4226,3239,3225,14,5,982,954,28,2332,1401,29,108,409,385
"2021","Bury 007","E02001025",6199,3178,2267,2247,20,13,898,850,48,3021,1951,113,156,489,312
"2021","Bury 008","E02001026",8513,4276,3152,3138,14,6,1118,1030,88,4237,2737,339,221,583,357
"2021","Bury 009","E02001027",5621,3002,1982,1964,18,2,1018,970,48,2619,1666,47,121,516,269
"2021","Bury 010","E02001028",6140,4226,3682,3675,7,12,532,514,18,1914,1019,47,65,281,502
"2021","Bury 011","E02001029",5932,3156,2452,2440,12,4,700,656,44,2776,1728,188,135,415,310
"2021","Bury 012","E02001030",5103,3355,2598,2585,13,9,748,718,30,1748,1139,35,62,269,243
"2021","Bury 013","E02001031",5471,2980,2272,2254,18,4,704,682,22,2491,1494,90,129,438,340
"2021","Bury 014","E02001032",6150,3632,2587,2567,20,7,1038,1004,34,2518,1547,30,107,435,399
"2021","Bury 015","E02001033",4848,2676,1764,1748,16,0,912,886,26,2172,1340,63,143,408,218
"2021","Bury 016","E02001034",6740,3022,1925,1911,14,3,1094,1040,54,3718,2386,75,203,682,372
"2021","Bury 017","E02001035",5982,3736,3062,3052,10,0,674,646,28,2246,1358,50,85,316,437
"2021","Bury 018","E02001036",5873,3402,2374,2352,22,7,1021,978,43,2471,1596,41,146,411,277
"2021","Bury 019","E02001037",5865,3888,3200,3192,8,6,682,638,44,1977,1160,46,74,300,397
"2021","Bury 020","E02001038",4691,2499,1747,1728,19,2,750,682,68,2192,1313,45,98,429,307
"2021","Bury 021","E02001039",6588,3406,2341,2325,16,7,1058,994,64,3182,2100,67,159,470,386
"2021","Bury 022","E02001040",5066,3150,2376,2340,36,2,772,728,44,1916,1170,38,94,302,312
"2021","Bury 023","E02001041",6280,3431,2219,2187,32,2,1210,1120,90,2849,1780,75,140,451,403
"2021","Bury 024","E02001042",5290,3088,2408,2372,36,4,676,612,64,2202,1392,55,82,370,303
"2021","Bury 025","E02001043",4468,2554,1832,1808,24,8,714,672,42,1914,1228,56,88,305,237
"2021","Bury 026","E02001044",6368,3910,3502,3490,12,8,400,368,32,2458,1711,137,68,267,275
"2021","Manchester 001","E02001045",6443,2798,1921,1895,26,5,872,826,46,3645,2430,91,196,533,395
"2021","Manchester 002","E02001046",8362,4092,2880,2836,44,2,1210,1102,108,4270,3061,143,205,536,325
"2021","Manchester 003","E02001047",8010,3642,2601,2591,10,5,1036,980,56,4368,2995,105,238,611,419
"2021","Manchester 004","E02001048",6963,3680,3033,3009,24,5,642,592,50,3283,2159,191,171,448,314
"2021","Manchester 005","E02001049",8071,4098,2930,2910,20,4,1164,1102,62,3973,2692,94,193,505,489
"2021","Manchester 006","E02001050",5854,2619,1951,1928,23,6,662,622,40,3235,2176,178,192,452,237
"2021","Manchester 007","E02001051",6743,3131,2323,2307,16,8,800,764,36,3612,2486,194,223,407,302
"2021","Manchester 008","E02001052",10408,5149,4564,4548,16,33,552,488,64,5259,3362,720,236,510,431
"2021","Manchester 009","E02001053",8392,3228,2330,2312,18,20,878,798,80,5164,3697,227,295,622,323
"2021","Manchester 011","E02001055",6960,2932,1975,1947,28,11,946,880,66,4028,2773,120,242,555,338
"2021","Manchester 012","E02001056",6405,2482,1693,1691,2,11,778,732,46,3923,2700,177,220,490,336
"2021","Manchester 015","E02001059",8770,3844,2604,2561,43,11,1229,1114,115,4926,3534,220,283,578,311
"2021","Manchester 017","E02001061",8064,3508,2473,2455,18,9,1026,976,50,4556,3102,217,250,613,374
"2021","Manchester 018","E02001062",6980,2624,2019,1997,22,11,594,544,50,4356,3306,260,190,415,185
"2021","Manchester 019","E02001063",6305,2092,1311,1255,56,13,768,664,104,4213,3485,183,118,314,113
"2021","Manchester 020","E02001064",7714,3462,2791,2783,8,11,660,586,74,4252,2904,309,200,530,309
"2021","Manchester 021","E02001065",7013,3299,2280,2276,4,4,1015,946,69,3714,2545,217,189,454,309
"2021","Manchester 022","E02001066",8099,2848,2328,2320,8,4,516,456,60,5251,4183,415,147,293,213
"2021","Manchester 023","E02001067",8110,3538,2604,2586,18,18,916,858,58,4572,3172,277,264,551,308
"2021","Manchester 024","E02001068",8366,2874,2272,2240,32,6,596,534,62,5492,3915,407,268,579,323
"2021","Manchester 025","E02001069",9157,3040,2291,2257,34,17,732,649,83,6117,4876,414,204,385,238
"2021","Manchester 026","E02001070",7590,2682,2156,2134,22,10,516,446,70,4908,3856,397,140,297,218
"2021","Manchester 028","E02001072",7231,3276,2128,2080,48,4,1144,1010,134,3955,2988,218,136,433,180
"2021","Manchester 029","E02001073",7768,4017,2598,2489,109,7,1412,1280,132,3751,2846,135,114,376,280
"2021","Manchester 030","E02001074",8909,3808,3007,2959,48,11,790,730,60,5101,3794,218,184,518,387
"2021","Manchester 031","E02001075",6907,3370,2288,2254,34,6,1076,968,108,3537,2521,285,174,348,209
"2021","Manchester 032","E02001076",8071,1722,1229,1211,18,3,490,422,68,6349,5864,133,55,165,132
"2021","Manchester 033","E02001077",6132,3254,2142,2060,82,0,1112,980,132,2878,2124,143,86,286,239
"2021","Manchester 034","E02001078",8385,4400,3478,3426,52,4,918,848,70,3985,2782,206,161,394,442
"2021","Manchester 035","E02001079",7668,2645,1878,1861,17,3,764,708,56,5023,4015,193,137,386,292
"2021","Manchester 036","E02001080",8777,2188,1318,1306,12,6,864,776,88,6589,5905,103,98,264,219
"2021","Manchester 037","E02001081",5137,2991,1889,1806,83,4,1098,986,112,2146,1540,37,79,278,212
"2021","Manchester 038","E02001082",5814,2459,1430,1394,36,2,1027,952,75,3355,2888,73,74,199,121
"2021","Manchester 039","E02001083",7068,3484,1579,1541,38,3,1902,1790,112,3584,3017,59,83,315,110
"2021","Manchester 040","E02001084",7206,3055,2148,2088,60,0,907,846,61,4151,3414,77,103,310,247
"2021","Manchester 041","E02001085",6618,2945,2176,2160,16,8,761,744,17,3673,2625,109,182,435,322
"2021","Manchester 042","E02001086",5428,2600,1550,1510,40,6,1044,988,56,2828,2055,93,118,340,222
"2021","Manchester 043","E02001087",7734,4632,3087,3039,48,1,1544,1446,98,3102,2203,79,91,392,337
"2021","Manchester 044","E02001088",6860,3350,2246,2228,18,12,1092,1054,38,3510,2411,86,165,515,333
"2021","Manchester 045","E02001089",6498,3934,2913,2877,36,7,1014,944,70,2564,1778,84,74,303,325
"2021","Manchester 046","E02001090",5783,3145,2186,2152,34,1,958,916,42,2638,1719,90,117,390,322
"2021","Manchester 047","E02001091",6781,3498,2397,2375,22,3,1098,1046,52,3283,2109,70,127,602,375
"2021","Manchester 048","E02001092",7063,3358,2338,2322,16,4,1016,940,76,3705,2612,110,170,491,322
"2021","Manchester 049","E02001093",7168,3350,2088,2080,8,12,1250,1190,60,3818,2709,90,218,509,292
"2021","Manchester 050","E02001094",7154,3062,1888,1878,10,18,1156,1052,104,4092,2871,131,216,557,317
"2021","Manchester 051","E02001095",6963,3120,1989,1971,18,7,1124,1054,70,3843,2628,107,152,585,371
"2021","Manchester 052","E02001096",6394,3084,2105,2087,18,3,976,928,48,3310,2304,79,136,473,318
"2021","Manchester 053","E02001097",6562,2987,1866,1850,16,7,1114,1070,44,3575,2499,68,164,542,302
"2021","Manchester 054","E02006902",6991,2764,976,904,72,4,1784,1562,222,4227,3668,136,106,240,77
"2021","Manchester 055","E02006912",8085,3262,876,766,110,0,2386,2020,366,4823,4255,104,102,233,129
"2021","Manchester 056","E02006913",6229,2782,1779,1757,22,7,996,856,140,3447,2731,248,91,226,151
"2021","Manchester 057","E02006914",3614,1276,412,366,46,2,862,756,106,2338,2097,59,40,122,20
"2021","Manchester 058","E02006915",6275,2818,2196,2170,26,11,611,550,61,3457,2502,228,174,352,201
"2021","Manchester 059","E02006916",6288,2422,762,718,44,2,1658,1464,194,3866,3349,83,118,218,98
"2021","Manchester 060","E02006917",6023,2420,732,684,48,0,1688,1460,228,3603,3247,127,47,147,35
"2021","Manchester 061","E02006983",5817,2490,1160,1100,60,6,1324,1112,212,3327,2586,137,144,293,167
"2021","Manchester 062","E02006984",5044,2140,791,749,42,5,1344,1168,176,2904,2531,50,59,181,83
"2021","Manchester 063","E02006985",6457,3192,2913,2913,0,7,272,244,28,3265,2269,434,134,249,179
"2021","Manchester 064","E02006986",4570,2245,1726,1710,16,4,515,468,47,2325,1594,211,110,262,148
"2021","Oldham 001","E02001098",4978,2987,2292,2290,2,4,691,654,37,1991,1097,37,79,324,454
"2021","Oldham 002","E02001099",4660,2525,1750,1741,9,9,766,730,36,2135,1261,40,100,414,320
"2021","Oldham 003","E02001100",4865,2960,2276,2260,16,0,684,648,36,1905,1129,42,85,316,333
"2021","Oldham 004","E02001101",4703,2928,2300,2296,4,0,628,622,6,1775,1024,38,93,282,338
"2021","Oldham 005","E02001102",4859,3002,2161,2145,16,3,838,818,20,1857,1155,38,106,297,261
"2021","Oldham 006","E02001103",4649,3004,2473,2452,21,4,527,510,17,1645,910,35,67,279,354
"2021","Oldham 007","E02001104",5611,3452,2449,2437,12,9,994,948,46,2159,1439,57,111,322,230
"2021","Oldham 008","E02001105",4929,2768,2104,2096,8,8,656,644,12,2161,1274,32,87,377,391
"2021","Oldham 009","E02001106",4918,2589,1886,1872,14,2,701,672,29,2329,1388,46,104,413,378
"2021","Oldham 010","E02001107",5219,3006,2470,2464,6,6,530,500,30,2213,1429,79,113,291,301
"2021","Oldham 011","E02001108",4263,2096,1242,1236,6,4,850,814,36,2167,1475,54,121,337,180
"2021","Oldham 012","E02001109",5999,2978,2126,2114,12,4,848,818,30,3021,1939,110,148,490,334
"2021","Oldham 013","E02001110",5380,3570,2808,2788,20,6,756,726,30,1810,983,41,89,360,337
"2021","Oldham 014","E02001111",6309,2594,1934,1925,9,6,654,624,30,3715,2518,180,229,496,292
"2021","Oldham 015","E02001112",5004,3296,2670,2656,14,2,624,602,22,1708,1079,39,73,234,283
"2021","Oldham 016","E02001113",6692,3213,2930,2926,4,11,272,270,2,3479,2435,303,141,256,344
"2021","Oldham 017","E02001114",6822,3646,2837,2829,8,9,800,772,28,3176,2045,101,154,436,440
"2021","Oldham 018","E02001115",4792,2696,1899,1893,6,5,792,760,32,2096,1264,54,101,381,296
"2021","Oldham 019","E02001116",5415,3071,2636,2632,4,10,425,402,23,2344,1491,249,140,261,203
"2021","Oldham 020","E02001117",5007,3192,2634,2622,12,2,556,544,12,1815,1025,34,69,318,369
"2021","Oldham 021","E02001118",5037,3242,2525,2517,8,1,716,710,6,1795,1057,42,75,275,346
"2021","Oldham 022","E02001119",8441,4366,4083,4083,0,15,268,252,16,4075,2650,558,302,268,297
"2021","Oldham 024","E02001121",5995,2867,2537,2531,6,11,319,306,13,3128,2058,381,167,294,228
"2021","Oldham 026","E02001123",5173,2629,1848,1832,16,3,778,740,38,2544,1688,71,147,366,272
"2021","Oldham 027","E02001124",5267,2497,1721,1715,6,3,773,736,37,2770,1858,105,145,409,253
"2021","Oldham 028","E02001125",6323,3520,2528,2514,14,4,988,958,30,2803,1817,59,118,398,411
"2021","Oldham 029","E02001126",6608,3204,2309,2293,16,3,892,850,42,3404,2241,197,178,479,309
"2021","Oldham 030","E02001127",5755,2862,2044,2032,12,4,814,778,36,2893,2010,60,154,372,297
"2021","Oldham 031","E02001128",5975,3088,2174,2168,6,10,904,854,50,2887,1855,59,141,430,402
"2021","Oldham 032","E02001129",5347,2672,1617,1600,17,7,1048,980,68,2675,1746,60,126,417,326
"2021","Oldham 033","E02001130",4891,2821,2188,2176,12,2,631,608,23,2070,1261,31,81,336,361
"2021","Oldham 034","E02001131",4416,2544,1860,1850,10,0,684,660,24,1872,1184,31,70,227,360
"2021","Oldham 036","E02007000",5225,2596,2303,2301,2,5,288,268,20,2629,1674,315,143,290,207
"2021","Oldham 037","E02007001",6106,3194,2926,2922,4,6,262,250,12,2912,1931,338,134,237,272
"2021","Rochdale 001","E02001132",5401,3040,2075,2067,8,9,956,940,16,2361,1387,43,142,448,341
"2021","Rochdale 002","E02001133",5271,3503,2534,2525,9,1,968,934,34,1768,1076,30,89,286,287
"2021","Rochdale 003","E02001134",5146,3416,2688,2672,16,8,720,702,18,1730,1017,50,103,281,279
"2021","Rochdale 004","E02001135",6044,2958,2242,2228,14,10,706,674,32,3086,1949,114,190,509,324
"2021","Rochdale 005","E02001136",7266,4260,3316,3298,18,6,938,900,38,3006,1865,109,126,471,435
"2021","Rochdale 006","E02001137",5179,3429,2642,2620,22,4,783,756,27,1750,1074,40,93,281,262
"2021","Rochdale 007","E02001138",7120,4586,3786,3768,18,0,800,780,20,2534,1451,64,111,431,477
"2021","Rochdale 008","E02001139",7508,3767,3217,3213,4,11,539,504,35,3741,2451,346,190,403,351
"2021","Rochdale 009","E02001140",6012,3170,2371,2367,4,3,796,764,32,2842,1835,138,141,424,304
"2021","Rochdale 010","E02001141",8929,4033,3292,3286,6,13,728,682,46,4896,3118,340,276,697,465
"2021","Rochdale 011","E02001142",4973,3147,2716,2710,6,2,429,418,11,1826,1037,88,69,252,380
"2021","Rochdale 012","E02001143",8442,4190,3291,3281,10,7,892,854,38,4252,2823,238,222,567,402
"2021","Rochdale 013","E02001144",5159,3024,2168,2160,8,2,854,800,54,2135,1298,30,126,387,294
"2021","Rochdale 014","E02001145",5762,3513,2615,2602,13,10,888,858,30,2249,1325,31,114,413,366
"2021","Rochdale 015","E02001146",7440,3620,3228,3224,4,4,388,370,18,3820,2459,398,184,419,360
"2021","Rochdale 016","E02001147",7748,4145,2904,2876,28,10,1231,1184,47,3603,2357,112,190,537,407
"2021","Rochdale 017","E02001148",8184,4518,3298,3280,18,2,1218,1160,58,3666,2254,114,190,595,513
"2021","Rochdale 018","E02001149",8151,4020,2595,2577,18,13,1412,1368,44,4131,2545,76,235,746,529
"2021","Rochdale 019","E02001150",6806,3674,2517,2493,24,9,1148,1100,48,3132,1989,76,164,505,398
"2021","Rochdale 020","E02001151",7974,4792,3523,3505,18,6,1263,1224,39,3182,2094,55,158,480,395
"2021","Rochdale 021","E02001152",7642,4118,2808,2792,16,8,1302,1260,42,3524,2349,72,184,515,404
"2021","Rochdale 022","E02001153",9043,4505,2879,2865,14,13,1613,1533,80,4538,2990,94,261,685,508
"2021","Rochdale 023","E02001154",8029,4300,2866,2854,12,8,1426,1382,44,3729,2431,60,202,598,438
"2021","Rochdale 024","E02001155",5804,2916,1953,1935,18,11,952,908,44,2888,1746,67,180,511,384
"2021","Rochdale 025","E02001156",8036,4974,3974,3947,27,3,997,971,26,3062,1911,68,117,412,554
"2021","Salford 001","E02001157",6297,2746,1657,1640,17,6,1083,1046,37,3551,2427,76,199,526,323
"2021","Salford 002","E02001158",4721,2284,1479,1469,10,3,802,760,42,2437,1633,47,99,384,274
"2021","Salford 003","E02001159",5843,3276,1956,1916,40,6,1314,1252,62,2567,1697,61,145,408,256
"2021","Salford 004","E02001160",5367,2902,2014,1984,30,0,888,850,38,2465,1679,35,110,359,282
"2021","Salford 005","E02001161",4864,2710,1978,1966,12,2,730,694,36,2154,1399,50,78,345,282
"2021","Salford 006","E02001162",4825,2553,1766,1757,9,5,782,762,20,2272,1442,42,102,360,326
"2021","Salford 007","E02001163",8114,4914,3399,3361,38,7,1508,1424,84,3200,2059,44,116,509,472
"2021","Salford 008","E02001164",5136,2708,1696,1674,22,2,1010,952,58,2428,1701,62,143,313,209
"2021","Salford 009","E02001165",4962,2767,1820,1789,31,1,946,918,28,2195,1448,32,71,343,301
"2021","Salford 010","E02001166",5334,3024,2744,2724,20,0,280,252,28,2310,1608,208,60,227,207
"2021","Salford 011","E02001167",5274,2738,2058,2044,14,6,674,622,52,2536,1733,117,109,318,259
"2021","Salford 012","E02001168",7759,4246,2909,2887,22,1,1336,1274,62,3513,2288,68,162,535,460
"2021","Salford 013","E02001169",8878,5942,4701,4675,26,3,1238,1198,40,2936,1820,61,101,461,493
"2021","Salford 014","E02001170",7927,5329,4242,4204,38,0,1087,1024,63,2598,1474,49,110,412,553
"2021","Salford 015","E02001171",5052,3174,2324,2310,14,8,842,802,40,1878,1203,48,74,251,302
"2021","Salford 017","E02001173",6871,2488,1467,1431,36,1,1020,946,74,4383,3393,121,194,404,271
"2021","Salford 018","E02001174",4753,2576,1703,1683,20,5,868,774,94,2177,1553,52,88,227,257
"2021","Salford 019","E02001175",5931,3193,1991,1967,24,8,1194,1140,54,2738,1903,52,110,352,321
"2021","Salford 020","E02001176",9726,5151,3446,3391,55,13,1692,1550,142,4575,2837,133,188,779,638
"2021","Salford 021","E02001177",10704,5196,3188,3142,46,22,1986,1787,199,5508,3895,155,225,707,526
"2021","Salford 023","E02001179",5837,2406,1359,1329,30,1,1046,938,108,3431,2522,129,141,337,302
"2021","Salford 024","E02001180",4148,1576,941,931,10,5,630,564,66,2572,1784,65,129,398,196
"2021","Salford 025","E02001181",4662,2143,1355,1341,14,3,785,726,59,2519,1687,50,123,430,229
"2021","Salford 026","E02001182",5711,2746,1617,1581,36,5,1124,1040,84,2965,2042,85,140,464,234
"2021","Salford 027","E02001183",5828,2864,1657,1651,6,7,1200,1128,72,2964,2121,69,145,384,245
"2021","Salford 029","E02001185",7712,4338,3103,3089,14,3,1232,1198,34,3374,2084,50,158,561,521
"2021","Salford 030","E02001186",8265,4636,3139,3121,18,5,1492,1432,60,3629,2348,56,149,627,449
"2021","Salford 031","E02006957",5005,2350,1995,1991,4,7,348,310,38,2655,1911,159,116,314,155
"2021","Salford 032","E02006958",6002,2528,1608,1578,30,12,908,780,128,3474,2661,151,135,313,214
"2021","Salford 033","E02006959",7460,2855,869,819,50,0,1986,1716,270,4605,4149,112,96,193,55
"2021","Salford 034","E02006960",6555,2773,1138,1102,36,0,1635,1395,240,3782,3177,95,128,261,121
"2021","Salford 035","E02006961",5382,2211,1008,980,28,5,1198,1078,120,3171,2483,111,147,273,157
"2021","Salford 036","E02006962",4645,1701,659,637,22,0,1042,920,122,2944,2657,47,53,116,71
"2021","Salford 037","E02006963",5696,2726,1028,970,58,0,1698,1486,212,2970,2574,122,52,181,41
"2021","Stockport 001","E02001187",5698,3150,2187,2167,20,3,960,908,52,2548,1656,33,94,387,378
"2021","Stockport 002","E02001188",6818,3451,2055,2043,12,11,1385,1174,211,3367,2382,67,152,476,290
"2021","Stockport 003","E02001189",6787,4049,2906,2888,18,8,1135,1078,57,2738,1758,47,129,424,380
"2021","Stockport 004","E02001190",5791,2490,1427,1415,12,3,1060,978,82,3301,2468,39,133,412,249
"2021","Stockport 005","E02001191",4837,2970,2302,2286,16,4,664,634,30,1867,1117,33,68,323,326
"2021","Stockport 006","E02001192",5346,3268,2428,2388,40,6,834,782,52,2078,1337,50,101,259,331
"2021","Stockport 007","E02001193",5231,2749,1659,1634,25,2,1088,1032,56,2482,1684,40,92,422,244
"2021","Stockport 008","E02001194",5074,3243,2624,2592,32,9,610,588,22,1831,1145,54,57,269,306
"2021","Stockport 009","E02001195",6100,3688,2562,2538,24,4,1122,1082,40,2412,1478,43,113,387,391
"2021","Stockport 010","E02001196",6427,3999,3096,3086,10,6,897,869,28,2428,1421,34,107,396,470
"2021","Stockport 011","E02001197",5000,3070,2432,2406,26,8,630,582,48,1930,1214,46,70,356,244
"2021","Stockport 012","E02001198",5979,3288,2392,2370,22,10,886,846,40,2691,1598,32,112,434,515
"2021","Stockport 013","E02001199",6454,4004,3114,3074,40,6,884,828,56,2450,1496,83,116,388,367
"2021","Stockport 014","E02001200",6255,2523,1450,1422,28,5,1068,994,74,3732,2515,100,163,697,257
"2021","Stockport 015","E02001201",4630,2770,1884,1870,14,2,884,846,38,1860,1179,34,81,298,268
"2021","Stockport 016","E02001202",5264,2587,1444,1404,40,8,1135,1070,65,2677,1842,59,125,443,208
"2021","Stockport 017","E02001203",4826,3502,3008,2980,28,6,488,466,22,1324,739,30,40,218,297
"2021","Stockport 018","E02001204",7087,4287,2913,2875,38,6,1368,1288,80,2800,1855,50,116,444,335
"2021","Stockport 019","E02001205",6887,3675,2441,2418,23,14,1220,1164,56,3212,2172,57,127,558,298
"2021","Stockport 020","E02001206",5811,3692,2904,2896,8,6,782,752,30,2119,1174,46,100,373,426
"2021","Stockport 021","E02001207",5642,3634,2854,2850,4,6,774,736,38,2008,1170,25,96,340,377
"2021","Stockport 022","E02001208",6132,3500,2383,2341,42,9,1108,1062,46,2632,1664,51,105,452,360
"2021","Stockport 023","E02001209",6167,3513,2305,2273,32,7,1201,1130,71,2654,1770,36,117,469,262
"2021","Stockport 024","E02001210",5773,3062,2202,2190,12,2,858,824,34,2711,1698,37,122,486,368
"2021","Stockport 025","E02001211",5196,3400,2860,2842,18,0,540,510,30,1796,1035,60,94,292,315
"2021","Stockport 026","E02001212",5138,2592,1747,1723,24,5,840,802,38,2546,1775,44,125,389,213
"2021","Stockport 027","E02001213",7919,4838,3577,3547,30,3,1258,1218,40,3081,1821,76,135,599,450
"2021","Stockport 028","E02001214",6486,3944,3389,3383,6,9,546,508,38,2542,1497,92,105,354,494
"2021","Stockport 029","E02001215",4894,3158,2502,2494,8,4,652,626,26,1736,923,31,78,311,393
"2021","Stockport 030","E02001216",6353,4072,3370,3348,22,2,700,664,36,2281,1345,50,86,300,500
"2021","Stockport 031","E02001217",5482,3044,2132,2116,16,0,912,866,46,2438,1379,53,114,487,405
"2021","Stockport 032","E02001218",4796,3265,2796,2784,12,10,459,446,13,1531,914,35,58,235,289
"2021","Stockport 033","E02001219",4402,2956,2422,2412,10,4,530,518,12,1446,793,27,42,252,332
"2021","Stockport 034","E02001220",4525,2874,2364,2342,22,1,509,488,21,1651,943,38,69,328,273
"2021","Stockport 035","E02001221",4835,3321,2795,2785,10,8,518,502,16,1514,910,22,52,193,337
"2021","Stockport 036","E02001222",5179,3286,2822,2816,6,0,464,440,24,1893,1085,110,44,246,408
"2021","Stockport 037","E02001223",5441,3640,3126,3114,12,0,514,492,22,1801,962,56,60,324,399
"2021","Stockport 038","E02001224",4948,3394,2888,2866,22,2,504,492,12,1554,835,35,48,217,419
"2021","Stockport 039","E02001225",5914,3854,3205,3189,16,3,646,608,38,2060,1164,40,78,358,420
"2021","Stockport 040","E02001226",5621,3413,2789,2774,15,12,612,588,24,2208,1334,96,93,300,385
"2021","Stockport 041","E02001227",4580,3196,2848,2844,4,2,346,340,6,1384,719,27,39,217,382
"2021","Stockport 042","E02001228",5048,3583,3088,3072,16,2,493,477,16,1465,826,33,45,203,358
"2021","Tameside 001","E02001229",8345,5028,3398,3366,32,0,1630,1558,72,3317,2013,46,151,650,457
"2021","Tameside 002","E02001230",4887,3066,2595,2563,32,7,464,454,10,1821,1119,61,74,229,338
"2021","Tameside 003","E02001231",5575,3442,2539,2517,22,9,894,874,20,2133,1396,29,101,310,297
"2021","Tameside 004","E02001232",6694,3620,2579,2561,18,7,1034,980,54,3074,1993,96,130,470,385
"2021","Tameside 005","E02001233",6242,3362,2485,2475,10,5,872,846,26,2880,1663,91,155,478,493
"2021","Tameside 006","E02001234",6014,3053,2144,2122,22,4,905,870,35,2961,1918,106,141,465,331
"2021","Tameside 007","E02001235",5691,3280,2278,2240,38,4,998,952,46,2411,1504,91,117,408,291
"2021","Tameside 008","E02001236",4589,2234,1432,1406,26,2,800,768,32,2355,1501,53,162,352,287
"2021","Tameside 009","E02001237",5644,3203,2175,2162,13,6,1022,988,34,2441,1543,49,128,456,265
"2021","Tameside 010","E02001238",6544,3638,2603,2591,12,3,1032,992,40,2906,1788,70,131,465,452
"2021","Tameside 011","E02001239",7562,4182,2822,2772,50,2,1358,1296,62,3380,2219,62,166,504,429
"2021","Tameside 012","E02001240",5187,2910,2031,2017,14,5,874,830,44,2277,1486,57,110,336,288
"2021","Tameside 013","E02001241",8410,3599,2675,2660,15,8,916,876,40,4811,3106,309,261,702,433
"2021","Tameside 014","E02001242",5652,3554,2639,2623,16,5,910,884,26,2098,1322,59,83,264,370
"2021","Tameside 015","E02001243",6932,4162,3112,3089,23,8,1042,1002,40,2770,1650,34,161,530,395
"2021","Tameside 016","E02001244",4485,2864,2144,2132,12,8,712,688,24,1621,967,25,74,230,325
"2021","Tameside 017","E02001245",6397,3466,2316,2300,16,4,1146,1086,60,2931,1889,41,148,499,354
"2021","Tameside 018","E02001246",5839,3171,2126,2112,14,9,1036,997,39,2668,1666,40,118,460,384
"2021","Tameside 019","E02001247",5944,3258,2156,2142,14,6,1096,1057,39,2686,1671,54,130,506,325
"2021","Tameside 020","E02001248",9323,5028,3179,3133,46,9,1840,1762,78,4295,2746,74,264,721,490
"2021","Tameside 021","E02001249",5184,2754,1879,1861,18,5,870,834,36,2430,1558,42,115,397,318
"2021","Tameside 022","E02001250",5380,3463,2596,2570,26,0,867,846,21,1917,1199,28,69,315,306
"2021","Tameside 023","E02001251",5096,3060,2206,2180,26,0,854,822,32,2036,1203,34,110,353,336
"2021","Tameside 024","E02001252",6303,3870,2918,2894,24,8,944,910,34,2433,1421,48,98,358,508
"2021","Tameside 025","E02001253",4114,2308,1677,1665,12,5,626,600,26,1806,1117,48,83,312,246
"2021","Tameside 026","E02001254",4596,2532,1752,1746,6,0,780,754,26,2064,1247,24,110,342,341
"2021","Tameside 027","E02001255",5667,2800,1688,1666,22,10,1102,1038,64,2867,1915,41,140,446,325
"2021","Tameside 028","E02001256",7969,4125,3017,3000,17,14,1094,1020,74,3844,2519,158,195,523,449
"2021","Tameside 029","E02001257",7436,3841,2671,2651,20,10,1160,1116,44,3595,2040,86,196,580,693
"2021","Tameside 030","E02001258",6093,3827,2870,2852,18,4,953,890,63,2266,1309,43,91,390,433
"2021","Trafford 001","E02001259",9157,3893,2708,2661,47,9,1176,1082,94,5264,3890,231,233,556,354
"2021","Trafford 002","E02001260",6137,3914,3134,3116,18,4,776,742,34,2223,1392,36,77,368,350
"2021","Trafford 003","E02001261",6915,3596,2374,2354,20,12,1210,1110,100,3319,2395,89,140,416,279
"2021","Trafford 004","E02001262",6838,3481,2787,2737,50,6,688,620,68,3357,2343,173,121,362,358
"2021","Trafford 005","E02001263",6749,4460,3649,3635,14,1,810,790,20,2289,1343,49,78,355,464
"2021","Trafford 006","E02001264",6735,4020,3101,3071,30,5,914,866,48,2715,1822,68,94,381,350
"2021","Trafford 007","E02001265",6589,3950,3016,2994,22,12,922,894,28,2639,1607,42,109,495,386
"2021","Trafford 008","E02001266",5562,2862,2193,2175,18,7,662,626,36,2700,1763,55,128,455,299
"2021","Trafford 009","E02001267",5928,3362,2419,2389,30,13,930,876,54,2566,1514,41,116,471,424
"2021","Trafford 010","E02001268",5733,3746,3040,3016,24,12,694,658,36,1987,1160,38,65,322,402
"2021","Trafford 011","E02001269",6702,3570,2565,2519,46,3,1002,950,52,3132,2063,82,150,443,394
"2021","Trafford 012","E02001270",6626,4133,3061,3044,17,2,1070,1016,54,2493,1530,67,109,432,355
"2021","Trafford 013","E02001271",5219,3014,2271,2250,21,12,731,707,24,2205,1325,35,92,419,334
"2021","Trafford 014","E02001272",6334,4108,3296,3266,30,2,810,778,32,2226,1299,37,122,380,388
"2021","Trafford 015","E02001273",7523,4654,3573,3543,30,3,1078,1006,72,2869,1706,77,128,567,391
"2021","Trafford 016","E02001274",6418,4326,3885,3861,24,1,440,418,22,2092,1277,44,73,261,437
"2021","Trafford 017","E02001275",6142,2992,2023,2009,14,13,956,928,28,3150,2042,45,154,502,407
"2021","Trafford 018","E02001276",6228,3602,2724,2706,18,4,874,834,40,2626,1618,52,122,454,380
"2021","Trafford 019","E02001277",7073,3753,2788,2769,19,7,958,912,46,3320,2231,72,161,560,296
"2021","Trafford 020","E02001278",6687,4520,3837,3819,18,5,678,654,24,2167,1364,64,71,327,341
"2021","Trafford 021","E02001279",6501,4568,3966,3946,20,6,596,576,20,1933,1224,49,54,277,329
"2021","Trafford 022","E02001280",6549,3498,2776,2770,6,0,722,714,8,3051,1826,74,123,546,482
"2021","Trafford 023","E02001281",6177,4230,3659,3639,20,5,566,548,18,1947,1121,26,57,308,435
"2021","Trafford 024","E02001282",7781,4973,3599,3567,32,5,1369,1336,33,2808,1774,68,101,511,354
"2021","Trafford 025","E02001283",7592,4901,3890,3864,26,8,1003,936,67,2691,1621,77,123,450,420
"2021","Trafford 026","E02001284",6265,4294,3658,3618,40,12,624,594,30,1971,1227,45,76,326,297
"2021","Trafford 027","E02001285",6200,3996,3328,3314,14,4,664,628,36,2204,1277,56,87,390,394
"2021","Trafford 028","E02001286",6408,4206,3855,3845,10,6,345,326,19,2202,1279,108,76,292,447
"2021","Wigan 001","E02001287",5435,3691,2701,2672,29,2,988,966,22,1744,1075,24,63,292,290
"2021","Wigan 002","E02001288",6907,4509,3518,3498,20,6,985,951,34,2398,1415,37,103,394,449
"2021","Wigan 003","E02001289",8492,5596,4507,4489,18,3,1086,1050,36,2896,1539,55,122,525,655
"2021","Wigan 004","E02001290",5092,3177,2494,2476,18,1,682,646,36,1915,1142,25,79,306,363
"2021","Wigan 005","E02001291",6322,3706,2653,2637,16,3,1050,1012,38,2616,1634,49,124,423,386
"2021","Wigan 006","E02001292",6731,4136,3164,3150,14,0,972,928,44,2595,1553,87,121,392,442
"2021","Wigan 007","E02001293",5173,3323,2518,2507,11,3,802,772,30,1850,1126,34,72,286,332
"2021","Wigan 008","E02001294",6582,3663,2439,2424,15,2,1222,1134,88,2919,1860,74,154,464,367
"2021","Wigan 009","E02001295",5835,2666,1707,1692,15,3,956,906,50,3169,1890,66,164,673,376
"2021","Wigan 010","E02001296",6561,3164,1831,1821,10,1,1332,1286,46,3397,2282,64,157,559,335
"2021","Wigan 011","E02001297",5366,3094,2172,2156,16,2,920,880,40,2272,1395,31,108,384,354
"2021","Wigan 012","E02001298",6302,3292,2141,2133,8,11,1140,1110,30,3010,1963,51,138,501,357
"2021","Wigan 013","E02001299",7136,4185,3010,2990,20,5,1170,1106,64,2951,1855,41,146,452,457
"2021","Wigan 014","E02001300",6378,3652,2432,2418,14,8,1212,1168,44,2726,1631,54,136,467,438
"2021","Wigan 015","E02001301",7114,3806,2335,2321,14,5,1466,1392,74,3308,2048,78,168,593,421
"2021","Wigan 016","E02001302",6314,3642,2584,2582,2,2,1056,1024,32,2672,1647,37,119,404,465
"2021","Wigan 017","E02001303",6936,3660,2370,2340,30,6,1284,1218,66,3276,2150,52,195,515,364
"2021","Wigan 018","E02001304",10560,6830,5360,5333,27,12,1458,1402,56,3730,2113,52,167,625,773
"2021","Wigan 019","E02001305",7065,4617,3498,3474,24,4,1115,1069,46,2448,1459,48,71,394,476
"2021","Wigan 020","E02001306",6000,3846,3026,3014,12,0,820,798,22,2154,1313,35,83,355,368
"2021","Wigan 021","E02001307",9499,6576,5314,5304,10,0,1262,1214,48,2923,1807,44,122,453,497
"2021","Wigan 022","E02001308",4940,2958,2146,2142,4,8,804,768,36,1982,1164,32,87,365,334
"2021","Wigan 023","E02001309",6796,4013,2656,2642,14,6,1351,1290,61,2783,1617,47,143,549,427
"2021","Wigan 024","E02001310",7182,4046,2721,2699,22,5,1320,1250,70,3136,2041,61,132,517,385
"2021","Wigan 025","E02001311",6728,3898,2737,2725,12,3,1158,1108,50,2830,1721,47,129,535,398
"2021","Wigan 026","E02001312",6503,3973,2706,2682,24,3,1264,1204,60,2530,1636,41,129,395,329
"2021","Wigan 027","E02001313",6396,3555,2451,2427,24,12,1092,1044,48,2841,1784,49,140,484,384
"2021","Wigan 028","E02001314",6331,4111,3231,3219,12,5,875,856,19,2220,1403,24,95,379,319
"2021","Wigan 029","E02001315",7683,5121,3615,3586,29,5,1501,1442,59,2562,1538,53,110,432,429
"2021","Wigan 030","E02001316",5897,2952,1718,1702,16,2,1232,1158,74,2945,1879,90,182,510,284
"2021","Wigan 031","E02001317",7188,4326,3009,2999,10,3,1314,1270,44,2862,1822,51,166,449,374
"2021","Wigan 032","E02001318",6495,3812,2840,2834,6,6,966,936,30,2683,1621,39,111,425,487
"2021","Wigan 033","E02001319",6614,3647,2287,2275,12,5,1355,1298,57,2967,1820,45,144,545,413
"2021","Wigan 034","E02001320",6070,3390,2352,2340,12,4,1034,994,40,2680,1614,35,106,500,425
"2021","Wigan 035","E02001321",6536,4130,3193,3167,26,5,932,890,42,2406,1442,33,123,396,412
"2021","Wigan 036","E02001322",5967,3687,2808,2800,8,3,876,844,32,2280,1298,25,112,425,420
"2021","Wigan 037","E02001323",6342,3820,2876,2864,12,0,944,902,42,2522,1449,47,114,465,447
"2021","Wigan 038","E02001324",6641,3823,2615,2595,20,5,1203,1142,61,2818,1721,47,128,484,438
"2021","Wigan 039","E02001325",7416,4905,3679,3654,25,4,1222,1170,52,2511,1464,50,115,438,444
"2021","Wigan 040","E02001326",6698,4314,3237,3219,18,1,1076,1024,52,2384,1409,34,97,402,442
"2021","Knowsley 001","E02001327",6957,3340,2101,2079,22,13,1226,1180,46,3617,2650,45,199,393,330
"2021","Knowsley 002","E02001328",8550,4957,3484,3468,16,13,1460,1420,40,3593,2372,58,165,480,518
"2021","Knowsley 003","E02001329",5934,2509,1694,1680,14,7,808,778,30,3425,2470,54,158,410,333
"2021","Knowsley 004","E02001330",7213,3263,2215,2203,12,12,1036,990,46,3950,2798,63,197,468,424
"2021","Knowsley 005","E02001331",8120,3758,2588,2576,12,12,1158,1118,40,4362,3108,59,171,513,511
"2021","Knowsley 006","E02001332",5919,2568,1748,1726,22,0,820,778,42,3351,2295,48,165,466,377
"2021","Knowsley 007","E02001333",7594,3866,2461,2439,22,7,1398,1344,54,3728,2397,61,202,618,450
"2021","Knowsley 008","E02001334",5069,2089,1319,1307,12,7,763,728,35,2980,2140,36,153,355,296
"2021","Knowsley 009","E02001335",6673,4022,3022,3014,8,0,1000,960,40,2651,1735,60,123,384,349
"2021","Knowsley 010","E02001336",5345,2170,1447,1439,8,11,712,676,36,3175,2265,44,143,401,322
"2021","Knowsley 011","E02001337",4705,2416,1790,1784,6,2,624,600,24,2289,1554,40,85,278,332
"2021","Knowsley 012","E02001338",4864,2503,1622,1610,12,2,879,858,21,2361,1576,37,119,323,306
"2021","Knowsley 013","E02001339",5073,2526,1761,1741,20,7,758,724,34,2547,1704,29,120,350,344
"2021","Knowsley 014","E02001340",7943,4992,3696,3680,16,8,1288,1250,38,2951,1936,53,115,358,489
"2021","Knowsley 015","E02001341",5937,2710,1824,1808,16,6,880,844,36,3227,2233,47,147,429,371
"2021","Knowsley 016","E02001342",6475,4200,3302,3288,14,6,892,862,30,2275,1449,35,69,288,434
"2021","Knowsley 017","E02001343",6081,3909,3096,3069,27,5,808,758,50,2172,1423,28,89,279,353
"2021","Knowsley 018","E02001344",4487,2321,1655,1643,12,5,661,638,23,2166,1447,35,74,351,259
"2021","Knowsley 019","E02001345",4593,2752,2119,2115,4,7,626,608,18,1841,1141,38,80,237,345
"2021","Knowsley 020","E02001346",5934,2684,1834,1818,16,6,844,812,32,3250,2266,46,143,407,388
"2021","Liverpool 001","E02001347",6420,3110,2190,2174,16,10,910,884,26,3310,2291,65,162,417,375
"2021","Liverpool 002","E02001348",5472,2724,1861,1847,14,7,856,820,36,2748,1877,32,129,373,337
"2021","Liverpool 003","E02001349",6182,3310,2376,2348,28,2,932,894,38,2872,1992,44,105,381,350
"2021","Liverpool 004","E02001350",6178,2894,2049,2043,6,13,832,802,30,3284,2223,72,134,426,429
"2021","Liverpool 005","E02001351",6537,2877,1961,1946,15,10,906,862,44,3660,2573,50,152,468,417
"2021","Liverpool 006","E02001352",5178,2169,1416,1404,12,7,746,696,50,3009,2177,47,126,369,290
"2021","Liverpool 007","E02001353",5937,3447,2682,2668,14,0,765,738,27,2490,1702,49,84,323,332
"2021","Liverpool 008","E02001354",6307,2865,1975,1974,1,4,886,858,28,3442,2460,30,125,393,434
"2021","Liverpool 009","E02001355",5173,2188,1524,1514,10,2,662,622,40,2985,2034,47,146,399,359
"2021","Liverpool 010","E02001356",6543,3302,2052,2036,16,12,1238,1184,54,3241,2317,58,134,448,284
"2021","Liverpool 011","E02001357",5516,2352,1635,1633,2,7,710,690,20,3164,2270,39,140,352,363
"2021","Liverpool 012","E02001358",5532,2198,1411,1403,8,3,784,738,46,3334,2407,67,128,419,313
"2021","Liverpool 013","E02001359",4636,2558,2063,2061,2,3,492,472,20,2078,1410,35,79,249,305
"2021","Liverpool 014","E02001360",7060,2596,1678,1670,8,22,896,826,70,4464,3203,139,210,513,399
"2021","Liverpool 015","E02001361",5978,2750,2057,2051,6,7,686,660,26,3228,2215,59,141,401,412
"2021","Liverpool 016","E02001362",6212,3076,2302,2292,10,4,770,740,30,3136,2082,50,125,442,437
"2021","Liverpool 017","E02001363",6194,2747,1887,1883,4,10,850,798,52,3447,2437,43,182,407,378
"2021","Liverpool 018","E02001364",4779,2002,1272,1266,6,4,726,688,38,2777,1982,78,126,359,232
"2021","Liverpool 019","E02001365",7272,2906,1929,1911,18,5,972,922,50,4366,3157,146,215,501,347
"2021","Liverpool 020","E02001366",7132,3195,2155,2135,20,12,1028,974,54,3937,2737,103,190,552,355
"2021","Liverpool 021","E02001367",7974,4694,3740,3715,25,11,943,908,35,3280,2169,53,110,425,523
"2021","Liverpool 022","E02001368",5816,2208,1396,1382,14,10,802,754,48,3608,2633,72,140,425,338
"2021","Liverpool 023","E02001369",6331,2376,1612,1594,18,4,760,708,52,3955,2911,77,158,425,384
"2021","Liverpool 024","E02001370",5596,1976,1414,1408,6,4,558,520,38,3620,2501,138,154,509,318
"2021","Liverpool 025","E02001371",5829,2679,1841,1824,17,6,832,792,40,3150,2235,52,129,393,341
"2021","Liverpool 026","E02001372",4889,2458,1843,1835,8,3,612,580,32,2431,1586,31,94,363,357
"2021","Liverpool 027","E02001373",7252,3350,2357,2345,12,5,988,942,46,3902,2729,101,173,543,356
"2021","Liverpool 028","E02001374",6997,2596,1677,1661,16,3,916,860,56,4401,3299,185,182,504,231
"2021","Liverpool 029","E02001375",5643,2528,1788,1774,14,10,730,710,20,3115,2108,41,158,420,388
"2021","Liverpool 030","E02001376",7664,2393,1634,1622,12,14,745,707,38,5271,4253,177,176,356,309
"2021","Liverpool 031","E02001377",7726,2040,1332,1322,10,0,708,630,78,5686,4808,133,111,356,278
"2021","Liverpool 032","E02001378",6105,2839,2061,2040,21,6,772,732,40,3266,2240,48,123,489,366
"2021","Liverpool 034","E02001380",6198,3884,3044,3022,22,4,836,790,46,2314,1519,34,86,310,365
"2021","Liverpool 035","E02001381",7880,2946,2006,1988,18,8,932,856,76,4934,3804,190,166,481,293
"2021","Liverpool 036","E02001382",5631,3653,2950,2936,14,3,700,684,16,1978,1305,35,59,265,314
"2021","Liverpool 037","E02001383",6747,2014,980,948,32,4,1030,936,94,4733,3861,128,117,418,209
"2021","Liverpool 038","E02001384",9748,2038,1249,1229,20,1,788,716,72,7710,6942,89,104,311,264
"2021","Liverpool 039","E02001385",6624,2374,1849,1841,8,5,520,470,50,4250,3173,225,157,414,281
"2021","Liverpool 040","E02001386",6705,2980,2036,2024,12,10,934,902,32,3725,2339,33,170,621,562
"2021","Liverpool 041","E02001387",6387,3890,3194,3168,26,0,696,666,30,2497,1660,69,64,301,403
"2021","Liverpool 042","E02001388",5896,2792,1705,1659,46,9,1078,1010,68,3104,2477,39,89,292,207
"2021","Liverpool 043","E02001389",5644,2178,1018,1000,18,0,1160,1080,80,3466,2672,103,148,417,126
"2021","Liverpool 044","E02001390",7567,2899,1882,1852,30,13,1004,910,94,4668,3409,133,209,519,398
"2021","Liverpool 045","E02001391",4647,2015,1398,1390,8,5,612,590,22,2632,1780,31,90,337,394
"2021","Liverpool 046","E02001392",5280,3384,2698,2680,18,4,682,660,22,1896,1139,38,49,263,407
"2021","Liverpool 047","E02001393",5922,4003,3546,3524,22,4,453,415,38,1919,1280,35,38,194,372
"2021","Liverpool 048","E02001394",7394,3207,1974,1938,36,5,1228,1168,60,4187,3117,65,128,553,324
"2021","Liverpool 049","E02001395",4861,3024,2362,2318,44,2,660,626,34,1837,1177,35,57,265,303
"2021","Liverpool 050","E02001396",6528,3017,1716,1694,22,3,1298,1196,102,3511,2579,55,142,424,311
"2021","Liverpool 051","E02001397",6100,3198,2434,2418,16,10,754,732,22,2902,1653,73,133,555,488
"2021","Liverpool 052","E02001398",6104,3010,1984,1930,54,4,1022,940,82,3094,2186,70,114,409,315
"2021","Liverpool 053","E02001399",5733,3678,3082,3060,22,4,592,568,24,2055,1292,36,81,283,363
"2021","Liverpool 054","E02001400",5534,2998,2335,2317,18,7,656,640,16,2536,1692,48,105,351,340
"2021","Liverpool 055","E02001401",6604,3924,2946,2932,14,2,976,920,56,2680,1732,32,87,329,500
"2021","Liverpool 056","E02001402",7284,4402,3442,3410,32,12,948,910,38,2882,1877,58,122,417,408
"2021","Liverpool 057","E02001403",5104,2333,1473,1457,16,7,853,815,38,2771,1965,35,121,413,237
"2021","Liverpool 058","E02001404",6211,2976,1889,1875,14,3,1084,1042,42,3235,2344,44,137,401,309
"2021","Liverpool 059","E02001405",7466,3308,2043,2031,12,9,1256,1210,46,4158,2929,61,238,556,374
"2021","Liverpool 060","E02006932",5538,1809,606,586,20,0,1203,1096,107,3729,3385,105,53,144,42
"2021","Liverpool 061","E02006933",6332,2668,1068,1042,26,0,1600,1472,128,3664,3029,81,75,317,162
"2021","Liverpool 062","E02006934",5147,2013,652,624,28,2,1359,1237,122,3134,2684,85,101,223,41
"2021","St. Helens 001","E02001406",6637,4332,3578,3564,14,8,746,716,30,2305,1214,35,91,371,594
"2021","St. Helens 002","E02001407",5021,3281,2776,2766,10,3,502,482,20,1740,953,23,68,268,428
"2021","St. Helens 003","E02001408",4638,2989,2367,2354,13,6,616,590,26,1649,954,24,68,292,311
"2021","St. Helens 004","E02001409",8480,5025,3667,3643,24,0,1358,1306,52,3455,2088,48,157,618,544
"2021","St. Helens 005","E02001410",4657,2712,1958,1946,12,3,751,717,34,1945,1176,29,101,312,327
"2021","St. Helens 006","E02001411",4792,2878,2188,2176,12,2,688,666,22,1914,1104,32,67,310,401
"2021","St. Helens 007","E02001412",7321,4354,3424,3396,28,5,925,882,43,2967,1857,41,132,467,470
"2021","St. Helens 008","E02001413",7738,4661,3531,3515,16,10,1120,1084,36,3077,1869,42,116,509,541
"2021","St. Helens 009","E02001414",4609,3148,2735,2733,2,1,412,392,20,1461,814,30,54,176,387
"2021","St. Helens 010","E02001415",5485,3264,2241,2211,30,0,1023,982,41,2221,1431,34,98,362,296
"2021","St. Helens 011","E02001416",4960,2590,1670,1654,16,4,916,892,24,2370,1530,43,120,394,283
"2021","St. Helens 012","E02001417",6063,2538,1553,1527,26,11,974,914,60,3525,2230,55,193,693,354
"2021","St. Helens 013","E02001418",5333,2992,1786,1754,32,4,1202,1134,68,2341,1445,35,129,409,323
"2021","St. Helens 014","E02001419",6061,2798,1556,1532,24,8,1234,1174,60,3263,2101,68,189,574,331
"2021","St. Helens 015","E02001420",9421,5707,3895,3857,38,13,1799,1739,60,3714,2290,51,197,639,537
"2021","St. Helens 016","E02001421",8732,4716,3226,3196,30,10,1480,1414,66,4016,2538,67,202,669,540
"2021","St. Helens 017","E02001422",5107,2641,1693,1676,17,4,944,898,46,2466,1624,45,127,390,280
"2021","St. Helens 018","E02001423",5519,3544,2932,2924,8,4,608,586,22,1975,1202,26,75,285,387
"2021","St. Helens 020","E02001425",8864,5204,3842,3805,37,3,1359,1298,61,3660,2258,64,173,575,590
"2021","St. Helens 021","E02001426",4494,2652,2012,2004,8,8,632,610,22,1842,1044,27,82,320,369
"2021","St. Helens 022","E02001427",8704,4928,3559,3533,26,5,1364,1302,62,3776,2368,58,174,662,514
"2021","St. Helens 023","E02001428",4682,2930,2530,2522,8,2,398,384,14,1752,978,46,78,213,437
"2021","St. Helens 024","E02006935",5959,3048,2214,2204,10,4,830,816,14,2911,1818,55,160,476,402
"2021","St. Helens 025","E02006936",6077,3762,2634,2612,22,6,1122,1052,70,2315,1427,45,134,362,347
"2021","Sefton 001","E02001429",5687,3513,2707,2695,12,5,801,778,23,2174,1119,33,82,409,531
"2021","Sefton 002","E02001430",5785,3732,3104,3088,16,0,628,610,18,2053,1131,26,71,361,464
"2021","Sefton 003","E02001431",6185,3415,2796,2784,12,1,618,584,34,2770,1221,59,98,689,703
"2021","Sefton 004","E02001432",7931,3342,2063,2041,22,3,1276,1224,52,4589,2694,106,228,1012,549
"2021","Sefton 005","E02001433",5885,3430,2483,2453,30,3,944,912,32,2455,1507,58,80,458,352
"2021","Sefton 006","E02001434",5790,3412,2554,2538,16,2,856,812,44,2378,1520,60,109,450,239
"2021","Sefton 007","E02001435",7148,3471,2307,2279,28,5,1159,1123,36,3677,2177,60,143,956,341
"2021","Sefton 008","E02001436",7685,4392,3281,3257,24,15,1096,1060,36,3293,1995,55,152,661,430
"2021","Sefton 009","E02001437",7783,4650,3864,3826,38,4,782,736,46,3133,1616,65,111,622,719
"2021","Sefton 010","E02001438",5903,3536,2750,2736,14,4,782,744,38,2367,1422,31,82,471,361
"2021","Sefton 011","E02001439",5357,2914,2171,2163,8,7,736,718,18,2443,1370,37,100,495,441
"2021","Sefton 012","E02001440",5260,3598,3110,3100,10,6,482,460,22,1662,873,48,47,218,476
"2021","Sefton 013","E02001441",5289,3644,3216,3194,22,0,428,428,0,1645,869,34,61,219,462
"2021","Sefton 014","E02001442",5007,3016,2522,2514,8,0,494,480,14,1991,1032,51,59,340,509
"2021","Sefton 015","E02001443",4718,3071,2653,2644,9,4,414,395,19,1647,940,35,47,235,390
"2021","Sefton 016","E02001444",4672,2834,2286,2268,18,0,548,526,22,1838,1039,30,60,294,415
"2021","Sefton 017","E02001445",5772,3606,2966,2958,8,6,634,602,32,2166,1204,49,85,336,492
"2021","Sefton 018","E02001446",5913,3617,2825,2813,12,6,786,770,16,2296,1326,26,72,329,543
"2021","Sefton 019","E02001447",5079,3068,2419,2409,10,7,642,616,26,2011,1144,41,59,322,445
"2021","Sefton 020","E02001448",5636,3546,2927,2915,12,1,618,604,14,2090,1251,42,65,291,441
"2021","Sefton 021","E02001449",7776,4798,3850,3828,22,10,938,918,20,2978,1821,47,93,466,551
"2021","Sefton 022","E02001450",7027,4322,3692,3678,14,2,628,612,16,2705,1579,66,108,413,539
"2021","Sefton 023","E02001451",4726,2146,1560,1548,12,4,582,562,20,2580,1675,52,105,373,375
"2021","Sefton 024","E02001452",5074,2128,1437,1429,8,7,684,660,24,2946,1837,55,137,527,390
"2021","Sefton 025","E02001453",7238,4564,3622,3602,20,10,932,898,34,2674,1652,36,87,422,477
"2021","Sefton 026","E02001454",6052,3646,2914,2908,6,0,732,696,36,2406,1503,45,78,304,476
"2021","Sefton 027","E02001455",5937,3594,2748,2738,10,4,842,816,26,2343,1525,36,72,339,371
"2021","Sefton 028","E02001456",6166,3600,2780,2756,24,8,812,784,28,2566,1562,43,107,425,429
"2021","Sefton 029","E02001457",5483,2489,1712,1704,8,8,769,750,19,2994,2068,33,120,413,360
"2021","Sefton 030","E02001458",6352,3397,2358,2333,25,1,1038,1000,38,2955,1953,41,141,518,302
"2021","Sefton 031","E02001459",5546,2931,2065,2056,9,4,862,820,42,2615,1787,34,97,347,350
"2021","Sefton 032","E02001460",6501,2766,1906,1884,22,6,854,796,58,3735,2489,105,148,561,432
"2021","Sefton 033","E02001461",5688,3270,2384,2368,16,4,882,850,32,2418,1534,47,89,319,429
"2021","Sefton 034","E02001462",6019,2458,1486,1476,10,6,966,912,54,3561,2410,33,199,584,335
"2021","Sefton 035","E02001463",5866,2897,2066,2058,8,3,828,801,27,2969,2085,31,134,352,367
"2021","Sefton 036","E02001464",5537,2282,1411,1401,10,5,866,834,32,3255,2269,61,163,447,315
"2021","Sefton 037","E02001465",6255,2273,1438,1418,20,7,828,792,36,3982,2757,68,251,600,306
"2021","Sefton 038","E02001466",7179,3400,2440,2428,12,4,956,912,44,3779,2638,63,170,519,389
"2021","Wirral 001","E02001467",6446,3247,2244,2204,40,3,1000,932,68,3199,1876,56,152,654,461
"2021","Wirral 002","E02001468",6049,3109,2180,2134,46,6,923,860,63,2940,1894,41,139,569,297
"2021","Wirral 003","E02001469",6417,3768,2969,2951,18,7,792,764,28,2649,1512,35,101,490,511
"2021","Wirral 004","E02001470",6809,4254,3328,3310,18,6,920,872,48,2555,1554,52,99,400,450
"2021","Wirral 005","E02001471",5695,2587,1744,1719,25,5,838,804,34,3108,1991,44,176,590,307
"2021","Wirral 006","E02001472",5623,3228,2401,2389,12,13,814,798,16,2395,1482,28,102,447,336
"2021","Wirral 007","E02001473",6200,3224,2278,2266,12,2,944,903,41,2976,1849,58,137,531,401
"2021","Wirral 008","E02001474",5186,2044,1263,1253,10,3,778,742,36,3142,2071,39,153,566,313
"2021","Wirral 009","E02001475",4899,2264,1514,1498,16,4,746,716,30,2635,1576,26,120,566,347
"2021","Wirral 010","E02001476",6133,2622,1652,1636,16,2,968,912,56,3511,2337,48,201,567,358
"2021","Wirral 011","E02001477",5648,2228,1338,1322,16,8,882,822,60,3420,2312,41,146,580,341
"2021","Wirral 012","E02001478",6707,3696,2780,2758,22,10,906,868,38,3011,1735,48,140,570,518
"2021","Wirral 013","E02001479",5024,3204,2648,2628,20,4,552,532,20,1820,1054,31,61,343,331
"2021","Wirral 014","E02001480",6120,3660,2923,2902,21,2,735,707,28,2460,1345,42,121,470,482
"2021","Wirral 015","E02001481",6632,3782,2814,2790,24,0,968,924,44,2850,1819,53,112,495,371
"2021","Wirral 016","E02001482",6527,2138,1280,1266,14,4,854,798,56,4389,2913,78,251,797,350
"2021","Wirral 017","E02001483",6087,3795,3004,2987,17,5,786,764,22,2292,1284,39,82,451,436
"2021","Wirral 018","E02001484",6567,3870,3069,3059,10,7,794,756,38,2697,1554,39,93,469,542
"2021","Wirral 019","E02001485",5240,2540,1839,1817,22,9,692,672,20,2700,1822,30,115,384,349
"2021","Wirral 020","E02001486",6737,3290,2452,2425,27,6,832,786,46,3447,1926,45,282,694,500
"2021","Wirral 021","E02001487",7174,2968,1841,1817,24,9,1118,1054,64,4206,2900,82,200,694,330
"2021","Wirral 022","E02001488",6751,3362,2257,2237,20,9,1096,1046,50,3389,2235,88,153,580,333
"2021","Wirral 023","E02001489",6901,4519,3893,3878,15,4,622,614,8,2382,1295,34,78,410,565
"2021","Wirral 024","E02001490",6802,4336,3378,3358,20,6,952,932,20,2466,1458,41,115,412,440
"2021","Wirral 025","E02001491",5251,2300,1538,1530,8,6,756,726,30,2951,1833,36,141,566,375
"2021","Wirral 026","E02001492",6242,3582,2802,2776,26,4,776,728,48,2660,1443,46,129,544,498
"2021","Wirral 027","E02001493",6877,2645,1535,1507,28,5,1105,1043,62,4232,2872,82,242,678,358
"2021","Wirral 028","E02001494",5865,3969,3511,3502,9,4,454,446,8,1896,1027,53,68,312,436
"2021","Wirral 029","E02001495",6334,3261,2347,2341,6,10,904,888,16,3073,1978,49,134,464,448
"2021","Wirral 030","E02001496",4973,3024,2472,2460,12,2,550,526,24,1949,1270,22,81,268,308
"2021","Wirral 031","E02001497",6397,3004,2049,2027,22,7,948,910,38,3393,2136,43,192,606,416
"2021","Wirral 032","E02001498",5901,3627,2908,2888,20,3,716,684,32,2274,1404,36,111,356,367
"2021","Wirral 033","E02001499",5513,3584,2966,2956,10,2,616,600,16,1929,999,31,79,339,481
"2021","Wirral 034","E02001500",6143,3930,3202,3176,26,0,728,710,18,2213,1215,38,93,373,494
"2021","Wirral 035","E02001501",6312,3943,3193,3175,18,0,750,716,34,2369,1429,59,89,377,415
"2021","Wirral 036","E02001502",7742,4592,3181,3153,28,5,1406,1346,60,3150,1908,53,144,564,481
"2021","Wirral 037","E02001503",6287,3642,2972,2956,16,4,666,624,42,2645,1353,41,117,561,573
"2021","Wirral 038","E02001504",5854,4012,3471,3455,16,4,537,520,17,1842,1012,31,63,257,479
"2021","Wirral 039","E02001505",5335,3020,2285,2275,10,5,730,700,30,2315,1403,45,114,394,359
"2021","Wirral 040","E02001506",7517,5295,4809,4796,13,6,480,456,24,2222,1192,42,64,312,612
"2021","Wirral 041","E02001507",5832,3886,3292,3274,18,8,586,566,20,1946,1028,39,73,297,509
"2021","Wirral 042","E02001508",6582,3868,2940,2922,18,2,926,890,36,2714,1609,40,136,448,481
"2021","Kingston upon Hull 002","E02002653",6124,2993,1929,1910,19,2,1062,1020,42,3131,2088,36,164,469,374
"2021","Kingston upon Hull 003","E02002654",5743,2688,1580,1568,12,6,1102,1076,26,3055,2138,35,144,440,298
"2021","Kingston upon Hull 004","E02002655",6472,3440,2151,2138,13,4,1285,1228,57,3032,2004,43,147,500,338
"2021","Kingston upon Hull 005","E02002656",4461,2788,2096,2080,16,4,688,666,22,1673,874,44,59,314,382
"2021","Kingston upon Hull 006","E02002657",6188,3922,2923,2899,24,9,990,958,32,2266,1284,45,117,401,419
"2021","Kingston upon Hull 007","E02002658",5500,3412,2576,2556,20,4,832,794,38,2088,1214,30,82,390,372
"2021","Kingston upon Hull 008","E02002659",8519,4165,2494,2488,6,8,1663,1612,51,4354,2838,225,177,623,491
"2021","Kingston upon Hull 009","E02002660",5502,3076,2068,2062,6,2,1006,960,46,2426,1481,34,125,381,405
"2021","Kingston upon Hull 010","E02002661",6352,3682,2469,2455,14,7,1206,1172,34,2670,1727,46,126,407,364
"2021","Kingston upon Hull 011","E02002662",5948,3292,2274,2248,26,2,1016,948,68,2656,1477,38,159,498,484
"2021","Kingston upon Hull 012","E02002663",5699,2319,1520,1508,12,0,799,742,57,3380,2878,52,55,234,161
"2021","Kingston upon Hull 013","E02002664",5955,4052,3158,3156,2,2,892,860,32,1903,1191,30,67,276,339
"2021","Kingston upon Hull 014","E02002665",6440,4039,3018,2992,26,3,1018,988,30,2401,1468,56,102,408,367
"2021","Kingston upon Hull 015","E02002666",6819,2690,1362,1352,10,4,1324,1242,82,4129,2997,205,185,554,188
"2021","Kingston upon Hull 016","E02002667",5998,3606,2320,2298,22,0,1286,1244,42,2392,1533,56,117,414,272
"2021","Kingston upon Hull 017","E02002668",6317,3102,1838,1820,18,14,1250,1204,46,3215,1993,53,147,548,474
"2021","Kingston upon Hull 018","E02002669",6765,3300,1909,1881,28,3,1388,1262,126,3465,2647,93,140,431,154
"2021","Kingston upon Hull 019","E02002670",6384,3532,2377,2355,22,3,1152,1086,66,2852,1702,47,122,551,430
"2021","Kingston upon Hull 020","E02002671",6501,3748,2438,2426,12,4,1306,1286,20,2753,1790,60,133,461,309
"2021","Kingston upon Hull 021","E02002672",5209,2651,1596,1586,10,10,1045,1017,28,2558,1740,36,148,328,306
"2021","Kingston upon Hull 022","E02002673",6018,3392,2161,2141,20,3,1228,1172,56,2626,1703,66,135,440,282
"2021","Kingston upon Hull 023","E02002674",5490,3195,1842,1833,9,3,1350,1292,58,2295,1353,39,131,440,332
"2021","Kingston upon Hull 024","E02002675",6680,3122,1831,1827,4,3,1288,1216,72,3558,2323,140,159,647,289
"2021","Kingston upon Hull 025","E02002676",5993,3128,1789,1763,26,0,1339,1256,83,2865,1932,50,152,461,270
"2021","Kingston upon Hull 026","E02002677",6823,3426,2194,2168,26,0,1232,1142,90,3397,2156,71,204,633,333
"2021","Kingston upon Hull 027","E02002678",6775,3712,2298,2260,38,8,1406,1344,62,3063,2020,78,183,511,271
"2021","Kingston upon Hull 028","E02002679",6329,3934,2814,2798,16,4,1116,1072,44,2395,1398,49,118,449,381
"2021","Kingston upon Hull 029","E02002680",7920,2972,1566,1546,20,10,1396,1230,166,4948,3393,169,260,815,311
"2021","Kingston upon Hull 030","E02002681",6925,3221,1793,1779,14,11,1417,1337,80,3704,2492,105,235,606,266
"2021","Kingston upon Hull 031","E02002682",8279,4521,2698,2680,18,14,1809,1732,77,3758,2464,76,202,636,380
"2021","Kingston upon Hull 033","E02006813",6681,3574,2430,2418,12,6,1138,1110,28,3107,1761,49,148,581,568
"2021","Kingston upon Hull 034","E02007079",6159,3628,2148,2122,26,8,1472,1408,64,2531,1865,25,113,338,190
"2021","Kingston upon Hull 035","E02007080",6371,4556,2818,2788,30,14,1724,1650,74,1815,1331,33,103,265,83
"2021","East Riding of Yorkshire 001","E02002684",8855,5928,4793,4765,28,5,1130,1076,54,2927,1357,59,103,585,823
"2021","East Riding of Yorkshire 002","E02002685",6793,4505,3643,3622,21,0,862,810,52,2288,1056,52,96,443,641
"2021","East Riding of Yorkshire 003","E02002686",6023,2973,2043,2033,10,4,926,872,54,3050,1593,43,153,677,584
"2021","East Riding of Yorkshire 004","E02002687",4769,2528,1833,1825,8,3,692,650,42,2241,1200,47,140,481,373
"2021","East Riding of Yorkshire 005","E02002688",4431,2230,1624,1614,10,4,602,578,24,2201,1182,50,147,489,333
"2021","East Riding of Yorkshire 006","E02002689",4866,3338,2701,2681,20,3,634,614,20,1528,801,39,81,282,325
"2021","East Riding of Yorkshire 008","E02002691",6946,4860,3849,3833,16,9,1002,954,48,2086,1068,34,105,390,489
"2021","East Riding of Yorkshire 009","E02002692",7433,5429,4297,4271,26,4,1128,1082,46,2004,1072,36,90,351,455
"2021","East Riding of Yorkshire 010","E02002693",6032,4206,3460,3437,23,4,742,730,12,1826,974,52,90,324,386
"2021","East Riding of Yorkshire 011","E02002694",10622,6924,5250,5220,30,6,1668,1626,42,3698,1973,74,197,748,706
"2021","East Riding of Yorkshire 012","E02002695",6870,4306,3496,3476,20,4,806,764,42,2564,1250,41,122,537,614
"2021","East Riding of Yorkshire 013","E02002696",4832,3445,2859,2838,21,4,582,552,30,1387,786,23,72,233,273
"2021","East Riding of Yorkshire 014","E02002697",6385,4445,3644,3627,17,10,791,761,30,1940,1037,42,76,357,428
"2021","East Riding of Yorkshire 015","E02002698",6967,4707,3521,3492,29,0,1186,1138,48,2260,1179,47,125,472,437
"2021","East Riding of Yorkshire 016","E02002699",8191,5638,4691,4671,20,1,946,914,32,2553,1322,49,120,465,597
"2021","East Riding of Yorkshire 017","E02002700",4775,2457,1686,1676,10,4,767,741,26,2318,1340,34,142,465,337
"2021","East Riding of Yorkshire 018","E02002701",7270,5256,4292,4272,20,14,950,904,46,2014,1104,60,92,344,414
"2021","East Riding of Yorkshire 019","E02002702",8425,4859,3575,3528,47,2,1282,1222,60,3566,1778,66,205,896,621
"2021","East Riding of Yorkshire 020","E02002703",7594,5174,4203,4185,18,5,966,944,22,2420,1379,41,103,482,415
"2021","East Riding of Yorkshire 021","E02002704",6173,4348,3563,3549,14,5,780,756,24,1825,987,32,67,318,421
"2021","East Riding of Yorkshire 022","E02002705",5883,4084,3221,3205,16,7,856,838,18,1799,947,39,70,289,454
"2021","East Riding of Yorkshire 023","E02002706",6005,3974,3102,3084,18,2,870,826,44,2031,1133,47,90,359,402
"2021","East Riding of Yorkshire 024","E02002707",5679,4002,3336,3324,12,4,662,636,26,1677,886,35,82,296,378
"2021","East Riding of Yorkshire 025","E02002708",4929,2917,2343,2334,9,2,572,558,14,2012,950,45,83,407,527
"2021","East Riding of Yorkshire 026","E02002709",6321,4258,3314,3308,6,6,938,914,24,2063,1141,36,90,359,437
"2021","East Riding of Yorkshire 027","E02002710",5975,3955,3179,3169,10,3,773,756,17,2020,1120,38,96,349,417
"2021","East Riding of Yorkshire 028","E02002711",6569,4657,3978,3958,20,6,673,652,21,1912,1006,45,63,266,532
"2021","East Riding of Yorkshire 029","E02002712",6093,3914,3069,3052,17,7,838,828,10,2179,1143,42,87,444,463
"2021","East Riding of Yorkshire 031","E02002714",6652,4622,3672,3656,16,4,946,906,40,2030,1101,52,93,333,451
"2021","East Riding of Yorkshire 032","E02002715",10774,7338,5768,5748,20,4,1566,1516,50,3436,1994,68,181,671,522
"2021","East Riding of Yorkshire 033","E02002716",7037,4600,3604,3594,10,6,990,946,44,2437,1313,53,109,457,505
"2021","East Riding of Yorkshire 034","E02002717",6514,3754,2510,2492,18,6,1238,1202,36,2760,1567,47,117,592,437
"2021","East Riding of Yorkshire 035","E02002718",6646,4673,4025,4009,16,5,643,624,19,1973,1066,49,77,334,447
"2021","East Riding of Yorkshire 036","E02002719",5362,3669,2801,2780,21,6,862,828,34,1693,1010,37,78,267,301
"2021","East Riding of Yorkshire 037","E02002720",6317,4386,3419,3400,19,4,963,938,25,1931,1088,34,85,321,403
"2021","East Riding of Yorkshire 038","E02002721",5555,3658,2847,2817,30,3,808,790,18,1897,1070,38,80,359,350
"2021","East Riding of Yorkshire 039","E02002722",6920,4268,3240,3218,22,4,1024,984,40,2652,1398,53,139,509,553
"2021","East Riding of Yorkshire 040","E02002723",6822,4036,2809,2791,18,1,1226,1198,28,2786,1618,99,121,526,422
"2021","East Riding of Yorkshire 041","E02002724",7443,4032,2591,2579,12,5,1436,1364,72,3411,2180,81,163,585,402
"2021","East Riding of Yorkshire 042","E02002725",5665,3834,3002,2996,6,2,830,798,32,1831,1036,37,89,316,353
"2021","East Riding of Yorkshire 043","E02006814",6679,4251,3116,3105,11,5,1130,1094,36,2428,1412,47,91,437,441
"2021","East Riding of Yorkshire 044","E02006891",6802,4678,3719,3697,22,7,952,900,52,2124,1161,43,94,411,415
"2021","East Riding of Yorkshire 045","E02006892",5115,2869,2050,2040,10,2,817,778,39,2246,1143,45,114,489,455
"2021","North East Lincolnshire 001","E02002726",8330,5078,3714,3690,24,14,1350,1302,48,3252,1820,88,139,625,580
"2021","North East Lincolnshire 002","E02002727",3878,1386,783,769,14,3,600,586,14,2492,1538,50,121,534,249
"2021","North East Lincolnshire 003","E02002728",5979,2772,1588,1576,12,0,1184,1140,44,3207,2026,67,195,632,287
"2021","North East Lincolnshire 004","E02002729",4632,2784,2108,2098,10,4,672,650,22,1848,1095,23,94,357,279
"2021","North East Lincolnshire 005","E02002730",5343,2596,1508,1482,26,6,1082,1034,48,2747,1772,56,179,514,226
"2021","North East Lincolnshire 006","E02002731",4189,2000,1112,1106,6,2,886,854,32,2189,1448,62,97,380,202
"2021","North East Lincolnshire 007","E02002732",6483,4514,3622,3612,10,10,882,866,16,1969,1154,37,74,315,389
"2021","North East Lincolnshire 008","E02002733",4772,2541,1704,1693,11,1,836,814,22,2231,1263,49,129,501,289
"2021","North East Lincolnshire 009","E02002734",4369,2592,1760,1746,14,2,830,804,26,1777,1032,23,97,326,299
"2021","North East Lincolnshire 011","E02002736",4239,1978,1106,1094,12,0,872,836,36,2261,1511,71,139,389,151
"2021","North East Lincolnshire 012","E02002737",5704,3568,2495,2475,20,9,1064,1032,32,2136,1306,32,96,360,342
"2021","North East Lincolnshire 013","E02002738",5598,3642,2633,2619,14,7,1002,974,28,1956,1176,30,96,341,313
"2021","North East Lincolnshire 014","E02002739",4711,2538,1665,1655,10,1,872,846,26,2173,1150,22,122,534,345
"2021","North East Lincolnshire 015","E02002740",4299,2360,1595,1587,8,1,764,732,32,1939,1193,23,109,338,276
"2021","North East Lincolnshire 016","E02002741",6920,4146,3030,2998,32,4,1112,1068,44,2774,1674,70,134,515,381
"2021","North East Lincolnshire 018","E02002743",4597,2700,2076,2068,8,2,622,598,24,1897,872,43,80,404,498
"2021","North East Lincolnshire 019","E02002744",5095,2544,1670,1664,6,4,870,852,18,2551,1673,35,142,424,277
"2021","North East Lincolnshire 020","E02002745",6207,4152,3365,3357,8,5,782,754,28,2055,982,36,64,410,563
"2021","North East Lincolnshire 021","E02002746",7938,5200,3892,3874,18,12,1296,1256,40,2738,1424,54,142,566,552
"2021","North East Lincolnshire 022","E02002747",7701,5210,4105,4095,10,1,1104,1064,40,2491,1350,45,121,425,550
"2021","North East Lincolnshire 023","E02002748",6675,4514,3685,3681,4,3,826,812,14,2161,1095,41,83,408,534
"2021","North East Lincolnshire 024","E02007081",8356,5025,3683,3659,24,3,1339,1291,48,3331,1914,64,193,643,517
"2021","North Lincolnshire 001","E02002749",9774,6162,4503,4463,40,5,1654,1578,76,3612,1997,59,177,722,657
"2021","North Lincolnshire 002","E02002750",5243,3580,2826,2798,28,2,752,728,24,1663,913,41,78,294,337
"2021","North Lincolnshire 003","E02002751",5216,3376,2549,2537,12,5,822,794,28,1840,1032,30,92,322,364
"2021","North Lincolnshire 004","E02002752",5819,3946,3037,3011,26,1,908,880,28,1873,1003,55,92,358,365
"2021","North Lincolnshire 005","E02002753",7165,4544,3471,3445,26,3,1070,1032,38,2621,1304,44,127,528,618
"2021","North Lincolnshire 006","E02002754",6772,4346,3293,3275,18,3,1050,1028,22,2426,1344,54,133,476,419
"2021","North Lincolnshire 007","E02002755",5838,3151,2160,2152,8,3,988,950,38,2687,1631,154,131,455,316
"2021","North Lincolnshire 008","E02002756",6963,3317,2183,2181,2,9,1125,1055,70,3646,2402,258,161,537,288
"2021","North Lincolnshire 009","E02002757",5049,3145,2321,2310,11,6,818,792,26,1904,1126,86,88,294,310
"2021","North Lincolnshire 010","E02002758",5132,2804,1819,1801,18,9,976,940,36,2328,1489,70,102,394,273
"2021","North Lincolnshire 011","E02002759",7922,5180,3973,3947,26,11,1196,1160,36,2742,1469,50,137,541,545
"2021","North Lincolnshire 012","E02002760",4668,2919,2195,2180,15,2,722,704,18,1749,1015,30,83,337,284
"2021","North Lincolnshire 013","E02002761",5346,3540,2674,2666,8,2,864,826,38,1806,993,35,94,333,351
"2021","North Lincolnshire 014","E02002762",5103,2808,1955,1939,16,5,848,826,22,2295,1343,37,130,445,340
"2021","North Lincolnshire 015","E02002763",6692,3820,2371,2357,14,3,1446,1392,54,2872,1777,33,124,575,363
"2021","North Lincolnshire 016","E02002764",4452,2442,1616,1608,8,0,826,788,38,2010,1267,37,117,343,246
"2021","North Lincolnshire 017","E02002765",4864,2816,1875,1861,14,3,938,904,34,2048,1138,44,91,431,344
"2021","North Lincolnshire 018","E02002766",7150,4539,3414,3395,19,1,1124,1094,30,2611,1422,45,118,509,517
"2021","North Lincolnshire 019","E02002767",5690,3823,2963,2957,6,4,856,832,24,1867,956,39,80,336,456
"2021","North Lincolnshire 020","E02002768",6258,4181,3355,3340,15,0,826,800,26,2077,1151,31,96,371,428
"2021","North Lincolnshire 021","E02002769",4844,3364,2776,2770,6,6,582,568,14,1480,763,35,65,273,344
"2021","North Lincolnshire 022","E02002770",5856,4024,3141,3121,20,1,882,862,20,1832,1006,22,76,350,378
"2021","North Lincolnshire 023","E02002771",5994,4188,3383,3374,9,7,798,770,28,1806,993,34,69,295,415
"2021","York 001","E02002772",5531,3778,3162,3132,30,4,612,586,26,1753,1056,35,70,294,298
"2021","York 002","E02002773",4807,3233,2707,2689,18,2,524,500,24,1574,743,33,66,321,411
"2021","York 003","E02002774",5025,3463,2945,2919,26,3,515,506,9,1562,801,24,58,285,394
"2021","York 004","E02002775",4682,2786,2264,2256,8,4,518,510,8,1896,1010,32,65,405,384
"2021","York 005","E02002776",5619,3535,2639,2618,21,2,894,864,30,2084,1173,35,73,377,426
"2021","York 006","E02002777",7331,4872,3530,3514,16,2,1340,1278,62,2459,1581,54,100,424,300
"2021","York 007","E02002778",6576,4114,3179,3143,36,3,932,876,56,2462,1471,65,80,402,444
"2021","York 008","E02002779",7902,4960,3926,3892,34,10,1024,956,68,2942,1748,61,103,465,565
"2021","York 009","E02002780",6596,3022,1898,1870,28,8,1116,1058,58,3574,2642,62,112,453,305
"2021","York 010","E02002781",7834,3545,2084,2055,29,9,1452,1368,84,4289,3312,75,137,515,250
"2021","York 011","E02002782",5025,3561,3021,3009,12,8,532,514,18,1464,833,32,44,206,349
"2021","York 012","E02002783",8294,5243,3937,3895,42,6,1300,1232,68,3051,1865,54,119,512,501
"2021","York 013","E02002784",8894,3872,2082,2024,58,2,1788,1638,150,5022,3661,109,189,721,342
"2021","York 014","E02002785",6745,3857,2964,2934,30,4,889,842,47,2888,2037,47,79,331,394
"2021","York 015","E02002786",8755,3161,1970,1948,22,2,1189,1108,81,5594,4728,66,110,447,243
"2021","York 016","E02002787",7406,4109,2778,2750,28,4,1327,1258,69,3297,2064,53,121,594,465
"2021","York 017","E02002788",6937,4240,2757,2729,28,3,1480,1366,114,2697,1867,42,106,412,270
"2021","York 018","E02002789",7144,3852,2457,2431,26,7,1388,1318,70,3292,2096,46,151,608,391
"2021","York 019","E02002790",9053,4163,2806,2764,42,4,1353,1268,85,4890,3848,79,115,519,329
"2021","York 020","E02002791",5355,3608,3075,3055,20,3,530,510,20,1747,961,50,67,250,419
"2021","York 021","E02002792",6403,4049,2955,2905,50,7,1087,1046,41,2354,1539,39,89,391,296
"2021","York 022","E02002793",7771,4897,3679,3656,23,4,1214,1166,48,2874,1662,49,103,550,510
"2021","York 023","E02002794",4361,2676,2180,2152,28,4,492,470,22,1685,1062,50,61,266,246
"2021","York 024","E02002795",6868,4821,4096,4078,18,3,722,692,30,2047,1048,33,68,378,520
"2021","Craven 001","E02005742",6314,4216,3404,3386,18,2,810,788,22,2098,1092,39,101,396,470
"2021","Craven 003","E02005744",6747,4431,3610,3571,39,5,816,786,30,2316,1202,57,92,462,503
"2021","Craven 005","E02005746",5632,3617,2750,2730,20,4,863,830,33,2015,1061,47,107,426,374
"2021","Craven 006","E02005747",5696,3072,2075,2053,22,7,990,966,24,2624,1503,79,161,512,369
"2021","Craven 007","E02005748",6475,4370,3408,3372,36,2,960,928,32,2105,1198,36,101,427,343
"2021","Craven 008","E02005749",8172,5410,4253,4237,16,7,1150,1126,24,2762,1482,41,120,568,551
"2021","Craven 009","E02007041",8620,5999,5049,5018,31,4,946,902,44,2621,1313,66,140,468,634
"2021","Hambleton 001","E02005750",6637,4092,3356,3336,20,0,736,716,20,2545,1336,53,121,461,574
"2021","Hambleton 002","E02005751",7528,5256,4576,4562,14,2,678,666,12,2272,1145,52,88,379,608
"2021","Hambleton 003","E02005752",5954,4014,3256,3242,14,4,754,714,40,1940,1141,50,83,325,341
"2021","Hambleton 005","E02005754",6403,4606,3952,3936,16,0,654,634,20,1797,900,35,78,315,469
"2021","Hambleton 006","E02005755",5659,3648,2956,2942,14,4,688,674,14,2011,1031,45,104,404,427
"2021","Hambleton 007","E02005756",4907,3577,2934,2926,8,2,641,630,11,1330,732,43,65,229,261
"2021","Hambleton 008","E02005757",7343,4732,3625,3599,26,1,1106,1058,48,2611,1374,56,141,506,534
"2021","Hambleton 009","E02005758",7668,5266,4100,4086,14,4,1162,1136,26,2402,1323,40,116,444,479
"2021","Hambleton 010","E02005759",7876,5105,4149,4125,24,3,953,922,31,2771,1395,64,136,566,610
"2021","Hambleton 011","E02005760",5083,3604,2914,2896,18,0,690,656,34,1479,891,37,61,237,253
"2021","Hambleton 012","E02007042",5750,3636,2874,2858,16,4,758,744,14,2114,1135,31,105,397,446
"2021","Hambleton 013","E02007043",5079,2790,1991,1977,14,3,796,778,18,2289,1290,36,114,478,371
"2021","Harrogate 001","E02005761",4560,3158,2738,2730,8,0,420,398,22,1402,746,37,75,261,283
"2021","Harrogate 002","E02005762",4708,2970,2476,2470,6,4,490,464,26,1738,936,34,89,341,338
"2021","Harrogate 003","E02005763",5254,3780,3104,3096,8,2,674,654,20,1474,793,37,68,297,279
"2021","Harrogate 004","E02005764",8483,5048,3965,3949,16,3,1080,1042,38,3435,1843,60,165,770,597
"2021","Harrogate 005","E02005765",5962,4160,3353,3335,18,5,802,784,18,1802,976,38,80,328,380
"2021","Harrogate 006","E02005766",5134,3514,2866,2848,18,12,636,618,18,1620,887,57,76,278,322
"2021","Harrogate 007","E02005767",6004,4326,3684,3662,22,0,642,624,18,1678,928,28,57,308,357
"2021","Harrogate 008","E02005768",5385,3814,3075,3061,14,7,732,714,18,1571,890,42,82,274,283
"2021","Harrogate 009","E02005769",5763,3188,2389,2365,24,3,796,764,32,2575,1374,38,114,563,486
"2021","Harrogate 010","E02005770",7515,4780,3595,3565,30,7,1178,1142,36,2735,1472,47,111,587,518
"2021","Harrogate 011","E02005771",6132,3624,2553,2531,22,11,1060,1004,56,2508,1412,45,143,607,301
"2021","Harrogate 012","E02005772",4920,3511,3041,3029,12,4,466,442,24,1409,725,30,44,239,371
"2021","Harrogate 013","E02005773",7371,3799,2554,2528,26,3,1242,1186,56,3572,2064,68,206,821,413
"2021","Harrogate 014","E02005774",7602,4518,3300,3278,22,8,1210,1164,46,3084,1769,52,152,639,472
"2021","Harrogate 015","E02005775",7880,4118,2809,2767,42,1,1308,1214,94,3762,2315,108,186,740,413
"2021","Harrogate 016","E02005776",7027,5073,4130,4115,15,1,942,906,36,1954,1133,38,86,375,322
"2021","Harrogate 017","E02005777",6600,4503,3822,3810,12,7,674,646,28,2097,1157,39,83,380,438
"2021","Harrogate 018","E02005778",5197,3718,3178,3154,24,2,538,528,10,1479,859,46,49,256,269
"2021","Harrogate 019","E02005779",6216,3712,3015,2975,40,3,694,658,36,2504,1318,68,120,512,486
"2021","Harrogate 020","E02005780",8750,5888,5038,5020,18,0,850,816,34,2862,1611,56,115,552,528
"2021","Harrogate 021","E02005781",4854,3501,3006,2984,22,0,495,470,25,1353,749,33,53,228,290
"2021","Richmondshire 001","E02005782",6507,4574,3888,3868,20,4,682,652,30,1933,1023,37,92,380,401
"2021","Richmondshire 002","E02005783",6824,4126,3350,3326,24,2,774,740,34,2698,1349,43,147,616,543
"2021","Richmondshire 003","E02005784",4442,2950,2357,2337,20,7,586,556,30,1492,777,31,86,297,301
"2021","Richmondshire 004","E02005785",8868,5814,4629,4605,24,17,1168,1106,62,3054,1838,79,241,579,317
"2021","Richmondshire 005","E02005786",5060,3439,2847,2827,20,4,588,568,20,1621,827,60,67,292,375
"2021","Richmondshire 006","E02005787",7324,4998,4084,4054,30,4,910,870,40,2326,1230,46,114,398,538
"2021","Ryedale 001","E02005788",5484,3693,2984,2966,18,2,707,685,22,1791,937,34,83,353,384
"2021","Ryedale 002","E02005789",9101,5938,4779,4759,20,3,1156,1116,40,3163,1591,61,138,608,765
"2021","Ryedale 003","E02005790",5724,3894,3200,3184,16,10,684,654,30,1830,903,49,84,358,436
"2021","Ryedale 004","E02005791",5716,3884,3036,3020,16,2,846,820,26,1832,1086,40,92,304,310
"2021","Ryedale 007","E02005794",7904,5521,4475,4449,26,8,1038,1008,30,2383,1276,57,104,445,501
"2021","Ryedale 009","E02007044",6124,3602,2323,2301,22,9,1270,1230,40,2522,1473,56,129,491,373
"2021","Ryedale 010","E02007045",5655,3674,2856,2836,20,6,812,788,24,1981,1067,53,102,336,423
"2021","Scarborough 001","E02005795",5839,3368,2589,2569,20,5,774,736,38,2471,1254,87,120,546,464
"2021","Scarborough 002","E02005796",5667,3674,2947,2915,32,7,720,692,28,1993,1131,57,75,316,414
"2021","Scarborough 003","E02005797",5156,3102,2380,2358,22,0,722,700,22,2054,1194,48,93,384,335
"2021","Scarborough 004","E02005798",7046,4852,3954,3931,23,5,893,848,45,2194,1100,52,80,419,543
"2021","Scarborough 005","E02005799",7814,5180,4224,4204,20,4,952,920,32,2634,1331,43,93,476,691
"2021","Scarborough 006","E02005800",6197,2823,1908,1872,36,2,913,868,45,3374,1986,85,194,720,389
"2021","Scarborough 007","E02005801",4278,2216,1554,1546,8,6,656,628,28,2062,1248,23,79,424,288
"2021","Scarborough 008","E02005802",6199,3181,2000,1968,32,0,1181,1138,43,3018,1836,63,170,642,307
"2021","Scarborough 009","E02005803",7664,4455,3283,3259,24,2,1170,1118,52,3209,1712,69,167,710,551
"2021","Scarborough 010","E02005804",6619,3108,2142,2104,38,4,962,884,78,3511,1858,99,214,856,484
"2021","Scarborough 011","E02005805",6601,4486,3468,3442,26,10,1008,980,28,2115,1010,44,92,456,513
"2021","Scarborough 012","E02005806",6239,3654,2436,2418,18,8,1210,1176,34,2585,1567,39,145,457,377
"2021","Scarborough 013","E02005807",5466,3806,3127,3117,10,1,678,658,20,1660,878,32,63,316,371
"2021","Scarborough 014","E02005808",9943,6412,5100,5082,18,6,1306,1250,56,3531,1648,88,199,672,924
"2021","Selby 001","E02005809",6242,4006,3156,3138,18,10,840,814,26,2236,1228,34,94,444,436
"2021","Selby 002","E02005810",7651,5467,4486,4461,25,9,972,930,42,2184,1318,37,104,363,362
"2021","Selby 003","E02005811",7980,5636,4406,4376,30,8,1222,1174,48,2344,1307,56,125,399,457
"2021","Selby 004","E02005812",9132,6198,4442,4424,18,2,1754,1704,50,2934,1684,34,148,580,488
"2021","Selby 005","E02005813",10390,5854,3645,3611,34,19,2190,2128,62,4536,2843,100,250,885,458
"2021","Selby 006","E02005814",5720,3664,2879,2849,30,5,780,748,32,2056,1111,33,96,382,434
"2021","Selby 007","E02005815",7222,5078,4063,4047,16,3,1012,991,21,2144,1144,36,110,350,504
"2021","Selby 008","E02005816",7170,5072,4010,3990,20,8,1054,1016,38,2098,1199,37,114,359,389
"2021","Selby 009","E02005817",6156,4246,3286,3264,22,0,960,936,24,1910,1055,25,93,399,338
"2021","Selby 010","E02005818",7219,5069,3968,3961,7,1,1100,1062,38,2150,1216,62,117,398,357
"2021","Barnsley 001","E02001509",5606,3520,2561,2541,20,1,958,922,36,2086,1222,32,102,400,330
"2021","Barnsley 002","E02001510",4815,2883,2084,2074,10,8,791,766,25,1932,1157,34,106,355,280
"2021","Barnsley 003","E02001511",5010,3116,2290,2276,14,4,822,800,22,1894,1071,29,90,333,371
"2021","Barnsley 004","E02001512",6931,4466,3234,3198,36,0,1232,1172,60,2465,1417,42,114,489,403
"2021","Barnsley 005","E02001513",6342,4170,3034,3018,16,4,1132,1078,54,2172,1200,37,88,445,402
"2021","Barnsley 006","E02001514",5993,3620,2372,2342,30,0,1248,1214,34,2373,1451,52,125,433,312
"2021","Barnsley 007","E02001515",7469,4070,2643,2631,12,5,1422,1376,46,3399,2096,44,170,645,444
"2021","Barnsley 008","E02001516",4933,2944,2006,1980,26,4,934,914,20,1989,1232,28,97,383,249
"2021","Barnsley 009","E02001517",6653,4297,3256,3244,12,0,1041,991,50,2356,1303,32,109,455,457
"2021","Barnsley 010","E02001518",8357,4881,3416,3392,24,12,1453,1396,57,3476,2124,61,175,654,462
"2021","Barnsley 011","E02001519",6174,3786,2529,2515,14,5,1252,1204,48,2388,1554,45,123,315,351
"2021","Barnsley 012","E02001520",9796,6485,4875,4852,23,4,1606,1542,64,3311,1830,51,141,612,677
"2021","Barnsley 013","E02001521",10001,5232,3058,3026,32,8,2166,2046,120,4769,3047,156,247,912,407
"2021","Barnsley 014","E02001522",7470,4155,2825,2812,13,6,1324,1274,50,3315,2050,51,215,500,499
"2021","Barnsley 015","E02001523",5675,3527,2401,2384,17,4,1122,1042,80,2148,1324,36,95,372,321
"2021","Barnsley 016","E02001524",5213,3722,3134,3118,16,0,588,564,24,1491,771,39,51,283,347
"2021","Barnsley 017","E02001525",5437,2676,1574,1560,14,2,1100,1046,54,2761,1648,75,143,596,299
"2021","Barnsley 018","E02001526",4740,2616,1722,1708,14,6,888,856,32,2124,1289,43,89,382,321
"2021","Barnsley 019","E02001527",4947,3115,2370,2362,8,0,745,724,21,1832,1036,23,78,362,333
"2021","Barnsley 020","E02001528",8585,5200,3781,3759,22,3,1416,1372,44,3385,1958,62,194,562,609
"2021","Barnsley 021","E02001529",7605,4328,3003,2989,14,3,1322,1270,52,3277,1966,55,164,557,535
"2021","Barnsley 022","E02001530",5715,3306,2152,2126,26,6,1148,1090,58,2409,1477,40,129,423,340
"2021","Barnsley 023","E02001531",6317,3695,2383,2364,19,2,1310,1264,46,2622,1579,52,138,461,392
"2021","Barnsley 024","E02001532",8455,5593,4310,4284,26,4,1279,1228,51,2862,1590,61,147,566,498
"2021","Barnsley 025","E02001533",6136,3740,2543,2517,26,7,1190,1148,42,2396,1435,42,111,471,337
"2021","Barnsley 026","E02001534",7710,4673,3181,3166,15,0,1492,1424,68,3037,1859,47,130,543,458
"2021","Barnsley 027","E02001535",5428,3800,3075,3055,20,9,716,678,38,1628,902,26,74,301,325
"2021","Barnsley 028","E02001536",7228,4528,3191,3189,2,7,1330,1264,66,2700,1488,34,130,535,513
"2021","Barnsley 029","E02001537",6902,4215,2957,2935,22,4,1254,1200,54,2687,1606,37,170,496,378
"2021","Barnsley 030","E02001538",6455,3981,2880,2865,15,9,1092,1050,42,2474,1451,49,131,399,444
"2021","Doncaster 001","E02001539",5174,3050,2176,2168,8,4,870,840,30,2124,1364,51,95,328,286
"2021","Doncaster 002","E02001540",9655,5876,4324,4290,34,6,1546,1486,60,3779,2283,75,186,659,576
"2021","Doncaster 003","E02001541",9368,5577,4093,4064,29,5,1479,1432,47,3791,2122,71,190,723,685
"2021","Doncaster 004","E02001542",5833,3302,2310,2296,14,4,988,956,32,2531,1547,40,156,407,381
"2021","Doncaster 005","E02001543",6284,3734,2625,2617,8,7,1102,1072,30,2550,1465,36,112,460,477
"2021","Doncaster 006","E02001544",6600,3935,2876,2862,14,2,1057,1024,33,2665,1586,39,144,474,422
"2021","Doncaster 007","E02001545",7112,4591,3633,3619,14,2,956,920,36,2521,1268,38,112,546,557
"2021","Doncaster 008","E02001546",5643,3777,2951,2937,14,3,823,791,32,1866,999,36,90,334,407
"2021","Doncaster 009","E02001547",8473,4830,3224,3202,22,4,1602,1540,62,3643,2340,55,204,617,427
"2021","Doncaster 010","E02001548",6179,3109,1973,1954,19,10,1126,1080,46,3070,1915,64,167,547,377
"2021","Doncaster 011","E02001549",5088,3281,2457,2447,10,8,816,792,24,1807,978,45,87,367,330
"2021","Doncaster 012","E02001550",6213,3726,2571,2539,32,5,1150,1108,42,2487,1398,31,148,488,422
"2021","Doncaster 013","E02001551",4835,2724,1835,1822,13,2,887,846,41,2111,1259,27,120,440,265
"2021","Doncaster 014","E02001552",5992,3542,2364,2356,8,6,1172,1140,32,2450,1404,51,121,528,346
"2021","Doncaster 015","E02001553",8123,4697,3356,3331,25,9,1332,1266,66,3426,2069,90,194,595,478
"2021","Doncaster 016","E02001554",5059,3255,2476,2466,10,1,778,754,24,1804,1037,24,79,317,347
"2021","Doncaster 017","E02001555",4475,2954,2349,2347,2,1,604,578,26,1521,762,33,49,298,379
"2021","Doncaster 018","E02001556",7223,3904,2823,2811,12,3,1078,1024,54,3319,2067,86,162,561,443
"2021","Doncaster 019","E02001557",8278,4204,2877,2845,32,5,1322,1238,84,4074,2499,238,191,718,428
"2021","Doncaster 020","E02001558",5190,3460,2760,2750,10,0,700,670,30,1730,922,29,62,331,386
"2021","Doncaster 021","E02001559",6198,4186,3291,3281,10,3,892,858,34,2012,1117,40,91,332,432
"2021","Doncaster 022","E02001560",8611,3909,2318,2302,16,12,1579,1509,70,4702,3086,244,224,778,370
"2021","Doncaster 023","E02001561",5005,2507,1578,1566,12,13,916,884,32,2498,1576,80,125,474,243
"2021","Doncaster 024","E02001562",4662,2619,1884,1872,12,6,729,694,35,2043,1081,23,113,434,392
"2021","Doncaster 025","E02001563",6578,4190,3387,3375,12,3,800,772,28,2388,1313,57,103,428,487
"2021","Doncaster 026","E02001564",6829,4730,3892,3878,14,8,830,798,32,2099,1134,38,84,382,461
"2021","Doncaster 027","E02001565",6531,4476,3712,3696,16,6,758,732,26,2055,1188,75,65,346,381
"2021","Doncaster 028","E02001566",6740,3860,2445,2423,22,13,1402,1318,84,2880,1874,75,167,519,245
"2021","Doncaster 029","E02001567",6860,3818,2668,2652,16,2,1148,1102,46,3042,1850,55,137,579,421
"2021","Doncaster 030","E02001568",5469,3161,2177,2164,13,2,982,946,36,2308,1399,24,125,409,351
"2021","Doncaster 031","E02001569",6880,3762,2430,2418,12,12,1320,1258,62,3118,1933,48,162,590,385
"2021","Doncaster 032","E02001570",5550,2928,1925,1909,16,5,998,954,44,2622,1487,31,150,530,424
"2021","Doncaster 033","E02001571",4974,3213,2494,2479,15,1,718,694,24,1761,1015,31,94,298,323
"2021","Doncaster 034","E02001572",6135,3473,2383,2357,26,1,1089,1024,65,2662,1565,44,150,480,423
"2021","Doncaster 035","E02001573",6061,3519,2537,2521,16,12,970,936,34,2542,1596,33,141,360,412
"2021","Doncaster 036","E02001574",5020,3392,2618,2588,30,4,770,744,26,1628,883,27,82,325,311
"2021","Doncaster 037","E02001575",6036,3367,2102,2090,12,3,1262,1218,44,2669,1600,51,151,485,382
"2021","Doncaster 038","E02001576",5621,3609,2594,2574,20,1,1014,962,52,2012,1133,55,111,374,339
"2021","Doncaster 039","E02001577",5487,3690,2999,2979,20,3,688,668,20,1797,854,42,89,345,467
"2021","Rotherham 001","E02001578",9028,5626,3866,3847,19,7,1753,1670,83,3402,2100,48,202,626,426
"2021","Rotherham 002","E02001579",7922,4672,3454,3438,16,0,1218,1176,42,3250,1927,36,168,543,576
"2021","Rotherham 003","E02001580",7070,4328,3086,3072,14,6,1236,1182,54,2742,1626,46,120,450,500
"2021","Rotherham 004","E02001581",5051,3276,2304,2300,4,0,972,942,30,1775,1043,26,79,325,302
"2021","Rotherham 005","E02001582",6282,3799,2693,2680,13,6,1100,1076,24,2483,1532,33,118,408,392
"2021","Rotherham 006","E02001583",4415,2699,1806,1794,12,4,889,852,37,1716,1071,27,111,253,254
"2021","Rotherham 007","E02001584",5739,3870,3025,3003,22,1,844,832,12,1869,1056,37,71,338,367
"2021","Rotherham 008","E02001585",4922,2592,1754,1740,14,0,838,816,22,2330,1425,33,124,423,325
"2021","Rotherham 009","E02001586",6638,3400,2324,2304,20,10,1066,1018,48,3238,1906,40,147,607,538
"2021","Rotherham 010","E02001587",4737,2607,1737,1721,16,1,869,848,21,2130,1325,31,95,340,339
"2021","Rotherham 011","E02001588",5632,3022,2072,2056,16,6,944,914,30,2610,1665,30,104,423,388
"2021","Rotherham 012","E02001589",6546,4329,3332,3314,18,7,990,964,26,2217,1276,30,108,426,377
"2021","Rotherham 013","E02001590",5627,2733,1793,1785,8,2,938,898,40,2894,1962,52,140,432,308
"2021","Rotherham 014","E02001591",6226,3200,2281,2267,14,9,910,862,48,3026,1943,141,174,451,317
"2021","Rotherham 015","E02001592",7132,4466,3303,3289,14,3,1160,1118,42,2666,1658,36,99,410,463
"2021","Rotherham 016","E02001593",5490,2558,1774,1758,16,8,776,742,34,2932,1894,178,152,449,259
"2021","Rotherham 017","E02001594",5494,2574,1718,1704,14,3,853,803,50,2920,1978,188,162,388,204
"2021","Rotherham 018","E02001595",6919,4582,3497,3483,14,1,1084,1054,30,2337,1392,24,95,383,443
"2021","Rotherham 019","E02001596",6877,4258,3322,3298,24,4,932,908,24,2619,1368,37,130,471,613
"2021","Rotherham 020","E02001597",7436,4045,2665,2657,8,5,1375,1341,34,3391,2096,56,169,586,484
"2021","Rotherham 021","E02001598",7759,4872,3726,3712,14,6,1140,1106,34,2887,1657,64,94,489,583
"2021","Rotherham 023","E02001600",8844,5325,4475,4461,14,10,840,798,42,3519,2147,196,128,475,573
"2021","Rotherham 025","E02001602",7458,4722,3505,3491,14,1,1216,1190,26,2736,1593,52,126,425,540
"2021","Rotherham 026","E02001603",5946,3702,2614,2588,26,2,1086,1052,34,2244,1331,58,106,365,384
"2021","Rotherham 027","E02001604",9194,6194,4218,4184,34,10,1966,1882,84,3000,1993,62,144,413,388
"2021","Rotherham 028","E02001605",6126,3960,2874,2836,38,0,1086,1052,34,2166,1291,35,99,397,344
"2021","Rotherham 029","E02001606",6453,3916,2788,2774,14,10,1118,1076,42,2537,1529,29,110,434,435
"2021","Rotherham 030","E02001607",7192,4534,3315,3295,20,3,1216,1184,32,2658,1548,57,101,441,511
"2021","Rotherham 031","E02001608",5714,3786,2914,2898,16,0,872,842,30,1928,1145,33,89,315,346
"2021","Rotherham 032","E02001609",7102,4744,3782,3762,20,10,952,930,22,2358,1294,36,89,393,546
"2021","Rotherham 033","E02001610",7126,4742,3690,3674,16,6,1046,1030,16,2384,1346,59,111,425,443
"2021","Rotherham 034","E02007002",9633,6186,4869,4841,28,1,1316,1276,40,3447,1924,77,151,636,659
"2021","Sheffield 001","E02001611",6282,3927,2878,2858,20,2,1047,1024,23,2355,1382,37,114,414,408
"2021","Sheffield 002","E02001612",4731,3076,2365,2353,12,1,710,690,20,1655,990,16,63,296,290
"2021","Sheffield 003","E02001613",8390,5236,3994,3980,14,2,1240,1200,40,3154,1818,49,139,537,611
"2021","Sheffield 004","E02001614",9278,6085,4752,4734,18,7,1326,1282,44,3193,1887,46,117,522,621
"2021","Sheffield 005","E02001615",6167,4197,3329,3307,22,0,868,846,22,1970,1110,32,53,304,471
"2021","Sheffield 006","E02001616",5993,3448,2466,2454,12,6,976,944,32,2545,1512,34,102,418,479
"2021","Sheffield 007","E02001617",4293,2223,1406,1394,12,8,809,788,21,2070,1382,52,97,324,215
"2021","Sheffield 008","E02001618",7868,5319,4232,4198,34,3,1084,1050,34,2549,1582,44,103,427,393
"2021","Sheffield 009","E02001619",7863,4218,2627,2613,14,5,1586,1528,58,3645,2454,71,161,489,470
"2021","Sheffield 010","E02001620",5230,2706,1914,1908,6,6,786,742,44,2524,1650,65,136,384,289
"2021","Sheffield 011","E02001621",4545,2359,1649,1638,11,6,704,676,28,2186,1500,32,114,298,242
"2021","Sheffield 012","E02001622",6978,3622,2331,2315,16,5,1286,1244,42,3356,2195,51,147,543,420
"2021","Sheffield 013","E02001623",6153,2739,2088,2081,7,9,642,596,46,3414,2241,171,167,480,355
"2021","Sheffield 014","E02001624",7547,4230,3106,3082,24,6,1118,1062,56,3317,2159,113,147,459,439
"2021","Sheffield 015","E02001625",5941,2936,1977,1962,15,5,954,918,36,3005,2047,67,132,434,325
"2021","Sheffield 016","E02001626",4819,3038,2298,2272,26,0,740,716,24,1781,1128,22,65,269,297
"2021","Sheffield 017","E02001627",5012,2731,1680,1653,27,1,1050,990,60,2281,1500,47,134,359,241
"2021","Sheffield 018","E02001628",4757,2470,2119,2091,28,13,338,318,20,2287,1434,183,108,272,290
"2021","Sheffield 019","E02001629",4972,2280,1698,1690,8,0,582,562,20,2692,1802,107,124,348,311
"2021","Sheffield 020","E02001630",6537,3179,2716,2704,12,8,455,421,34,3358,2330,282,139,324,283
"2021","Sheffield 021","E02001631",6270,3878,2682,2648,34,6,1190,1136,54,2392,1489,31,110,383,379
"2021","Sheffield 022","E02001632",8767,3877,2883,2874,9,15,979,939,40,4890,3363,422,317,482,306
"2021","Sheffield 023","E02001633",6363,4354,3512,3494,18,4,838,798,40,2009,1128,33,51,333,464
"2021","Sheffield 024","E02001634",7716,4556,2817,2781,36,7,1732,1646,86,3160,2154,62,128,458,358
"2021","Sheffield 025","E02001635",4999,2876,2152,2138,14,0,724,682,42,2123,1245,28,93,354,403
"2021","Sheffield 026","E02001636",6975,3083,2145,2129,16,7,931,872,59,3892,2662,145,183,576,326
"2021","Sheffield 027","E02001637",6064,2933,2485,2483,2,11,437,414,23,3131,2115,287,146,284,299
"2021","Sheffield 028","E02001638",5148,1806,977,951,26,3,826,780,46,3342,3057,25,37,133,90
"2021","Sheffield 029","E02001639",5039,2713,1653,1636,17,2,1058,1012,46,2326,1697,33,71,280,245
"2021","Sheffield 030","E02001640",7389,2095,1358,1340,18,3,734,658,76,5294,4764,89,70,244,127
"2021","Sheffield 032","E02001642",8316,4933,3595,3579,16,12,1326,1270,56,3383,2227,127,138,429,462
"2021","Sheffield 033","E02001643",5042,3444,2962,2946,16,0,482,468,14,1598,906,40,58,258,336
"2021","Sheffield 036","E02001646",5687,1998,1354,1340,14,2,642,596,46,3689,3219,58,52,204,156
"2021","Sheffield 037","E02001647",5031,3036,2263,2259,4,3,770,730,40,1995,1181,63,100,309,342
"2021","Sheffield 038","E02001648",4612,2950,2290,2266,24,4,656,626,30,1662,992,51,85,302,232
"2021","Sheffield 039","E02001649",8376,4075,2575,2553,22,5,1495,1427,68,4301,2928,103,245,634,391
"2021","Sheffield 040","E02001650",6668,2211,1336,1322,14,6,869,788,81,4457,3713,161,119,322,142
"2021","Sheffield 041","E02001651",6510,4664,4118,4102,16,8,538,516,22,1846,1052,47,66,247,434
"2021","Sheffield 042","E02001652",7815,2880,1755,1731,24,3,1122,1014,108,4935,4117,229,116,272,201
"2021","Sheffield 043","E02001653",5668,2869,1728,1710,18,6,1135,1025,110,2799,1910,73,142,396,278
"2021","Sheffield 044","E02001654",5113,3112,2322,2303,19,2,788,752,36,2001,1203,45,76,257,420
"2021","Sheffield 045","E02001655",6028,3398,2345,2337,8,3,1050,1010,40,2630,1706,63,122,394,345
"2021","Sheffield 046","E02001656",6408,3503,2498,2476,22,0,1005,943,62,2905,2269,68,67,279,222
"2021","Sheffield 047","E02001657",7153,4872,3788,3756,32,6,1078,1050,28,2281,1515,43,76,355,292
"2021","Sheffield 048","E02001658",3978,1827,1222,1212,10,4,601,569,32,2151,1454,44,128,289,236
"2021","Sheffield 049","E02001659",4812,2380,1662,1652,10,4,714,676,38,2432,1498,30,112,394,398
"2021","Sheffield 050","E02001660",7978,4408,3095,3055,40,3,1310,1228,82,3570,2501,152,122,476,319
"2021","Sheffield 051","E02001661",6036,2832,1806,1784,22,8,1018,972,46,3204,2017,126,209,520,332
"2021","Sheffield 052","E02001662",6088,3542,2437,2431,6,7,1098,1056,42,2546,1545,47,107,421,426
"2021","Sheffield 053","E02001663",5965,3571,2137,2093,44,2,1432,1370,62,2394,1705,53,100,327,209
"2021","Sheffield 054","E02001664",5148,3112,2312,2302,10,6,794,748,46,2036,1236,38,92,293,377
"2021","Sheffield 055","E02001665",7887,5582,4872,4845,27,8,702,664,38,2305,1299,59,71,333,543
"2021","Sheffield 056","E02001666",4813,2839,1984,1973,11,3,852,836,16,1974,1258,21,75,342,278
"2021","Sheffield 059","E02001669",6382,3850,2466,2426,40,4,1380,1328,52,2532,1592,52,135,443,310
"2021","Sheffield 060","E02001670",4628,2106,1426,1421,5,2,678,652,26,2522,1666,44,117,370,325
"2021","Sheffield 061","E02001671",4924,3169,2531,2524,7,2,636,618,18,1755,971,30,67,296,391
"2021","Sheffield 062","E02001672",4964,3020,2123,2111,12,5,892,852,40,1944,1148,34,75,327,360
"2021","Sheffield 063","E02001673",4260,2950,2338,2334,4,0,612,580,32,1310,834,15,65,201,195
"2021","Sheffield 064","E02001674",7519,5077,3973,3951,22,3,1101,1062,39,2442,1401,42,83,375,541
"2021","Sheffield 065","E02001675",7094,4012,3012,2994,18,8,992,941,51,3082,1799,48,129,589,517
"2021","Sheffield 066","E02001676",4874,3346,2743,2713,30,5,598,578,20,1528,862,33,45,250,338
"2021","Sheffield 068","E02001678",8465,5820,5045,5019,26,1,774,738,36,2645,1368,57,108,472,640
"2021","Sheffield 069","E02001679",4968,2522,1750,1746,4,2,770,726,44,2446,1511,53,116,432,334
"2021","Sheffield 070","E02001680",4877,2110,1314,1302,12,9,787,744,43,2767,1749,68,146,501,303
"2021","Sheffield 071","E02001681",6191,4085,3389,3373,16,10,686,670,16,2106,1148,40,68,405,445
"2021","Sheffield 072","E02006803",7731,5278,3980,3958,22,0,1298,1258,40,2453,1472,45,97,413,426
"2021","Sheffield 073","E02006843",6230,2620,972,946,26,0,1648,1506,142,3610,3240,89,76,163,42
"2021","Sheffield 074","E02006844",5317,1336,756,750,6,2,578,534,44,3981,3561,92,90,159,79
"2021","Sheffield 075","E02006868",9023,4179,2727,2690,37,6,1446,1302,144,4844,3424,186,208,582,444
"2021","Sheffield 076","E02006869",8990,5307,3691,3668,23,4,1612,1558,54,3683,2320,52,149,608,554
"2021","Bradford 001","E02002183",4907,3180,2687,2663,24,1,492,468,24,1727,785,24,67,394,457
"2021","Bradford 002","E02002184",10757,6996,5791,5763,28,9,1196,1170,26,3761,1945,80,153,657,926
"2021","Bradford 003","E02002185",4714,3193,2629,2617,12,4,560,542,18,1521,836,25,69,321,270
"2021","Bradford 005","E02002187",5021,3562,3007,2995,12,5,550,528,22,1459,773,28,78,260,320
"2021","Bradford 006","E02002188",6280,4108,3219,3189,30,3,886,860,26,2172,1277,73,109,344,369
"2021","Bradford 007","E02002189",5297,2970,2553,2543,10,3,414,384,30,2327,1469,181,94,319,264
"2021","Bradford 008","E02002190",8965,4518,3619,3607,12,11,888,842,46,4447,2803,357,217,613,457
"2021","Bradford 009","E02002191",7110,3533,2704,2698,6,5,824,784,40,3577,2245,133,252,578,369
"2021","Bradford 010","E02002192",7550,5161,4258,4240,18,4,899,858,41,2389,1256,47,109,460,517
"2021","Bradford 011","E02002193",5128,2412,1610,1590,20,4,798,754,44,2716,1664,55,144,554,299
"2021","Bradford 012","E02002194",5908,3484,2564,2552,12,0,920,892,28,2424,1516,43,103,399,363
"2021","Bradford 013","E02002195",5339,3588,3000,2988,12,4,584,560,24,1751,908,26,97,364,356
"2021","Bradford 014","E02002196",5173,3382,2479,2459,20,5,898,872,26,1791,1092,34,94,315,256
"2021","Bradford 015","E02002197",7108,3885,2636,2618,18,9,1240,1202,38,3223,1808,61,186,667,501
"2021","Bradford 016","E02002198",6863,4096,2992,2980,12,4,1100,1062,38,2767,1573,42,136,529,487
"2021","Bradford 017","E02002199",5995,3938,2978,2950,28,2,958,902,56,2057,1178,38,96,400,345
"2021","Bradford 018","E02002200",7296,4482,3425,3397,28,5,1052,976,76,2814,1679,83,173,450,429
"2021","Bradford 019","E02002201",9786,5726,4029,4000,29,5,1692,1628,64,4060,2541,80,227,712,500
"2021","Bradford 020","E02002202",6157,3048,1976,1944,32,0,1072,1000,72,3109,2046,72,168,498,325
"2021","Bradford 021","E02002203",6119,3242,2195,2187,8,9,1038,1002,36,2877,1840,37,161,498,341
"2021","Bradford 022","E02002204",9464,5966,4742,4706,36,6,1218,1174,44,3498,1954,74,136,640,694
"2021","Bradford 023","E02002205",8239,5292,3914,3888,26,6,1372,1308,64,2947,1653,69,130,599,496
"2021","Bradford 024","E02002206",6972,4010,3011,2985,26,11,988,962,26,2962,1812,102,153,443,452
"2021","Bradford 025","E02002207",5628,2764,2425,2407,18,9,330,304,26,2864,1901,255,154,308,246
"2021","Bradford 026","E02002208",6324,3286,2281,2271,10,3,1002,980,22,3038,1903,76,139,474,446
"2021","Bradford 027","E02002209",4959,2523,1744,1731,13,9,770,736,34,2436,1674,75,132,374,181
"2021","Bradford 028","E02002210",5929,3315,2721,2711,10,9,585,566,19,2614,1659,122,135,349,349
"2021","Bradford 029","E02002211",5646,2847,2622,2614,8,0,225,209,16,2799,1855,289,113,274,268
"2021","Bradford 030","E02002212",6267,3406,3110,3106,4,4,292,276,16,2861,1897,251,181,309,223
"2021","Bradford 031","E02002213",6233,3915,2937,2903,34,6,972,942,30,2318,1337,55,121,470,335
"2021","Bradford 032","E02002214",4958,2880,2185,2174,11,3,692,630,62,2078,1341,78,109,301,249
"2021","Bradford 033","E02002215",8044,3828,3521,3519,2,15,292,280,12,4216,2760,485,197,396,378
"2021","Bradford 034","E02002216",7351,3337,3028,3019,9,9,300,282,18,4014,2585,486,220,437,286
"2021","Bradford 035","E02002217",7355,3421,2900,2888,12,9,512,480,32,3934,2605,329,224,466,310
"2021","Bradford 036","E02002218",7603,4138,3294,3286,8,10,834,790,44,3465,2196,152,188,522,407
"2021","Bradford 037","E02002219",5781,2998,2781,2781,0,9,208,196,12,2783,1881,297,167,224,214
"2021","Bradford 038","E02002220",6820,3428,3125,3119,6,7,296,290,6,3392,2292,329,171,325,275
"2021","Bradford 040","E02002222",6492,3386,2816,2812,4,12,558,546,12,3106,1961,183,236,399,327
"2021","Bradford 041","E02002223",5586,2614,2320,2320,0,6,288,268,20,2972,1999,280,174,276,243
"2021","Bradford 042","E02002224",7580,3756,3500,3498,2,2,254,240,14,3824,2483,450,206,344,341
"2021","Bradford 043","E02002225",6735,4038,2973,2951,22,11,1054,1010,44,2697,1629,77,116,512,363
"2021","Bradford 044","E02002226",9309,4280,3855,3847,8,9,416,401,15,5029,3383,642,239,410,355
"2021","Bradford 045","E02002227",4597,2052,1536,1530,6,4,512,476,36,2545,1701,150,148,301,245
"2021","Bradford 046","E02002228",5469,2470,1684,1676,8,2,784,758,26,2999,1935,120,186,474,284
"2021","Bradford 047","E02002229",6203,3460,2597,2579,18,5,858,814,44,2743,1695,103,145,424,376
"2021","Bradford 048","E02002230",5978,2616,2258,2254,4,8,350,336,14,3362,2233,323,153,395,258
"2021","Bradford 049","E02002231",9920,5376,4475,4463,12,13,888,856,32,4544,3021,248,249,536,490
"2021","Bradford 050","E02002232",5214,2622,2077,2069,8,9,536,510,26,2592,1633,154,174,374,257
"2021","Bradford 051","E02002233",6820,3208,2880,2880,0,4,324,298,26,3612,2517,302,208,319,266
"2021","Bradford 052","E02002234",5466,2229,1367,1365,2,6,856,808,48,3237,2215,67,187,478,290
"2021","Bradford 053","E02002235",5096,2520,2115,2115,0,1,404,378,26,2576,1761,166,154,307,188
"2021","Bradford 054","E02002236",5008,2825,2246,2236,10,10,569,544,25,2183,1348,99,103,329,304
"2021","Bradford 055","E02002237",6558,3594,2643,2635,8,5,946,914,32,2964,1967,110,130,441,316
"2021","Bradford 056","E02002238",4859,2344,1715,1709,6,5,624,608,16,2515,1611,79,132,386,307
"2021","Bradford 057","E02002239",8173,4624,3294,3264,30,4,1326,1272,54,3549,2323,103,228,515,380
"2021","Bradford 058","E02002240",9332,5878,4297,4273,24,9,1572,1494,78,3454,2146,55,187,570,496
"2021","Bradford 059","E02002241",9270,4989,3427,3365,62,7,1555,1507,48,4281,2769,92,216,645,559
"2021","Bradford 060","E02002242",6509,3858,2871,2853,18,3,984,942,42,2651,1590,70,110,448,433
"2021","Bradford 061","E02002243",7617,4287,2976,2966,10,8,1303,1256,47,3330,2058,62,143,583,484
"2021","Bradford 062","E02006945",7124,4884,3761,3737,24,3,1120,1092,28,2240,1278,57,108,409,388
"2021","Bradford 063","E02006946",4280,2575,1831,1814,17,2,742,720,22,1705,959,28,95,363,260
"2021","Bradford 064","E02006947",7144,3298,2737,2735,2,16,545,493,52,3846,2589,394,216,362,285
"2021","Bradford 065","E02006948",4786,1994,1549,1549,0,3,442,406,36,2792,1955,233,187,278,139
"2021","Calderdale 001","E02002244",4981,3073,2325,2317,8,8,740,724,16,1908,1131,27,86,318,346
"2021","Calderdale 002","E02002245",4062,2024,1289,1277,12,3,732,704,28,2038,1387,38,99,320,194
"2021","Calderdale 003","E02002246",8013,5237,4060,4052,8,1,1176,1146,30,2776,1553,50,142,481,550
"2021","Calderdale 004","E02002247",7487,4538,3147,2989,158,5,1386,1258,128,2949,1729,51,132,634,403
"2021","Calderdale 005","E02002248",6087,3198,2117,2111,6,3,1078,1038,40,2889,1855,54,143,483,354
"2021","Calderdale 006","E02002249",4152,2064,1300,1292,8,2,762,738,24,2088,1421,28,104,340,195
"2021","Calderdale 007","E02002250",6904,4184,3145,3061,84,5,1034,988,46,2720,1549,34,139,563,435
"2021","Calderdale 008","E02002251",6572,3027,1991,1959,32,7,1029,964,65,3545,2179,87,175,681,423
"2021","Calderdale 009","E02002252",5350,3462,2655,2621,34,3,804,774,30,1888,1112,68,83,296,329
"2021","Calderdale 010","E02002253",6078,3152,2508,2498,10,6,638,622,16,2926,1920,153,176,410,267
"2021","Calderdale 011","E02002254",5069,3295,2524,2506,18,5,766,744,22,1774,1019,27,70,341,317
"2021","Calderdale 012","E02002255",5638,2645,2376,2372,4,4,265,248,17,2993,1844,298,203,339,309
"2021","Calderdale 013","E02002256",7459,4118,2754,2684,70,0,1364,1282,82,3341,2082,85,162,638,374
"2021","Calderdale 014","E02002257",4714,2405,2047,2045,2,5,353,327,26,2309,1491,219,149,270,180
"2021","Calderdale 015","E02002258",7289,4482,3273,3245,28,3,1206,1142,64,2807,1650,59,162,489,447
"2021","Calderdale 016","E02002259",5716,3282,2440,2426,14,0,842,812,30,2434,1397,74,145,489,329
"2021","Calderdale 017","E02002260",7527,4164,2821,2799,22,3,1340,1296,44,3363,2049,51,179,674,410
"2021","Calderdale 018","E02002261",6479,3802,2626,2614,12,8,1168,1126,42,2677,1591,55,118,533,380
"2021","Calderdale 019","E02002262",6382,3682,2714,2700,14,8,960,920,40,2700,1562,50,129,461,498
"2021","Calderdale 020","E02002263",5174,3151,2244,2220,24,10,897,868,29,2023,1165,37,103,421,297
"2021","Calderdale 021","E02002264",5682,3536,2873,2849,24,1,662,630,32,2146,1184,59,97,403,403
"2021","Calderdale 022","E02002265",4602,2649,1881,1849,32,7,761,732,29,1953,1150,27,92,386,298
"2021","Calderdale 023","E02002266",4704,2969,2268,2259,9,4,697,682,15,1735,1021,41,93,289,291
"2021","Calderdale 024","E02002267",6511,3948,2926,2902,24,6,1016,990,26,2563,1502,37,133,468,423
"2021","Calderdale 025","E02002268",8251,4620,3280,3244,36,6,1334,1288,46,3631,2120,55,186,734,536
"2021","Calderdale 026","E02002269",7605,4850,3622,3590,32,4,1224,1180,44,2755,1654,48,145,525,383
"2021","Calderdale 027","E02002270",6883,4748,3715,3691,24,7,1026,986,40,2135,1260,39,110,402,324
"2021","Kirklees 001","E02002271",6037,3986,2962,2948,14,0,1024,994,30,2051,1192,33,88,356,382
"2021","Kirklees 002","E02002272",7678,4644,3288,3274,14,12,1344,1276,68,3034,1847,52,170,550,415
"2021","Kirklees 003","E02002273",5352,3509,2551,2540,11,2,956,910,46,1843,1110,29,72,317,315
"2021","Kirklees 004","E02002274",5496,3508,2689,2681,8,5,814,780,34,1988,1170,28,96,337,357
"2021","Kirklees 005","E02002275",6942,3908,2666,2656,10,0,1242,1182,60,3034,1757,49,176,596,456
"2021","Kirklees 006","E02002276",6056,3689,2721,2715,6,10,958,922,36,2367,1522,42,111,364,328
"2021","Kirklees 007","E02002277",5314,3189,2519,2509,10,4,666,632,34,2125,1406,115,79,267,258
"2021","Kirklees 008","E02002278",5271,3230,2322,2304,18,0,908,870,38,2041,1250,29,94,379,289
"2021","Kirklees 009","E02002279",4960,2710,1900,1884,16,2,808,774,34,2250,1349,48,125,434,294
"2021","Kirklees 010","E02002280",5255,2600,2152,2152,0,6,442,414,28,2655,1725,129,127,410,264
"2021","Kirklees 011","E02002281",8953,5153,4112,4100,12,5,1036,976,60,3800,2296,231,205,567,501
"2021","Kirklees 012","E02002282",5570,3187,2702,2692,10,1,484,470,14,2383,1597,143,124,289,230
"2021","Kirklees 013","E02002283",5613,3086,2734,2728,6,5,347,325,22,2527,1738,146,105,261,277
"2021","Kirklees 014","E02002284",5068,3078,2341,2333,8,3,734,718,16,1990,1192,40,92,335,331
"2021","Kirklees 015","E02002285",6445,4184,3151,3141,10,1,1032,1002,30,2261,1323,38,104,397,399
"2021","Kirklees 016","E02002286",4676,2538,2043,2019,24,1,494,478,16,2138,1350,100,123,314,251
"2021","Kirklees 017","E02002287",5522,2796,2219,2209,10,9,568,536,32,2726,1761,173,163,381,248
"2021","Kirklees 018","E02002288",7749,4534,3099,3083,16,6,1429,1363,66,3215,2048,66,170,530,401
"2021","Kirklees 019","E02002289",5025,2738,2314,2310,4,0,424,406,18,2287,1570,176,130,239,172
"2021","Kirklees 020","E02002290",5223,3412,2693,2675,18,5,714,678,36,1811,986,31,87,332,375
"2021","Kirklees 021","E02002291",5250,3346,2549,2539,10,5,792,766,26,1904,1127,30,97,320,330
"2021","Kirklees 022","E02002292",4605,2794,2255,2243,12,3,536,514,22,1811,1115,67,95,251,283
"2021","Kirklees 023","E02002293",6266,3276,2826,2822,4,7,443,416,27,2990,1978,279,166,351,216
"2021","Kirklees 024","E02002294",8260,4541,4152,4148,4,2,387,379,8,3719,2505,307,157,354,396
"2021","Kirklees 025","E02002295",5363,2486,1700,1684,16,10,776,744,32,2877,1913,79,151,454,280
"2021","Kirklees 026","E02002296",5769,3490,2642,2624,18,2,846,798,48,2279,1247,34,118,442,438
"2021","Kirklees 027","E02002297",5702,3571,2934,2924,10,2,635,609,26,2131,1317,87,83,328,316
"2021","Kirklees 028","E02002298",5364,3220,2340,2330,10,2,878,862,16,2144,1325,42,75,345,357
"2021","Kirklees 029","E02002299",5167,2104,1450,1442,8,10,644,614,30,3063,2166,155,153,375,214
"2021","Kirklees 030","E02002300",6832,4466,3425,3409,16,3,1038,996,42,2366,1335,55,96,408,472
"2021","Kirklees 031","E02002301",6096,3039,2480,2465,15,3,556,528,28,3057,2026,235,133,395,268
"2021","Kirklees 032","E02002302",4974,3266,2545,2527,18,3,718,696,22,1708,990,44,76,305,293
"2021","Kirklees 033","E02002303",5227,2979,2280,2268,12,9,690,652,38,2248,1385,62,104,364,333
"2021","Kirklees 034","E02002304",5400,2525,1771,1755,16,7,747,690,57,2875,2041,108,111,368,247
"2021","Kirklees 035","E02002305",4843,2265,1584,1571,13,1,680,648,32,2578,1694,94,117,403,270
"2021","Kirklees 036","E02002306",5199,3341,2598,2582,16,2,741,714,27,1858,1037,51,87,329,354
"2021","Kirklees 037","E02002307",4764,2637,1927,1917,10,2,708,684,24,2127,1295,29,112,366,325
"2021","Kirklees 038","E02002308",5497,3256,2244,2230,14,2,1010,986,24,2241,1400,45,119,424,253
"2021","Kirklees 039","E02002309",5268,2583,1929,1913,16,5,649,614,35,2685,1823,118,112,380,252
"2021","Kirklees 040","E02002310",4593,2376,1612,1588,24,4,760,734,26,2217,1384,65,110,369,289
"2021","Kirklees 041","E02002311",5150,3002,2058,2038,20,8,936,906,30,2148,1308,35,113,423,269
"2021","Kirklees 042","E02002312",5357,2358,1502,1487,15,5,851,790,61,2999,2199,108,102,380,210
"2021","Kirklees 043","E02002313",5699,2788,2338,2328,10,4,446,406,40,2911,1920,298,129,332,232
"2021","Kirklees 044","E02002314",4768,2844,2156,2136,20,2,686,668,18,1924,1102,40,87,314,381
"2021","Kirklees 045","E02002315",5424,2916,1906,1888,18,4,1006,984,22,2508,1619,39,139,452,259
"2021","Kirklees 046","E02002316",5600,3745,2793,2778,15,2,950,906,44,1855,1074,35,71,327,348
"2021","Kirklees 047","E02002317",5672,3032,2358,2350,8,16,658,628,30,2640,1676,96,137,397,334
"2021","Kirklees 048","E02002318",4994,2615,1863,1837,26,12,740,712,28,2379,1481,47,107,427,317
"2021","Kirklees 049","E02002319",5624,3454,2404,2370,34,0,1050,1004,46,2170,1295,31,115,437,292
"2021","Kirklees 050","E02002320",5110,3041,2307,2292,15,0,734,698,36,2069,1167,43,96,384,379
"2021","Kirklees 051","E02002321",5069,3366,2768,2732,36,6,592,564,28,1703,952,34,67,343,307
"2021","Kirklees 052","E02002322",5256,3429,2557,2527,30,0,872,840,32,1827,1081,25,102,315,304
"2021","Kirklees 053","E02002323",6814,4352,3477,3451,26,11,864,828,36,2462,1364,26,103,482,487
"2021","Kirklees 054","E02002324",5439,3550,2814,2790,24,2,734,710,24,1889,1049,24,79,331,406
"2021","Kirklees 055","E02002325",7275,4765,3565,3553,12,3,1197,1158,39,2510,1422,32,105,498,453
"2021","Kirklees 056","E02002326",4890,3412,2776,2764,12,0,636,614,22,1478,864,32,65,254,263
"2021","Kirklees 057","E02002327",8179,5536,4452,4426,26,10,1074,1022,52,2643,1532,33,113,471,494
"2021","Kirklees 058","E02002328",5783,3904,3117,3091,26,5,782,756,26,1879,1078,26,81,372,322
"2021","Kirklees 059","E02002329",10062,6662,5100,5062,38,2,1560,1496,64,3400,1949,59,160,688,544
"2021","Leeds 001","E02002330",5873,4158,3592,3589,3,4,562,540,22,1715,922,41,73,287,392
"2021","Leeds 002","E02002331",5398,3298,2498,2478,20,0,800,768,32,2100,1027,41,111,441,480
"2021","Leeds 003","E02002332",5300,3371,2616,2610,6,7,748,734,14,1929,1118,30,80,344,357
"2021","Leeds 004","E02002333",6522,4030,3011,2991,20,1,1018,980,38,2492,1342,44,100,548,458
"2021","Leeds 005","E02002334",6197,4166,3438,3418,20,0,728,708,20,2031,1033,27,103,388,480
"2021","Leeds 006","E02002335",6161,4490,3913,3881,32,1,576,554,22,1671,918,53,80,272,348
"2021","Leeds 007","E02002336",5671,3961,3340,3330,10,0,621,570,51,1710,944,43,69,272,382
"2021","Leeds 008","E02002337",6218,4429,3548,3535,13,5,876,852,24,1789,1040,41,98,302,308
"2021","Leeds 009","E02002338",5786,3798,2873,2844,29,5,920,892,28,1988,1120,35,74,389,370
"2021","Leeds 010","E02002339",4569,2532,1716,1704,12,2,814,782,32,2037,1222,27,85,420,283
"2021","Leeds 011","E02002340",4963,3092,2248,2230,18,10,834,804,30,1871,1007,27,82,350,405
"2021","Leeds 012","E02002341",5975,4129,3640,3630,10,4,485,467,18,1846,1048,63,58,267,410
"2021","Leeds 013","E02002342",4979,3194,2510,2492,18,0,684,660,24,1785,1026,29,61,300,369
"2021","Leeds 014","E02002343",4804,3236,2492,2468,24,2,742,718,24,1568,952,19,57,277,263
"2021","Leeds 015","E02002344",6338,3938,3418,3402,16,2,518,488,30,2400,1302,82,94,458,464
"2021","Leeds 016","E02002345",4982,3334,2878,2858,20,2,454,432,22,1648,1017,59,47,225,300
"2021","Leeds 017","E02002346",4909,2804,2040,2018,22,7,757,726,31,2105,1347,40,94,336,288
"2021","Leeds 018","E02002347",4846,2485,2017,2007,10,1,467,437,30,2361,1479,61,114,422,285
"2021","Leeds 019","E02002348",5207,2991,2261,2231,30,9,721,692,29,2216,1394,51,95,372,304
"2021","Leeds 020","E02002349",4717,2911,2240,2208,32,2,669,606,63,1806,1135,39,65,319,248
"2021","Leeds 021","E02002350",4872,3382,2806,2796,10,4,572,546,26,1490,863,40,31,196,360
"2021","Leeds 022","E02002351",4617,3294,2728,2716,12,6,560,540,20,1323,752,30,44,199,298
"2021","Leeds 023","E02002352",6286,3909,3067,3049,18,5,837,788,49,2377,1448,125,87,335,382
"2021","Leeds 024","E02002353",4721,2998,2408,2378,30,2,588,566,22,1723,1122,69,77,235,220
"2021","Leeds 025","E02002354",6467,3868,3042,3026,16,4,822,772,50,2599,1522,113,143,395,426
"2021","Leeds 027","E02002356",7184,5002,3754,3726,28,2,1246,1196,50,2182,1320,51,100,374,337
"2021","Leeds 028","E02002357",6661,3948,2620,2598,22,8,1320,1260,60,2713,1695,39,135,468,376
"2021","Leeds 029","E02002358",6772,4082,2962,2946,16,6,1114,1082,32,2690,1646,73,121,455,395
"2021","Leeds 030","E02002359",5391,3672,2940,2922,18,4,728,696,32,1719,905,34,82,296,402
"2021","Leeds 031","E02002360",5596,3288,2116,2092,24,4,1168,1046,122,2308,1520,41,103,391,253
"2021","Leeds 032","E02002361",4660,2736,2071,2039,32,5,660,630,30,1924,1302,80,68,268,206
"2021","Leeds 033","E02002362",6363,3164,2077,2063,14,9,1078,1040,38,3199,2163,72,134,525,305
"2021","Leeds 034","E02002363",6099,3410,2030,1976,54,4,1376,1284,92,2689,1942,44,112,342,249
"2021","Leeds 035","E02002364",4582,1960,1217,1213,4,5,738,708,30,2622,1685,27,157,477,276
"2021","Leeds 037","E02002366",6494,3616,3016,3004,12,7,593,564,29,2878,1848,196,102,330,402
"2021","Leeds 038","E02002367",4900,2147,1388,1374,14,18,741,711,30,2753,1941,97,136,391,188
"2021","Leeds 039","E02002368",6888,4634,3426,3388,38,0,1208,1154,54,2254,1302,52,106,408,386
"2021","Leeds 040","E02002369",5986,2986,1974,1958,16,28,984,934,50,3000,2008,89,158,446,299
"2021","Leeds 041","E02002370",5450,2740,1688,1678,10,0,1052,1010,42,2710,1779,42,120,448,321
"2021","Leeds 042","E02002371",8297,3221,2283,2261,22,4,934,876,58,5076,3706,236,227,565,342
"2021","Leeds 044","E02002373",8063,1352,644,622,22,0,708,656,52,6711,6407,34,41,140,89
"2021","Leeds 045","E02002374",5670,2790,1577,1549,28,3,1210,1126,84,2880,2206,56,86,285,247
"2021","Leeds 046","E02002375",4611,2362,1419,1403,16,3,940,898,42,2249,1544,41,119,335,210
"2021","Leeds 047","E02002376",5576,2662,2119,2115,4,5,538,498,40,2914,2041,174,151,334,214
"2021","Leeds 048","E02002377",5556,2355,1999,1995,4,6,350,330,20,3201,2319,299,143,216,224
"2021","Leeds 050","E02002379",4362,2108,1329,1317,12,5,774,740,34,2254,1588,43,100,308,215
"2021","Leeds 051","E02002380",4560,2704,1867,1861,6,5,832,796,36,1856,1161,24,92,301,278
"2021","Leeds 052","E02002381",5200,2976,1813,1797,16,3,1160,1110,50,2224,1413,36,143,381,251
"2021","Leeds 053","E02002382",4843,2206,1672,1668,4,6,528,480,48,2637,1753,272,185,276,151
"2021","Leeds 054","E02002383",7566,928,474,468,6,0,454,398,56,6638,6351,82,35,111,59
"2021","Leeds 055","E02002384",7748,2638,1723,1699,24,45,870,796,74,5110,4028,251,187,448,196
"2021","Leeds 056","E02002385",7604,2180,964,944,20,6,1210,1084,126,5424,4782,100,98,295,149
"2021","Leeds 057","E02002386",7754,4908,3746,3720,26,2,1160,1126,34,2846,1624,55,95,467,605
"2021","Leeds 058","E02002387",4798,2281,1343,1321,22,6,932,896,36,2517,1696,42,119,381,279
"2021","Leeds 059","E02002388",6232,3239,1998,1984,14,6,1235,1168,67,2993,2116,47,139,451,240
"2021","Leeds 060","E02002389",5568,2650,1900,1884,16,4,746,700,46,2918,1953,118,166,415,266
"2021","Leeds 061","E02002390",5708,3148,2060,2036,24,4,1084,1046,38,2560,1708,47,124,386,295
"2021","Leeds 062","E02002391",6425,3994,2715,2693,22,5,1274,1208,66,2431,1508,38,103,445,337
"2021","Leeds 063","E02002392",5308,1254,610,606,4,0,644,612,32,4054,3690,94,61,139,70
"2021","Leeds 064","E02002393",6614,2659,1975,1967,8,6,678,636,42,3955,2709,280,289,491,186
"2021","Leeds 065","E02002394",5568,2201,1523,1513,10,5,673,629,44,3367,2362,151,222,442,190
"2021","Leeds 066","E02002395",5751,3526,2787,2775,12,5,734,712,22,2225,1326,143,98,285,373
"2021","Leeds 067","E02002396",7389,4010,2606,2580,26,10,1394,1286,108,3379,2333,83,152,489,322
"2021","Leeds 068","E02002397",6242,3541,2499,2473,26,8,1034,980,54,2701,1692,41,138,486,344
"2021","Leeds 069","E02002398",6352,4106,3128,3112,16,0,978,882,96,2246,1340,46,88,323,449
"2021","Leeds 070","E02002399",4913,2418,1608,1598,10,0,810,774,36,2495,1764,58,121,310,242
"2021","Leeds 071","E02002400",7099,2998,1754,1736,18,12,1232,1168,64,4101,2891,123,224,569,294
"2021","Leeds 072","E02002401",4819,2216,1452,1446,6,14,750,708,42,2603,1852,69,130,315,237
"2021","Leeds 073","E02002402",4830,3270,2537,2527,10,9,724,692,32,1560,960,33,63,238,266
"2021","Leeds 074","E02002403",5157,3032,2275,2267,8,1,756,730,26,2125,1211,24,85,403,402
"2021","Leeds 075","E02002404",8553,3712,1865,1842,23,9,1838,1706,132,4841,3772,147,165,471,286
"2021","Leeds 076","E02002405",7162,4492,3382,3364,18,6,1104,1054,50,2670,1594,57,138,416,465
"2021","Leeds 077","E02002406",5969,4194,3361,3347,14,3,830,804,26,1775,1014,23,56,315,367
"2021","Leeds 078","E02002407",4831,2138,1232,1224,8,10,896,852,44,2693,1818,60,152,452,211
"2021","Leeds 079","E02002408",6125,3668,2513,2495,18,3,1152,1102,50,2457,1466,36,142,439,374
"2021","Leeds 080","E02002409",4880,2728,1860,1840,20,4,864,826,38,2152,1351,40,109,369,283
"2021","Leeds 081","E02002410",5639,3189,2129,2098,31,7,1053,1002,51,2450,1591,70,95,384,310
"2021","Leeds 082","E02002411",7173,3118,1708,1694,14,8,1402,1328,74,4055,3101,153,151,450,200
"2021","Leeds 083","E02002412",5872,3534,2362,2344,18,4,1168,1120,48,2338,1518,40,104,356,320
"2021","Leeds 085","E02002414",4999,2106,1508,1504,4,19,579,536,43,2893,1933,158,154,448,200
"2021","Leeds 086","E02002415",5581,2246,1715,1715,0,13,518,480,38,3335,2388,269,171,364,143
"2021","Leeds 087","E02002416",5658,3640,2766,2760,6,2,872,830,42,2018,1101,38,70,361,448
"2021","Leeds 088","E02002417",5872,3860,2708,2686,22,6,1146,1100,46,2012,1189,25,94,321,383
"2021","Leeds 089","E02002418",5808,3752,2820,2802,18,6,926,898,28,2056,1227,23,89,372,345
"2021","Leeds 090","E02002419",6309,3114,2215,2193,22,7,892,856,36,3195,2026,102,210,509,348
"2021","Leeds 091","E02002420",6404,3466,2559,2549,10,9,898,862,36,2938,1906,127,165,412,328
"2021","Leeds 092","E02002421",4745,2119,1380,1364,16,2,737,703,34,2626,1765,60,146,389,266
"2021","Leeds 093","E02002422",5300,3571,2673,2651,22,3,895,836,59,1729,1044,35,79,272,299
"2021","Leeds 094","E02002423",4495,2358,1560,1554,6,2,796,768,28,2137,1383,41,109,334,270
"2021","Leeds 095","E02002424",6160,3863,2734,2711,23,1,1128,1064,64,2297,1420,42,96,389,350
"2021","Leeds 096","E02002425",7092,4516,3354,3324,30,6,1156,1108,48,2576,1477,48,148,438,465
"2021","Leeds 097","E02002426",6282,4050,3080,3068,12,2,968,922,46,2232,1332,32,90,391,387
"2021","Leeds 098","E02002427",5476,3306,2406,2394,12,4,896,866,30,2170,1232,27,133,376,402
"2021","Leeds 099","E02002428",6283,3739,2660,2613,47,7,1072,1014,58,2544,1708,59,118,362,297
"2021","Leeds 100","E02002429",6836,4409,3206,3178,28,7,1196,1132,64,2427,1441,31,106,426,423
"2021","Leeds 101","E02002430",5907,2731,1764,1758,6,6,961,921,40,3176,2173,61,166,491,285
"2021","Leeds 102","E02002431",7121,4294,2678,2650,28,30,1586,1464,122,2827,1915,42,135,452,283
"2021","Leeds 103","E02002432",6069,3904,2848,2816,32,2,1054,1024,30,2165,1309,28,100,381,347
"2021","Leeds 104","E02002433",5782,3060,1910,1874,36,8,1142,1088,54,2722,1675,58,125,502,362
"2021","Leeds 105","E02002434",7813,5110,3600,3566,34,5,1505,1440,65,2703,1779,51,133,459,281
"2021","Leeds 106","E02002435",6672,4266,3064,3032,32,4,1198,1138,60,2406,1439,44,116,434,373
"2021","Leeds 107","E02002436",5528,3338,2308,2280,28,6,1024,974,50,2190,1314,40,112,382,342
"2021","Leeds 108","E02002437",5102,3554,2847,2839,8,9,698,676,22,1548,946,36,63,224,279
"2021","Leeds 109","E02006852",9504,5249,3588,3543,45,7,1654,1552,102,4255,3267,109,110,411,358
"2021","Leeds 110","E02006861",10945,2264,1048,1038,10,4,1212,1106,106,8681,8176,78,80,205,142
"2021","Leeds 111","E02006875",5450,2078,588,562,26,4,1486,1350,136,3372,3079,79,55,128,31
"2021","Leeds 112","E02006876",6157,3028,1515,1485,30,1,1512,1368,144,3129,2442,73,107,311,196
"2021","Wakefield 001","E02002438",6799,3986,2556,2544,12,6,1424,1372,52,2813,1756,35,173,466,383
"2021","Wakefield 002","E02002439",7134,3915,2409,2368,41,0,1506,1428,78,3219,1862,74,183,665,435
"2021","Wakefield 003","E02002440",6346,3966,2858,2844,14,2,1106,1064,42,2380,1434,43,122,384,397
"2021","Wakefield 004","E02002441",7814,4582,3052,3028,24,2,1528,1468,60,3232,1943,48,186,598,457
"2021","Wakefield 005","E02002442",6033,4026,2762,2756,6,6,1258,1182,76,2007,1232,31,100,351,293
"2021","Wakefield 006","E02002443",4973,3251,2465,2444,21,2,784,762,22,1722,1050,33,82,297,260
"2021","Wakefield 007","E02002444",5644,3658,2567,2547,20,5,1086,1044,42,1986,1178,41,96,394,277
"2021","Wakefield 008","E02002445",6809,4292,3164,3142,22,4,1124,1090,34,2517,1426,43,108,480,460
"2021","Wakefield 009","E02002446",4993,3299,2506,2488,18,4,789,759,30,1694,954,30,77,295,338
"2021","Wakefield 010","E02002447",4895,2804,2008,1990,18,0,796,778,18,2091,1212,36,116,351,376
"2021","Wakefield 011","E02002448",6434,3708,2384,2360,24,2,1322,1280,42,2726,1618,50,142,470,446
"2021","Wakefield 012","E02002449",7780,5414,3734,3704,30,4,1676,1608,68,2366,1439,28,107,425,367
"2021","Wakefield 013","E02002450",6401,4172,2871,2865,6,5,1296,1226,70,2229,1369,42,125,418,275
"2021","Wakefield 014","E02002451",6545,4331,3357,3340,17,4,970,944,26,2214,1208,34,104,430,438
"2021","Wakefield 015","E02002452",7453,4191,2736,2710,26,0,1455,1406,49,3262,1926,45,200,692,399
"2021","Wakefield 016","E02002453",7785,4340,2902,2884,18,4,1434,1361,73,3445,2042,72,151,728,452
"2021","Wakefield 017","E02002454",7387,3630,2581,2541,40,13,1036,978,58,3757,2401,230,200,605,321
"2021","Wakefield 018","E02002455",5045,2839,1946,1936,10,0,893,866,27,2206,1357,35,99,387,328
"2021","Wakefield 019","E02002456",5906,3288,2234,2200,34,15,1039,988,51,2618,1727,92,134,419,246
"2021","Wakefield 020","E02002457",6099,3304,2450,2426,24,8,846,802,44,2795,1742,98,151,487,317
"2021","Wakefield 021","E02002458",7345,4672,3424,3403,21,3,1245,1209,36,2673,1551,41,117,494,470
"2021","Wakefield 022","E02002459",7861,4624,3279,3255,24,5,1340,1286,54,3237,2035,88,147,563,404
"2021","Wakefield 023","E02002460",6234,4084,3286,3260,26,0,798,768,30,2150,1150,36,97,395,472
"2021","Wakefield 024","E02002461",9397,6057,4208,4169,39,9,1840,1792,48,3340,2052,31,181,578,498
"2021","Wakefield 025","E02002462",6116,3626,2774,2758,16,4,848,812,36,2490,1395,44,132,458,461
"2021","Wakefield 026","E02002463",7729,4222,2841,2809,32,5,1376,1318,58,3507,2208,68,174,660,397
"2021","Wakefield 027","E02002464",7241,4299,2828,2809,19,5,1466,1408,58,2942,1786,36,140,528,452
"2021","Wakefield 028","E02002465",5277,3232,2409,2389,20,7,816,790,26,2045,1140,53,87,383,382
"2021","Wakefield 029","E02002466",7475,4616,3440,3422,18,2,1174,1108,66,2859,1528,35,147,612,537
"2021","Wakefield 030","E02002467",7125,3770,2315,2297,18,11,1444,1354,90,3355,2232,126,174,543,280
"2021","Wakefield 031","E02002468",5046,3214,2439,2429,10,1,774,750,24,1832,1063,21,87,353,308
"2021","Wakefield 032","E02002469",5346,3506,2738,2722,16,6,762,736,26,1840,1071,18,85,325,341
"2021","Wakefield 033","E02002470",5152,3658,3204,3178,26,4,450,434,16,1494,755,44,57,229,409
"2021","Wakefield 034","E02002471",9511,6519,5075,5066,9,4,1440,1390,50,2992,1616,81,128,564,603
"2021","Wakefield 035","E02002472",4684,3108,2410,2390,20,8,690,676,14,1576,867,24,67,289,329
"2021","Wakefield 036","E02002473",5576,3738,2840,2820,20,4,894,850,44,1838,986,23,95,390,344
"2021","Wakefield 037","E02002474",5527,3312,2318,2284,34,0,994,958,36,2215,1290,28,121,434,342
"2021","Wakefield 038","E02002475",5195,3658,2963,2947,16,8,687,662,25,1537,804,29,69,298,337
"2021","Wakefield 039","E02002476",5132,2986,1924,1906,18,6,1056,1014,42,2146,1367,34,111,339,295
"2021","Wakefield 040","E02002477",5086,3090,2233,2221,12,6,851,804,47,1996,1167,35,111,367,316
"2021","Wakefield 041","E02002478",5025,3222,2234,2220,14,6,982,948,34,1803,1093,29,98,322,261
"2021","Wakefield 042","E02002479",6774,3959,2917,2905,12,5,1037,992,45,2815,1594,57,122,514,528
"2021","Wakefield 043","E02002480",4630,2542,1861,1857,4,5,676,660,16,2088,1175,33,105,396,379
"2021","Wakefield 044","E02002481",5810,3460,2434,2420,14,2,1024,992,32,2350,1440,31,116,406,357
"2021","Wakefield 045","E02002482",5490,3225,2262,2244,18,4,959,928,31,2265,1394,37,108,379,347
"2021","Derby 001","E02002796",5046,3435,2894,2886,8,3,538,504,34,1611,877,23,81,287,343
"2021","Derby 002","E02002797",6216,4100,3490,3484,6,6,604,578,26,2116,1103,30,68,302,613
"2021","Derby 003","E02002798",8721,5759,4208,4172,36,2,1549,1496,53,2962,1952,47,109,514,340
"2021","Derby 004","E02002799",4978,2760,1771,1751,20,1,988,948,40,2218,1495,30,87,340,266
"2021","Derby 005","E02002800",5670,3340,2567,2545,22,3,770,736,34,2330,1433,42,95,412,348
"2021","Derby 006","E02002801",6075,3608,2593,2583,10,11,1004,950,54,2467,1478,52,100,388,449
"2021","Derby 007","E02002802",5993,3036,1944,1920,24,5,1087,1051,36,2957,1936,46,147,519,309
"2021","Derby 008","E02002803",5988,2406,1204,1184,20,0,1202,1120,82,3582,2646,51,116,531,238
"2021","Derby 009","E02002804",7061,3999,2820,2784,36,11,1168,1110,58,3062,1949,62,137,469,445
"2021","Derby 010","E02002805",4739,3098,2469,2459,10,3,626,594,32,1641,804,26,73,302,436
"2021","Derby 011","E02002806",5217,2079,1036,1024,12,0,1043,950,93,3138,2445,89,92,353,159
"2021","Derby 012","E02002807",7216,4334,3140,3116,24,6,1188,1152,36,2882,1786,35,128,514,419
"2021","Derby 013","E02002808",9695,3874,1999,1977,22,11,1864,1754,110,5821,4376,150,225,793,277
"2021","Derby 014","E02002809",5572,3258,2274,2268,6,12,972,930,42,2314,1360,35,101,436,382
"2021","Derby 015","E02002810",7480,5070,4010,3996,14,14,1046,1002,44,2410,1371,54,96,371,518
"2021","Derby 016","E02002811",8251,3812,3049,3039,10,5,758,728,30,4439,3057,423,204,474,281
"2021","Derby 017","E02002812",6131,3486,2858,2840,18,4,624,598,26,2645,1721,131,114,345,334
"2021","Derby 018","E02002813",8495,3975,3069,3062,7,8,898,856,42,4520,2991,439,225,538,327
"2021","Derby 019","E02002814",6037,3908,3315,3307,8,3,590,566,24,2129,1110,49,77,428,465
"2021","Derby 020","E02002815",6356,3195,2770,2766,4,8,417,397,20,3161,2026,425,138,317,255
"2021","Derby 021","E02002816",7293,4590,4104,4094,10,0,486,476,10,2703,1739,124,129,385,326
"2021","Derby 022","E02002817",5122,3174,2705,2691,14,3,466,448,18,1948,1118,107,80,283,360
"2021","Derby 023","E02002818",6180,2945,2407,2401,6,8,530,494,36,3235,2151,245,158,392,289
"2021","Derby 024","E02002819",6062,3318,2173,2152,21,3,1142,1076,66,2744,1720,55,145,511,313
"2021","Derby 025","E02002820",7730,4166,2787,2767,20,7,1372,1326,46,3564,2294,85,155,574,456
"2021","Derby 026","E02002821",9034,4403,2871,2859,12,14,1518,1458,60,4631,3258,180,226,572,395
"2021","Derby 027","E02002822",5475,3119,2483,2474,9,6,630,614,16,2356,1383,83,110,373,407
"2021","Derby 028","E02002823",6213,3518,2527,2517,10,3,988,948,40,2695,1599,47,102,479,468
"2021","Derby 029","E02002824",8215,4422,3363,3353,10,11,1048,1018,30,3793,2404,166,184,611,428
"2021","Derby 030","E02002825",6883,4134,3193,3177,16,11,930,890,40,2749,1638,78,122,434,477
"2021","Derby 031","E02002826",5656,3550,2752,2744,8,10,788,754,34,2106,1355,34,92,343,282
"2021","Leicester 001","E02002827",5271,2885,2175,2172,3,6,704,676,28,2386,1653,81,119,331,202
"2021","Leicester 002","E02002828",6756,4024,3575,3569,6,9,440,426,14,2732,1662,173,104,320,473
"2021","Leicester 003","E02002829",8667,4171,3059,3043,16,9,1103,1040,63,4496,3090,185,197,612,412
"2021","Leicester 004","E02002830",8082,4186,3176,3168,8,8,1002,964,38,3896,2695,186,180,543,292
"2021","Leicester 005","E02002831",5731,3198,2982,2980,2,2,214,214,0,2533,1534,260,98,259,382
"2021","Leicester 006","E02002832",8319,4490,4192,4184,8,4,294,284,10,3829,2150,542,116,407,614
"2021","Leicester 007","E02002833",7276,3948,3708,3704,4,6,234,230,4,3328,2023,421,115,273,496
"2021","Leicester 008","E02002834",9484,5354,4194,4176,18,10,1150,1082,68,4130,2728,258,142,488,514
"2021","Leicester 010","E02002836",9182,4825,4581,4571,10,1,243,229,14,4357,2488,707,103,351,708
"2021","Leicester 011","E02002837",7410,3699,3273,3271,2,5,421,392,29,3711,2511,417,127,330,326
"2021","Leicester 012","E02002838",6150,2889,1984,1982,2,4,901,862,39,3261,2274,89,146,449,303
"2021","Leicester 013","E02002839",6542,3664,3096,3096,0,6,562,538,24,2878,1816,142,102,413,405
"2021","Leicester 016","E02002842",6506,3156,1912,1892,20,4,1240,1178,62,3350,2337,215,155,477,166
"2021","Leicester 017","E02002843",12079,6567,6225,6215,10,7,335,316,19,5512,3364,1040,150,385,573
"2021","Leicester 018","E02002844",9085,4651,4409,4403,6,3,239,227,12,4434,2955,415,151,432,481
"2021","Leicester 019","E02002845",8401,4224,3805,3801,4,13,406,386,20,4177,2623,344,190,548,472
"2021","Leicester 020","E02002846",6110,3734,2806,2778,28,6,922,878,44,2376,1581,75,84,355,281
"2021","Leicester 021","E02002847",8168,4485,4255,4249,6,5,225,210,15,3683,2457,456,98,242,430
"2021","Leicester 022","E02002848",8365,4212,3858,3850,8,10,344,334,10,4153,2839,422,151,333,408
"2021","Leicester 023","E02002849",10319,4143,2348,2320,28,9,1786,1656,130,6176,4877,269,177,610,243
"2021","Leicester 025","E02002851",6982,4099,3824,3818,6,10,265,259,6,2883,1802,191,102,296,492
"2021","Leicester 026","E02002852",5310,2370,1534,1518,16,8,828,790,38,2940,2148,74,108,353,257
"2021","Leicester 027","E02002853",10238,5310,4934,4924,10,12,364,338,26,4928,3517,476,99,389,447
"2021","Leicester 028","E02002854",6334,3031,2044,2020,24,12,975,925,50,3303,2288,134,153,458,270
"2021","Leicester 029","E02002855",6317,3388,2350,2330,20,7,1031,966,65,2929,2120,178,81,318,232
"2021","Leicester 030","E02002856",9713,4276,2811,2756,55,5,1460,1362,98,5437,4260,136,123,551,367
"2021","Leicester 031","E02002857",5697,2723,1518,1488,30,0,1205,1136,69,2974,2202,69,133,392,178
"2021","Leicester 032","E02002858",5906,3734,3111,3080,31,6,617,592,25,2172,1371,85,84,299,333
"2021","Leicester 034","E02002860",6560,3845,2751,2731,20,7,1087,1040,47,2715,1772,54,101,443,345
"2021","Leicester 035","E02002861",6006,2702,1823,1813,10,13,866,830,36,3304,2428,87,137,366,286
"2021","Leicester 036","E02002862",6472,3110,1931,1913,18,15,1164,1120,44,3362,2093,86,206,580,397
"2021","Leicester 037","E02006815",8543,4654,3770,3760,10,12,872,806,66,3889,2484,166,156,586,497
"2021","Leicester 038","E02006817",6735,3505,2766,2750,16,6,733,698,35,3230,2339,134,110,324,323
"2021","Leicester 039","E02006819",6312,3094,2083,2073,10,15,996,948,48,3218,2261,99,152,434,272
"2021","Leicester 040","E02006850",5438,1570,976,976,0,0,594,522,72,3868,3121,205,111,291,140
"2021","Leicester 041","E02006851",6064,1930,795,774,21,5,1130,1044,86,4134,3475,235,134,240,50
"2021","Leicester 042","E02006964",4910,2961,2554,2550,4,10,397,379,18,1949,1304,136,73,265,171
"2021","Leicester 043","E02006965",6407,3595,3218,3210,8,3,374,352,22,2812,1833,170,103,365,341
"2021","Rutland 001","E02002863",5552,3999,3388,3366,22,1,610,588,22,1553,820,37,89,275,332
"2021","Rutland 002","E02002864",6708,4491,3520,3494,26,1,970,946,24,2217,1231,35,124,448,379
"2021","Rutland 003","E02002865",6321,4072,3322,3310,12,0,750,712,38,2249,1126,41,132,427,523
"2021","Rutland 004","E02002866",6153,4232,3552,3542,10,4,676,636,40,1921,1000,44,88,391,398
"2021","Rutland 005","E02002867",6539,4322,3560,3522,38,2,760,722,38,2217,1124,58,124,459,452
"2021","Nottingham 001","E02002868",4906,2904,2278,2270,8,2,624,598,26,2002,1227,49,76,285,365
"2021","Nottingham 002","E02002869",5756,2770,1785,1765,20,5,980,946,34,2986,1934,72,146,512,322
"2021","Nottingham 004","E02002871",6294,3404,2316,2304,12,4,1084,1034,50,2890,1927,53,125,457,328
"2021","Nottingham 005","E02002872",6684,3242,2143,2129,14,5,1094,1048,46,3442,2357,73,151,513,348
"2021","Nottingham 006","E02002873",7059,3488,2259,2239,20,7,1222,1176,46,3571,2510,103,155,494,309
"2021","Nottingham 007","E02002874",5906,3078,2113,2076,37,4,961,904,57,2828,1939,88,111,348,342
"2021","Nottingham 008","E02002875",6464,3123,1970,1960,10,12,1141,1105,36,3341,2279,84,180,460,338
"2021","Nottingham 009","E02002876",6216,3266,2299,2273,26,7,960,920,40,2950,1920,83,142,469,336
"2021","Nottingham 010","E02002877",6413,3386,2134,2076,58,2,1250,1174,76,3027,2022,95,103,526,281
"2021","Nottingham 011","E02002878",6326,2860,1848,1842,6,14,998,966,32,3466,2586,141,153,388,198
"2021","Nottingham 012","E02002879",7590,4114,2807,2771,36,11,1296,1232,64,3476,2436,130,171,467,272
"2021","Nottingham 013","E02002880",6273,2966,2031,2019,12,9,926,892,34,3307,2352,95,148,481,231
"2021","Nottingham 014","E02002881",5146,2536,1715,1697,18,7,814,782,32,2610,1802,70,108,391,239
"2021","Nottingham 015","E02002882",7047,3328,2092,2048,44,2,1234,1136,98,3719,2762,122,148,463,224
"2021","Nottingham 016","E02002883",6084,3102,1871,1847,24,5,1226,1154,72,2982,2060,68,145,496,213
"2021","Nottingham 017","E02002884",5712,2478,1696,1680,16,8,774,720,54,3234,2380,301,102,284,167
"2021","Nottingham 018","E02002885",6566,2689,1968,1966,2,3,718,646,72,3877,2929,252,149,337,210
"2021","Nottingham 019","E02002886",7803,4208,3537,3499,38,11,660,630,30,3595,2388,239,146,414,408
"2021","Nottingham 020","E02002887",5262,2598,2000,1992,8,4,594,552,42,2664,1635,75,124,427,403
"2021","Nottingham 021","E02002888",5844,2617,1702,1684,18,32,883,844,39,3227,2186,118,165,516,242
"2021","Nottingham 022","E02002889",6518,1129,589,568,21,2,538,496,42,5389,4966,86,69,203,65
"2021","Nottingham 023","E02002890",7386,2134,1197,1184,13,8,929,858,71,5252,4360,106,156,441,189
"2021","Nottingham 024","E02002891",6646,3523,2660,2644,16,2,861,828,33,3123,2018,180,128,418,379
"2021","Nottingham 025","E02002892",4887,2423,1752,1740,12,6,665,644,21,2464,1597,79,82,366,340
"2021","Nottingham 026","E02002893",8819,2613,1916,1904,12,5,692,642,50,6206,5182,270,173,407,174
"2021","Nottingham 028","E02002895",8345,2194,1254,1224,30,0,940,874,66,6151,5633,71,73,249,125
"2021","Nottingham 029","E02002896",7864,3212,1998,1980,18,4,1210,1128,82,4652,3424,229,198,542,259
"2021","Nottingham 030","E02002897",6348,4119,3557,3553,4,5,557,530,27,2229,1303,88,79,293,466
"2021","Nottingham 031","E02002898",9802,1581,936,924,12,0,645,598,47,8221,7675,131,43,231,141
"2021","Nottingham 034","E02002901",5008,3141,2301,2282,19,2,838,806,32,1867,1149,35,73,288,322
"2021","Nottingham 035","E02002902",6452,3396,2348,2326,22,0,1048,1004,44,3056,2051,60,108,434,403
"2021","Nottingham 036","E02002903",4770,2504,1765,1761,4,5,734,696,38,2266,1368,49,85,336,428
"2021","Nottingham 037","E02002904",4968,2627,1724,1716,8,5,898,868,30,2341,1519,48,103,335,336
"2021","Nottingham 038","E02006834",5988,2658,1748,1732,16,4,906,872,34,3330,2039,73,128,592,498
"2021","Nottingham 039","E02006904",7082,2642,1130,1102,28,8,1504,1374,130,4440,3874,104,102,270,90
"2021","Nottingham 040","E02006905",6013,2490,1649,1637,12,7,834,762,72,3523,2487,175,177,457,227
"2021","Nottingham 041","E02007082",9619,5450,4398,4352,46,6,1046,996,50,4169,2862,162,109,480,556
"2021","North Northamptonshire 002","E02005612",5893,3722,2761,2745,16,5,956,932,24,2171,1318,57,121,363,312
"2021","North Northamptonshire 003","E02005613",7478,4204,2905,2893,12,5,1294,1244,50,3274,1984,74,174,583,459
"2021","North Northamptonshire 006","E02005614",10619,6974,4560,4514,46,14,2400,2308,92,3645,2263,139,223,634,386
"2021","North Northamptonshire 004","E02005615",7601,4317,3040,3026,14,12,1265,1217,48,3284,1914,80,182,570,538
"2021","North Northamptonshire 005","E02005616",4720,2468,1709,1691,18,3,756,736,20,2252,1386,82,127,405,252
"2021","North Northamptonshire 007","E02005617",8750,4478,2934,2920,14,16,1528,1456,72,4272,2736,183,221,694,438
"2021","North Northamptonshire 001","E02005629",5331,3694,3030,3014,16,5,659,644,15,1637,888,37,81,317,314
"2021","North Northamptonshire 010","E02005630",8102,5464,4593,4555,38,5,866,840,26,2638,1438,49,130,508,513
"2021","North Northamptonshire 011","E02005631",9123,6105,4603,4577,26,13,1489,1436,53,3018,1758,70,162,530,498
"2021","North Northamptonshire 024","E02005632",5330,3752,2973,2957,16,5,774,740,34,1578,896,31,94,270,287
"2021","North Northamptonshire 025","E02005633",7926,5224,3708,3694,14,6,1510,1448,62,2702,1540,46,164,515,437
"2021","North Northamptonshire 027","E02005634",7437,4546,3161,3151,10,9,1376,1320,56,2891,1758,50,184,525,374
"2021","North Northamptonshire 035","E02005635",7553,4884,3638,3604,34,8,1238,1198,40,2669,1524,65,141,517,422
"2021","North Northamptonshire 034","E02005636",9739,6040,4298,4270,28,8,1734,1678,56,3699,2156,82,198,724,539
"2021","North Northamptonshire 037","E02005637",7501,3996,2445,2423,22,9,1542,1468,74,3505,2025,82,229,710,459
"2021","North Northamptonshire 039","E02005638",8240,5597,4438,4426,12,6,1153,1128,25,2643,1569,60,120,428,466
"2021","North Northamptonshire 012","E02005639",4719,3280,2628,2606,22,2,650,626,24,1439,782,36,72,256,293
"2021","North Northamptonshire 013","E02005640",9429,6259,4574,4543,31,13,1672,1616,56,3170,1825,64,188,581,512
"2021","North Northamptonshire 014","E02005641",7015,4380,3092,3074,18,10,1278,1244,34,2635,1542,46,145,514,388
"2021","North Northamptonshire 015","E02005642",6826,4437,3437,3428,9,10,990,964,26,2389,1450,68,112,394,365
"2021","North Northamptonshire 016","E02005643",6626,3590,2318,2308,10,12,1260,1222,38,3036,1979,45,183,534,295
"2021","North Northamptonshire 017","E02005644",7220,3656,2183,2169,14,3,1470,1390,80,3564,2347,168,207,638,204
"2021","North Northamptonshire 018","E02005645",9915,5595,3961,3929,32,11,1623,1552,71,4320,2563,135,221,840,561
"2021","North Northamptonshire 019","E02005646",5345,3546,2802,2780,22,4,740,722,18,1799,962,52,97,317,371
"2021","North Northamptonshire 022","E02005647",6075,3479,2501,2495,6,6,972,936,36,2596,1527,74,139,474,382
"2021","North Northamptonshire 021","E02005648",7708,5345,4104,4070,34,1,1240,1198,42,2363,1463,51,90,352,407
"2021","North Northamptonshire 026","E02005692",5884,3708,2830,2802,28,6,872,836,36,2176,1246,38,126,383,383
"2021","North Northamptonshire 028","E02005693",6755,3961,2994,2986,8,9,958,928,30,2794,1766,106,131,418,373
"2021","North Northamptonshire 029","E02005694",6323,4176,3349,3341,8,3,824,800,24,2147,1262,60,96,361,368
"2021","North Northamptonshire 030","E02005695",7980,4507,2858,2842,16,16,1633,1566,67,3473,2219,157,176,563,358
"2021","North Northamptonshire 031","E02005696",4828,2522,1613,1609,4,7,902,868,34,2306,1398,56,140,427,285
"2021","North Northamptonshire 032","E02005697",5858,2917,1958,1949,9,3,956,910,46,2941,1822,104,146,552,317
"2021","North Northamptonshire 033","E02005698",4742,2753,2056,2048,8,6,691,669,22,1989,1184,63,104,338,300
"2021","North Northamptonshire 036","E02005699",6605,3860,2756,2732,24,4,1100,1068,32,2745,1803,67,144,424,307
"2021","North Northamptonshire 038","E02005700",8542,5720,4417,4389,28,5,1298,1252,46,2822,1525,55,132,541,569
"2021","North Northamptonshire 040","E02005701",9147,5902,4554,4534,20,12,1336,1296,40,3245,1796,57,184,639,569
"2021","North Northamptonshire 009","E02006862",5352,3295,2429,2411,18,13,853,814,39,2057,1256,64,99,349,289
"2021","North Northamptonshire 008","E02006863",8842,5818,4242,4203,39,14,1562,1504,58,3024,1998,126,196,499,205
"2021","North Northamptonshire 020","E02007070",5089,3628,2865,2831,34,9,754,728,26,1461,872,23,73,243,250
"2021","North Northamptonshire 023","E02007071",8097,5274,3759,3737,22,5,1510,1468,42,2823,1670,51,157,530,415
"2021","West Northamptonshire 001","E02005619",5193,3652,2993,2973,20,5,654,626,28,1541,906,26,71,243,295
"2021","West Northamptonshire 002","E02005620",6870,4685,3715,3693,22,7,963,938,25,2185,1300,36,130,380,339
"2021","West Northamptonshire 004","E02005621",6479,4513,3640,3614,26,5,868,848,20,1966,1053,33,100,345,435
"2021","West Northamptonshire 005","E02005622",8093,5657,4522,4495,27,7,1128,1096,32,2436,1418,69,127,393,429
"2021","West Northamptonshire 003","E02005623",9085,6270,4697,4663,34,3,1570,1508,62,2815,1652,43,166,464,490
"2021","West Northamptonshire 010","E02005624",9269,6141,4389,4360,29,8,1744,1694,50,3128,1929,77,166,579,377
"2021","West Northamptonshire 016","E02005625",7653,4594,3361,3341,20,7,1226,1176,50,3059,1768,99,202,502,488
"2021","West Northamptonshire 022","E02005626",5611,3262,2250,2234,16,4,1008,970,38,2349,1442,95,119,436,257
"2021","West Northamptonshire 027","E02005627",6311,4134,3192,3152,40,2,940,902,38,2177,1189,57,124,446,361
"2021","West Northamptonshire 042","E02005628",7015,4682,3638,3606,32,4,1040,1012,28,2333,1357,50,112,429,385
"2021","West Northamptonshire 006","E02005650",5256,3307,2447,2435,12,7,853,816,37,1949,1218,68,79,286,298
"2021","West Northamptonshire 007","E02005651",5413,3482,2738,2728,10,2,742,728,14,1931,1044,60,76,326,425
"2021","West Northamptonshire 008","E02005652",5514,3480,2645,2632,13,2,833,799,34,2034,1148,66,101,338,381
"2021","West Northamptonshire 011","E02005653",6664,3552,2449,2443,6,17,1086,1036,50,3112,2080,175,153,482,222
"2021","West Northamptonshire 009","E02005654",6628,3671,2530,2505,25,11,1130,1086,44,2957,1940,130,149,488,250
"2021","West Northamptonshire 012","E02005655",5214,3153,2543,2534,9,6,604,574,30,2061,1123,71,77,382,408
"2021","West Northamptonshire 014","E02005656",4978,2563,1845,1843,2,10,708,680,28,2415,1565,127,121,378,224
"2021","West Northamptonshire 013","E02005657",5504,3327,2445,2433,12,10,872,832,40,2177,1250,67,93,410,357
"2021","West Northamptonshire 015","E02005658",5341,2644,1716,1704,12,8,920,886,34,2697,1850,109,144,402,192
"2021","West Northamptonshire 018","E02005659",4769,2922,2231,2217,14,13,678,650,28,1847,1024,65,81,344,333
"2021","West Northamptonshire 026","E02005660",5166,2844,2018,2004,14,6,820,788,32,2322,1385,89,140,435,273
"2021","West Northamptonshire 017","E02005661",5269,2726,1956,1936,20,10,760,716,44,2543,1748,80,134,359,222
"2021","West Northamptonshire 019","E02005662",5457,3070,2210,2200,10,6,854,806,48,2387,1515,93,95,388,296
"2021","West Northamptonshire 023","E02005663",4584,3058,2332,2318,14,2,724,696,28,1526,892,49,75,266,244
"2021","West Northamptonshire 025","E02005664",4884,2488,1598,1574,24,6,884,820,64,2396,1590,110,111,375,210
"2021","West Northamptonshire 024","E02005665",6908,4211,3312,3292,20,2,897,865,32,2697,1710,130,122,446,289
"2021","West Northamptonshire 021","E02005666",6766,3308,2277,2255,22,11,1020,994,26,3458,2295,163,183,495,322
"2021","West Northamptonshire 020","E02005667",5287,3114,2332,2310,22,2,780,750,30,2173,1234,60,116,432,331
"2021","West Northamptonshire 028","E02005668",5319,3436,2669,2657,12,3,764,746,18,1883,1043,43,79,296,422
"2021","West Northamptonshire 029","E02005669",4949,3351,2894,2888,6,0,457,428,29,1598,973,38,63,196,328
"2021","West Northamptonshire 032","E02005670",7764,3448,2073,2055,18,7,1368,1288,80,4316,3010,239,199,658,210
"2021","West Northamptonshire 030","E02005671",6488,3192,1962,1942,20,2,1228,1154,74,3296,2260,198,151,429,258
"2021","West Northamptonshire 031","E02005672",7093,3269,1938,1914,24,5,1326,1244,82,3824,2762,276,142,459,185
"2021","West Northamptonshire 033","E02005673",6254,3408,2242,2230,12,8,1158,1068,90,2846,1797,132,155,447,315
"2021","West Northamptonshire 034","E02005674",7008,3460,2262,2248,14,3,1195,1109,86,3548,2453,179,158,515,243
"2021","West Northamptonshire 036","E02005675",4836,2724,1871,1859,12,9,844,806,38,2112,1328,81,98,408,197
"2021","West Northamptonshire 038","E02005676",4918,2802,2049,2041,8,8,745,712,33,2116,1382,68,96,356,214
"2021","West Northamptonshire 037","E02005677",7443,4155,2880,2860,20,6,1269,1196,73,3288,2172,153,174,466,323
"2021","West Northamptonshire 041","E02005679",7267,4861,3693,3666,27,6,1162,1112,50,2406,1429,127,107,455,288
"2021","West Northamptonshire 044","E02005680",6571,4383,3621,3614,7,4,758,734,24,2188,1468,58,130,334,198
"2021","West Northamptonshire 040","E02005681",7042,4700,3804,3795,9,12,884,852,32,2342,1320,45,117,409,451
"2021","West Northamptonshire 043","E02005682",6140,4240,3408,3396,12,10,822,804,18,1900,1038,55,100,348,359
"2021","West Northamptonshire 046","E02005683",11798,7994,6088,6048,40,20,1886,1820,66,3804,2250,96,214,658,586
"2021","West Northamptonshire 045","E02005684",7105,5002,4006,3982,24,4,992,968,24,2103,1232,44,105,374,348
"2021","West Northamptonshire 047","E02005685",8179,5432,3876,3842,34,2,1554,1520,34,2747,1628,45,131,519,424
"2021","West Northamptonshire 048","E02005686",6604,4452,3705,3677,28,3,744,728,16,2152,1247,38,96,377,394
"2021","West Northamptonshire 049","E02005687",5519,3834,3139,3123,16,7,688,666,22,1685,1035,36,66,296,252
"2021","West Northamptonshire 050","E02005688",7883,5390,4331,4309,22,7,1052,1000,52,2493,1484,54,135,421,399
"2021","West Northamptonshire 051","E02005689",8402,5966,4413,4393,20,1,1552,1516,36,2436,1558,36,91,444,307
"2021","West Northamptonshire 053","E02005690",4521,2728,1956,1942,14,6,766,736,30,1793,968,45,69,430,281
"2021","West Northamptonshire 052","E02005691",5424,3692,2962,2932,30,2,728,706,22,1732,962,45,88,322,315
"2021","West Northamptonshire 035","E02007072",5444,3268,2270,2256,14,6,992,952,40,2176,1404,76,128,340,228
"2021","West Northamptonshire 039","E02007073",6053,4026,3105,3085,20,9,912,868,44,2027,1325,67,91,309,235
"2021","Amber Valley 001","E02004029",6006,3591,2450,2428,22,5,1136,1092,44,2415,1407,42,128,449,389
"2021","Amber Valley 002","E02004030",5115,3539,2827,2805,22,5,707,670,37,1576,788,37,89,295,367
"2021","Amber Valley 003","E02004031",5793,3110,1943,1935,8,1,1166,1126,40,2683,1659,49,133,518,324
"2021","Amber Valley 004","E02004032",7148,4764,3648,3628,20,14,1102,1058,44,2384,1315,41,105,414,509
"2021","Amber Valley 005","E02004033",7367,4488,3108,3080,28,4,1376,1314,62,2879,1721,42,131,575,410
"2021","Amber Valley 006","E02004034",5831,3858,3068,3048,20,0,790,770,20,1973,1023,34,96,367,453
"2021","Amber Valley 007","E02004035",5527,3833,3137,3123,14,6,690,666,24,1694,944,29,64,278,379
"2021","Amber Valley 008","E02004036",8437,5101,3672,3660,12,2,1427,1359,68,3336,1904,43,159,654,576
"2021","Amber Valley 009","E02004037",6563,4431,3479,3450,29,8,944,920,24,2132,1274,33,81,377,367
"2021","Amber Valley 010","E02004038",6331,3808,2688,2644,44,0,1120,1062,58,2523,1375,45,140,585,378
"2021","Amber Valley 011","E02004039",6443,4214,3199,3179,20,3,1012,982,30,2229,1273,26,116,445,369
"2021","Amber Valley 012","E02004040",7712,4965,3720,3685,35,7,1238,1196,42,2747,1709,37,136,465,400
"2021","Amber Valley 013","E02004041",6044,3823,2655,2623,32,6,1162,1110,52,2221,1364,37,122,360,338
"2021","Amber Valley 015","E02004043",6026,3981,2974,2964,10,6,1001,966,35,2045,1115,45,111,399,375
"2021","Amber Valley 016","E02004044",7285,4955,4130,4121,9,11,814,796,18,2330,1364,47,88,381,450
"2021","Amber Valley 017","E02006827",6440,3583,2285,2259,26,6,1292,1244,48,2857,1690,60,141,534,432
"2021","Bolsover 001","E02004045",8111,5427,4111,4091,20,2,1314,1250,64,2684,1493,48,131,533,479
"2021","Bolsover 002","E02004046",5163,3304,2414,2400,14,6,884,830,54,1859,966,46,103,365,379
"2021","Bolsover 003","E02004047",4826,2877,1816,1792,24,1,1060,1018,42,1949,1132,24,126,376,291
"2021","Bolsover 004","E02004048",5642,3468,2395,2371,24,9,1064,1014,50,2174,1237,23,111,455,348
"2021","Bolsover 005","E02004049",6632,4242,3142,3126,16,2,1098,1052,46,2390,1270,42,96,437,545
"2021","Bolsover 006","E02004050",6199,3690,2468,2454,14,6,1216,1182,34,2509,1489,64,106,419,431
"2021","Bolsover 007","E02004051",7945,4790,3275,3251,24,5,1510,1438,72,3155,1835,89,163,564,504
"2021","Bolsover 008","E02004052",7143,4677,3379,3346,33,8,1290,1228,62,2466,1451,50,122,439,404
"2021","Bolsover 009","E02004053",6357,3834,2651,2637,14,5,1178,1138,40,2523,1513,35,117,494,364
"2021","Bolsover 010","E02004054",7618,4958,3502,3476,26,0,1456,1416,40,2660,1592,57,137,453,421
"2021","Chesterfield 001","E02004055",5710,3360,2378,2368,10,2,980,934,46,2350,1333,39,102,483,393
"2021","Chesterfield 002","E02004056",6191,3544,2377,2365,12,7,1160,1118,42,2647,1633,26,125,503,360
"2021","Chesterfield 003","E02004057",6255,3680,2397,2369,28,3,1280,1230,50,2575,1605,41,134,502,293
"2021","Chesterfield 004","E02004058",6509,3550,2434,2416,18,4,1112,1066,46,2959,1745,52,163,580,419
"2021","Chesterfield 005","E02004059",6034,3852,2920,2898,22,2,930,898,32,2182,1195,33,86,398,470
"2021","Chesterfield 006","E02004060",6051,3744,2802,2790,12,6,936,916,20,2307,1283,44,116,387,477
"2021","Chesterfield 007","E02004061",6165,3520,2490,2474,16,2,1028,972,56,2645,1506,44,125,539,431
"2021","Chesterfield 008","E02004062",6447,3798,2938,2922,16,2,858,816,42,2649,1485,41,96,582,445
"2021","Chesterfield 009","E02004063",6488,4116,3159,3141,18,5,952,920,32,2372,1310,50,78,471,463
"2021","Chesterfield 010","E02004064",7805,3904,2307,2273,34,7,1590,1486,104,3901,2439,82,242,809,329
"2021","Chesterfield 011","E02004065",6874,4768,3964,3936,28,6,798,764,34,2106,1049,41,63,390,563
"2021","Chesterfield 012","E02004066",9409,5916,4286,4264,22,10,1620,1538,82,3493,1989,59,172,707,566
"2021","Chesterfield 013","E02004067",5148,2766,1965,1957,8,5,796,756,40,2382,1450,40,101,463,328
"2021","Derbyshire Dales 001","E02004068",6167,4121,3345,3307,38,8,768,738,30,2046,1101,33,96,374,442
"2021","Derbyshire Dales 002","E02004069",5457,3709,3146,3124,22,3,560,536,24,1748,870,46,62,362,408
"2021","Derbyshire Dales 005","E02004072",7853,5332,4260,4234,26,4,1068,1032,36,2521,1384,49,127,419,542
"2021","Derbyshire Dales 006","E02004073",7432,4570,3516,3478,38,4,1050,1016,34,2862,1543,54,158,590,517
"2021","Derbyshire Dales 007","E02004074",4924,3084,2348,2322,26,0,736,692,44,1840,964,49,91,380,356
"2021","Derbyshire Dales 008","E02004075",6139,4194,3504,3488,16,2,688,666,22,1945,1058,67,100,339,381
"2021","Derbyshire Dales 009","E02004076",6049,3769,2779,2768,11,0,990,946,44,2280,1247,46,120,455,412
"2021","Derbyshire Dales 010","E02004077",6532,4639,3755,3744,11,4,880,848,32,1893,1067,31,88,318,389
"2021","Derbyshire Dales 011","E02007029",9443,6196,4999,4967,32,9,1188,1152,36,3247,1715,72,127,608,725
"2021","Erewash 001","E02004078",5608,3048,1945,1933,12,11,1092,1042,50,2560,1538,51,124,492,355
"2021","Erewash 003","E02004080",7962,4446,2788,2752,36,6,1652,1562,90,3516,2201,50,197,628,440
"2021","Erewash 004","E02004081",4871,3308,2639,2625,14,7,662,624,38,1563,866,26,48,277,346
"2021","Erewash 005","E02004082",5067,3465,2822,2812,10,1,642,628,14,1602,882,22,59,293,346
"2021","Erewash 006","E02004083",6736,4272,2821,2803,18,5,1446,1384,62,2464,1581,52,107,416,308
"2021","Erewash 007","E02004084",4830,2854,1966,1954,12,4,884,854,30,1976,1136,39,92,323,386
"2021","Erewash 008","E02004085",7207,4501,3326,3310,16,6,1169,1124,45,2706,1601,48,121,455,481
"2021","Erewash 009","E02004086",5931,3842,3004,2980,24,4,834,802,32,2089,1153,41,86,370,439
"2021","Erewash 010","E02004087",6264,3776,2526,2509,17,6,1244,1204,40,2488,1515,45,112,475,341
"2021","Erewash 011","E02004088",6284,4302,3480,3460,20,2,820,800,20,1982,1165,27,78,346,366
"2021","Erewash 012","E02004089",5646,2904,1609,1591,18,3,1292,1228,64,2742,1730,41,146,541,284
"2021","Erewash 013","E02004090",5047,3124,2379,2361,18,3,742,716,26,1923,1031,30,114,378,370
"2021","Erewash 014","E02004091",7780,5000,3566,3542,24,8,1426,1382,44,2780,1612,36,113,543,476
"2021","Erewash 015","E02004092",7706,4736,3484,3460,24,8,1244,1194,50,2970,1701,43,145,578,503
"2021","Erewash 016","E02006828",5837,3820,2735,2723,12,3,1082,1038,44,2017,1262,13,104,355,283
"2021","High Peak 001","E02004093",5192,3115,2232,2208,24,4,879,848,31,2077,1262,26,99,414,276
"2021","High Peak 002","E02004094",5505,3054,2118,2110,8,0,936,918,18,2451,1486,30,129,462,344
"2021","High Peak 003","E02004095",8470,4914,3355,3319,36,5,1554,1478,76,3556,2081,49,212,725,489
"2021","High Peak 004","E02004096",8100,5661,4570,4538,32,1,1090,1032,58,2439,1451,49,73,381,485
"2021","High Peak 005","E02004097",6349,4070,3060,3036,24,6,1004,964,40,2279,1327,49,111,456,336
"2021","High Peak 006","E02004098",6079,3624,2678,2660,18,2,944,924,20,2455,1377,37,129,519,393
"2021","High Peak 008","E02004100",6739,4466,3465,3433,32,7,994,956,38,2273,1333,43,90,426,381
"2021","High Peak 010","E02004102",6459,3400,2432,2406,26,8,960,909,51,3059,1727,45,158,648,481
"2021","High Peak 011","E02004103",5390,3055,2124,2102,22,0,931,900,31,2335,1422,32,118,421,342
"2021","High Peak 012","E02004104",5956,4030,3205,3189,16,3,822,794,28,1926,1128,39,93,304,362
"2021","High Peak 013","E02006872",10794,7072,5423,5385,38,11,1638,1574,64,3722,2052,82,176,723,689
"2021","North East Derbyshire 001","E02004105",7635,4856,3678,3656,22,6,1172,1134,38,2779,1634,52,119,495,479
"2021","North East Derbyshire 002","E02004106",5899,3830,3127,3123,4,5,698,678,20,2069,1033,29,72,400,535
"2021","North East Derbyshire 004","E02004108",6202,3589,2717,2699,18,6,866,836,30,2613,1464,35,123,526,465
"2021","North East Derbyshire 005","E02004109",5672,4039,3474,3464,10,6,559,536,23,1633,829,32,60,309,403
"2021","North East Derbyshire 006","E02004110",6070,4213,3481,3474,7,4,728,716,12,1857,958,15,95,367,422
"2021","North East Derbyshire 007","E02004111",4687,3052,2273,2253,20,1,778,746,32,1635,876,32,72,317,338
"2021","North East Derbyshire 008","E02004112",5446,3774,3228,3213,15,5,541,526,15,1672,818,35,60,289,470
"2021","North East Derbyshire 009","E02004113",8139,4713,3079,3054,25,2,1632,1566,66,3426,2035,48,201,628,514
"2021","North East Derbyshire 010","E02004114",7177,4962,3853,3843,10,13,1096,1066,30,2215,1174,53,100,410,478
"2021","North East Derbyshire 011","E02004115",7466,4742,3544,3530,14,2,1196,1140,56,2724,1564,31,128,555,446
"2021","North East Derbyshire 012","E02004116",6943,3958,2775,2739,36,9,1174,1130,44,2985,1619,62,192,626,486
"2021","North East Derbyshire 013","E02004117",6583,4332,3250,3224,26,6,1076,1054,22,2251,1292,45,117,379,418
"2021","North East Derbyshire 014","E02006804",6638,3930,2748,2728,20,2,1180,1148,32,2708,1625,47,128,508,400
"2021","South Derbyshire 001","E02004118",6085,4141,3151,3131,20,0,990,946,44,1944,1234,24,95,284,307
"2021","South Derbyshire 002","E02004119",9360,6230,4682,4650,32,6,1542,1488,54,3130,1883,68,200,570,409
"2021","South Derbyshire 003","E02004120",8745,5723,4321,4297,24,6,1396,1338,58,3022,1872,112,161,474,403
"2021","South Derbyshire 004","E02004121",7459,5138,3868,3846,22,12,1258,1206,52,2321,1387,68,123,363,380
"2021","South Derbyshire 005","E02004122",5368,3745,3016,2994,22,2,727,706,21,1623,944,37,60,294,288
"2021","South Derbyshire 006","E02004123",5619,3658,2878,2864,14,4,776,750,26,1961,1013,37,98,403,410
"2021","South Derbyshire 007","E02004124",6145,3932,2930,2911,19,8,994,956,38,2213,1289,28,112,380,404
"2021","South Derbyshire 008","E02004125",7108,4484,3170,3146,24,8,1306,1260,46,2624,1517,45,136,502,424
"2021","South Derbyshire 009","E02004126",6065,3760,2708,2696,12,4,1048,996,52,2305,1234,55,119,466,431
"2021","South Derbyshire 011","E02004128",9360,6270,4681,4645,36,13,1576,1524,52,3090,1791,56,155,525,563
"2021","South Derbyshire 012","E02006919",8172,5247,3549,3516,33,10,1688,1628,60,2925,1792,57,175,567,334
"2021","South Derbyshire 013","E02006920",6347,4022,2757,2733,24,5,1260,1224,36,2325,1490,34,127,411,263
"2021","Blaby 002","E02005334",4840,3184,2445,2419,26,13,726,690,36,1656,1028,44,69,241,274
"2021","Blaby 003","E02005335",6091,4096,3346,3326,20,4,746,710,36,1995,1113,58,79,341,404
"2021","Blaby 004","E02005336",5723,3518,2468,2440,28,10,1040,996,44,2205,1385,67,121,363,269
"2021","Blaby 005","E02005337",8096,4822,3808,3794,14,12,1002,952,50,3274,1965,145,127,454,583
"2021","Blaby 006","E02005338",9168,5850,4204,4170,34,4,1642,1574,68,3318,2015,55,169,526,553
"2021","Blaby 007","E02005339",7086,4580,3457,3439,18,9,1114,1080,34,2506,1475,39,124,449,419
"2021","Blaby 008","E02005340",7343,4581,3275,3243,32,6,1300,1244,56,2762,1562,51,128,516,505
"2021","Blaby 009","E02005341",6071,3983,2981,2969,12,1,1001,976,25,2088,1322,33,94,380,259
"2021","Blaby 010","E02005342",6008,4009,3051,3023,28,1,957,929,28,1999,1171,32,99,335,362
"2021","Blaby 011","E02005343",6459,4357,3367,3349,18,0,990,968,22,2102,1225,42,90,373,372
"2021","Blaby 012","E02005344",7459,5084,3829,3801,28,11,1244,1212,32,2375,1388,31,123,430,403
"2021","Blaby 013","E02006820",8903,5710,4506,4486,20,10,1194,1144,50,3193,1895,92,110,466,630
"2021","Charnwood 001","E02005345",5346,3438,2651,2627,24,7,780,754,26,1908,1124,41,106,337,300
"2021","Charnwood 002","E02005346",10088,4698,3107,3063,44,5,1586,1502,84,5390,3753,206,228,774,429
"2021","Charnwood 003","E02005347",8974,2535,1775,1757,18,4,756,708,48,6439,5613,87,94,380,265
"2021","Charnwood 004","E02005348",4705,2910,2386,2380,6,2,522,504,18,1795,1046,41,73,326,309
"2021","Charnwood 005","E02005349",6439,4169,3054,3029,25,13,1102,1060,42,2270,1333,42,123,403,369
"2021","Charnwood 006","E02005350",5607,3560,2603,2579,24,11,946,916,30,2047,1228,36,98,391,294
"2021","Charnwood 007","E02005351",5137,2465,1951,1939,12,8,506,472,34,2672,2031,58,76,232,275
"2021","Charnwood 008","E02005352",5111,3623,3032,3009,23,1,590,566,24,1488,878,41,58,237,274
"2021","Charnwood 009","E02005353",8145,4604,3274,3244,30,6,1324,1276,48,3541,2409,61,136,536,399
"2021","Charnwood 010","E02005354",8167,5500,4641,4627,14,7,852,820,32,2667,1604,66,90,376,531
"2021","Charnwood 011","E02005355",5987,3932,2978,2956,22,6,948,928,20,2055,1165,39,106,418,327
"2021","Charnwood 012","E02005356",5946,3878,3124,3102,22,4,750,716,34,2068,1133,35,123,444,333
"2021","Charnwood 013","E02005357",6677,4164,2851,2837,14,3,1310,1254,56,2513,1536,40,138,473,326
"2021","Charnwood 014","E02005358",9769,6319,4552,4516,36,5,1762,1704,58,3450,2115,71,171,620,473
"2021","Charnwood 015","E02005359",6218,4251,3409,3392,17,6,836,800,36,1967,1184,44,94,292,353
"2021","Charnwood 016","E02005360",5171,3688,3102,3080,22,4,582,554,28,1483,851,32,54,231,315
"2021","Charnwood 017","E02005361",5214,3054,2347,2333,14,7,700,664,36,2160,1284,36,106,408,326
"2021","Charnwood 018","E02005362",5811,3744,2814,2802,12,6,924,884,40,2067,1233,36,98,342,358
"2021","Charnwood 019","E02005363",7289,4737,4039,4014,25,8,690,664,26,2552,1489,88,107,358,510
"2021","Charnwood 020","E02005364",4354,2707,2206,2206,0,5,496,476,20,1647,1049,37,57,237,267
"2021","Charnwood 021","E02005365",8041,4734,3846,3838,8,10,878,856,22,3307,1959,125,136,480,607
"2021","Charnwood 022","E02005366",6252,4030,2944,2926,18,12,1074,1028,46,2222,1301,35,109,394,383
"2021","Harborough 002","E02005368",5364,3682,3099,3085,14,5,578,548,30,1682,983,50,72,276,301
"2021","Harborough 003","E02005369",10213,6735,5416,5373,43,9,1310,1254,56,3478,1989,93,176,640,580
"2021","Harborough 004","E02005370",7774,5324,3981,3955,26,5,1338,1290,48,2450,1543,31,129,412,335
"2021","Harborough 005","E02005371",8885,6010,4814,4786,28,4,1192,1156,36,2875,1740,56,140,484,455
"2021","Harborough 006","E02005372",8509,6004,4868,4842,26,8,1128,1094,34,2505,1500,77,99,388,441
"2021","Harborough 007","E02005373",9494,6622,5288,5236,52,2,1332,1278,54,2872,1625,57,140,513,537
"2021","Harborough 008","E02005374",5351,2826,1970,1956,14,0,856,822,34,2525,1358,52,134,532,449
"2021","Harborough 009","E02005375",7514,4910,3774,3766,8,6,1130,1092,38,2604,1458,55,121,495,475
"2021","Harborough 010","E02005376",8826,5672,4432,4402,30,14,1226,1180,46,3154,1851,78,142,541,542
"2021","Harborough 011","E02006816",7201,4824,4018,3994,24,0,806,770,36,2377,1442,102,76,332,425
"2021","Hinckley and Bosworth 001","E02005377",7397,4842,3648,3624,24,4,1190,1146,44,2555,1443,41,117,462,492
"2021","Hinckley and Bosworth 002","E02005378",4344,2880,2320,2306,14,2,558,532,26,1464,844,36,60,272,252
"2021","Hinckley and Bosworth 003","E02005379",4999,3302,2585,2583,2,1,716,704,12,1697,958,24,84,315,316
"2021","Hinckley and Bosworth 004","E02005380",7234,4976,4124,4096,28,6,846,822,24,2258,1266,55,112,393,432
"2021","Hinckley and Bosworth 005","E02005381",7174,4870,3920,3898,22,8,942,898,44,2304,1288,54,96,375,491
"2021","Hinckley and Bosworth 006","E02005382",8665,5447,3876,3832,44,13,1558,1486,72,3218,1908,42,168,611,489
"2021","Hinckley and Bosworth 007","E02005383",7512,4626,3266,3241,25,2,1358,1322,36,2886,1648,49,170,602,417
"2021","Hinckley and Bosworth 008","E02005384",6042,4213,3376,3368,8,6,831,810,21,1829,1087,38,100,285,319
"2021","Hinckley and Bosworth 009","E02005385",5611,3903,3091,3070,21,4,808,792,16,1708,1007,32,58,260,351
"2021","Hinckley and Bosworth 010","E02005386",7456,4117,2640,2620,20,3,1474,1430,44,3339,2057,52,170,658,402
"2021","Hinckley and Bosworth 011","E02005387",8068,5226,3612,3598,14,6,1608,1560,48,2842,1683,43,148,598,370
"2021","Hinckley and Bosworth 012","E02005388",5091,3102,2130,2114,16,0,972,938,34,1989,1160,52,106,377,294
"2021","Hinckley and Bosworth 013","E02005389",4964,3014,2308,2298,10,4,702,676,26,1950,1028,55,96,383,388
"2021","Hinckley and Bosworth 014","E02005390",8624,5998,4711,4679,32,5,1282,1250,32,2626,1434,53,126,513,500
"2021","Melton 001","E02005391",8146,5613,4566,4544,22,10,1037,1000,37,2533,1385,40,114,450,544
"2021","Melton 002","E02005392",7634,5026,3895,3883,12,5,1126,1082,44,2608,1476,45,122,469,496
"2021","Melton 003","E02005393",6148,4138,3193,3177,16,1,944,912,32,2010,1136,42,92,380,360
"2021","Melton 004","E02005394",7580,4545,3183,3169,14,8,1354,1306,48,3035,1754,55,163,605,458
"2021","Melton 005","E02005395",7320,4484,3382,3364,18,6,1096,1048,48,2836,1591,74,141,549,481
"2021","Melton 006","E02005396",5753,4001,3297,3275,22,4,700,678,22,1752,965,48,89,312,338
"2021","North West Leicestershire 001","E02005397",7707,5040,3732,3706,26,2,1306,1258,48,2667,1539,49,148,535,396
"2021","North West Leicestershire 002","E02005398",5881,3302,2436,2412,24,0,866,840,26,2579,1786,41,97,331,324
"2021","North West Leicestershire 003","E02005399",6702,4300,3188,3170,18,4,1108,1058,50,2402,1404,48,114,508,328
"2021","North West Leicestershire 004","E02005400",4840,3192,2408,2388,20,0,784,764,20,1648,944,34,84,256,330
"2021","North West Leicestershire 005","E02005401",5391,3748,2994,2980,14,6,748,714,34,1643,995,41,41,270,296
"2021","North West Leicestershire 006","E02005402",5477,3579,2890,2874,16,6,683,657,26,1898,1056,32,93,328,389
"2021","North West Leicestershire 007","E02005403",5573,3560,2699,2685,14,3,858,816,42,2013,1129,35,86,361,402
"2021","North West Leicestershire 008","E02005404",7106,4662,3440,3417,23,12,1210,1158,52,2444,1459,35,134,431,385
"2021","North West Leicestershire 009","E02005405",5801,3498,2555,2541,14,5,938,900,38,2303,1418,28,84,386,387
"2021","North West Leicestershire 010","E02005406",6215,3584,2315,2297,18,1,1268,1226,42,2631,1647,59,131,488,306
"2021","North West Leicestershire 011","E02005407",8883,6062,4184,4152,32,4,1874,1808,66,2821,1745,50,118,528,380
"2021","North West Leicestershire 012","E02005408",6464,4218,3204,3176,28,4,1010,974,36,2246,1271,49,141,410,375
"2021","North West Leicestershire 013","E02005409",9686,6282,4488,4460,28,6,1788,1706,82,3404,2031,58,198,598,519
"2021","Oadby and Wigston 003","E02005412",6962,4112,3598,3594,4,12,502,478,24,2850,1556,134,118,453,589
"2021","Oadby and Wigston 005","E02005414",6423,3520,2529,2511,18,7,984,942,42,2903,1766,44,129,530,434
"2021","Oadby and Wigston 006","E02005415",6466,3728,2470,2456,14,0,1258,1200,58,2738,1677,43,148,453,417
"2021","Oadby and Wigston 007","E02005416",7586,4922,3970,3952,18,4,948,920,28,2664,1544,49,118,403,550
"2021","Oadby and Wigston 008","E02006818",6834,4308,3598,3586,12,6,704,684,20,2526,1446,89,92,385,514
"2021","Oadby and Wigston 010","E02006966",4955,3028,2825,2821,4,3,200,190,10,1927,1192,146,65,195,329
"2021","Oadby and Wigston 011","E02006967",6150,3845,3559,3551,8,7,279,264,15,2305,1465,90,98,290,362
"2021","Boston 001","E02005417",6119,4102,3299,3281,18,5,798,764,34,2017,1096,55,72,353,441
"2021","Boston 002","E02005418",8593,4378,2622,2612,10,6,1750,1674,76,4215,2512,205,206,787,505
"2021","Boston 003","E02005419",7086,3699,2202,2196,6,12,1485,1422,63,3387,2087,184,162,641,313
"2021","Boston 004","E02005420",7084,4049,2695,2687,8,3,1351,1299,52,3035,1681,96,148,605,505
"2021","Boston 006","E02005422",5586,3715,2778,2748,30,3,934,912,22,1871,994,37,110,325,405
"2021","Boston 007","E02005423",8397,5258,3858,3824,34,6,1394,1328,66,3139,1728,67,152,589,603
"2021","Boston 008","E02006864",7202,4848,3681,3667,14,9,1158,1108,50,2354,1291,83,88,411,481
"2021","Boston 009","E02006865",6747,4510,3342,3330,12,6,1162,1132,30,2237,1287,77,86,377,410
"2021","East Lindsey 001","E02005424",8631,5995,4885,4855,30,6,1104,1058,46,2636,1398,58,121,472,587
"2021","East Lindsey 002","E02005425",5571,3905,3085,3073,12,5,815,778,37,1666,856,41,71,269,429
"2021","East Lindsey 003","E02005426",8267,5076,3726,3702,24,6,1344,1296,48,3191,1737,63,159,649,583
"2021","East Lindsey 004","E02005427",5764,3226,2314,2290,24,2,910,862,48,2538,1315,52,144,572,455
"2021","East Lindsey 005","E02005428",7174,4434,3410,3398,12,2,1022,968,54,2740,1340,73,140,538,649
"2021","East Lindsey 006","E02005429",5659,3836,3172,3150,22,6,658,612,46,1823,682,55,70,343,673
"2021","East Lindsey 007","E02005430",6105,4204,3358,3348,10,2,844,798,46,1901,1023,51,86,332,409
"2021","East Lindsey 008","E02005431",7487,4900,3856,3822,34,2,1042,1006,36,2587,1345,62,127,469,584
"2021","East Lindsey 009","E02005432",6657,4745,3829,3807,22,7,909,892,17,1912,974,53,115,358,412
"2021","East Lindsey 010","E02005433",6157,3994,3093,3059,34,7,894,866,28,2163,964,57,108,409,625
"2021","East Lindsey 011","E02005434",6228,3888,2922,2898,24,6,960,934,26,2340,1191,47,128,488,486
"2021","East Lindsey 012","E02005435",6635,4150,2922,2908,14,4,1224,1180,44,2485,1282,63,120,494,526
"2021","East Lindsey 013","E02005436",6771,4460,3409,3385,24,7,1044,1008,36,2311,1186,55,124,423,523
"2021","East Lindsey 014","E02005437",5032,2653,1717,1697,20,3,933,860,73,2379,1357,48,146,505,323
"2021","East Lindsey 015","E02005438",5702,3251,2359,2339,20,1,891,855,36,2451,1306,50,106,492,497
"2021","East Lindsey 016","E02005439",9293,6292,5083,5067,16,7,1202,1156,46,3001,1480,63,154,592,712
"2021","East Lindsey 017","E02005440",4678,3042,2310,2300,10,8,724,696,28,1636,911,49,67,256,353
"2021","East Lindsey 018","E02005441",7269,4916,3919,3877,42,11,986,938,48,2353,1236,53,93,432,539
"2021","Lincoln 001","E02005442",5092,2476,1566,1552,14,0,910,866,44,2616,1695,32,111,489,289
"2021","Lincoln 002","E02005443",6011,3576,2410,2374,36,8,1158,1090,68,2435,1411,46,106,506,366
"2021","Lincoln 003","E02005444",10971,5659,3773,3746,27,10,1876,1746,130,5312,3762,102,186,773,489
"2021","Lincoln 004","E02005445",9630,4523,2681,2654,27,20,1822,1706,116,5107,3640,162,209,757,339
"2021","Lincoln 005","E02005446",6561,1970,1022,1012,10,4,944,870,74,4591,3964,52,75,345,155
"2021","Lincoln 006","E02005447",7064,2762,1294,1266,28,4,1464,1364,100,4302,3290,138,139,561,174
"2021","Lincoln 007","E02005448",5708,3161,1968,1958,10,0,1193,1156,37,2547,1564,51,128,522,282
"2021","Lincoln 008","E02005449",6208,3431,2237,2223,14,8,1186,1122,64,2777,1883,69,107,430,288
"2021","Lincoln 009","E02005450",7055,4558,3382,3362,20,6,1170,1144,26,2497,1410,39,129,453,466
"2021","Lincoln 010","E02005451",6226,3096,1897,1885,12,5,1194,1140,54,3130,2044,53,134,591,308
"2021","Lincoln 011","E02005452",9313,5895,4507,4480,27,2,1386,1360,26,3418,2021,54,150,603,590
"2021","North Kesteven 001","E02005453",9098,6320,5126,5101,25,7,1187,1152,35,2778,1448,48,109,532,641
"2021","North Kesteven 003","E02005455",11541,8066,6274,6238,36,7,1785,1724,61,3475,1968,74,214,651,568
"2021","North Kesteven 004","E02005456",8411,5610,4208,4170,38,6,1396,1352,44,2801,1479,58,142,569,553
"2021","North Kesteven 005","E02005457",7133,4867,3758,3732,26,2,1107,1063,44,2266,1157,46,100,477,486
"2021","North Kesteven 006","E02005458",5632,3952,3259,3235,24,1,692,674,18,1680,868,32,68,338,374
"2021","North Kesteven 007","E02005459",6966,4599,3595,3577,18,6,998,954,44,2367,1282,49,129,428,479
"2021","North Kesteven 008","E02005460",4678,3303,2758,2742,16,4,541,523,18,1375,751,13,90,285,236
"2021","North Kesteven 009","E02005461",5525,3772,3167,3147,20,3,602,584,18,1753,869,35,71,346,432
"2021","North Kesteven 010","E02005462",7909,4544,3210,3192,18,2,1332,1290,42,3365,1860,67,215,745,478
"2021","North Kesteven 011","E02005463",7979,5370,4231,4215,16,11,1128,1078,50,2609,1521,49,166,479,394
"2021","North Kesteven 012","E02005464",7360,5015,4063,4023,40,9,943,897,46,2345,1178,41,146,449,531
"2021","North Kesteven 013","E02006866",6961,4629,3447,3414,33,8,1174,1124,50,2332,1324,39,112,464,393
"2021","North Kesteven 014","E02006867",6807,4428,3413,3397,16,1,1014,986,28,2379,1230,39,108,444,558
"2021","South Holland 001","E02005465",7266,4876,3856,3828,28,6,1014,986,28,2390,1259,62,120,400,549
"2021","South Holland 002","E02005466",5678,3830,3009,2995,14,9,812,790,22,1848,1003,33,77,310,425
"2021","South Holland 003","E02005467",6380,3909,2841,2823,18,7,1061,1025,36,2471,1270,66,116,453,566
"2021","South Holland 004","E02005468",6385,4370,3508,3504,4,0,862,840,22,2015,1079,38,96,337,465
"2021","South Holland 005","E02005469",6523,4402,3319,3299,20,13,1070,1010,60,2121,1188,62,94,394,383
"2021","South Holland 006","E02005470",10507,6388,4335,4309,26,9,2044,1956,88,4119,2284,188,181,792,674
"2021","South Holland 007","E02005471",7505,4379,3083,3072,11,10,1286,1246,40,3126,1728,113,140,633,512
"2021","South Holland 008","E02005472",8233,5152,3842,3824,18,10,1300,1258,42,3081,1573,71,155,611,671
"2021","South Holland 009","E02005473",7864,5016,3597,3589,8,11,1408,1390,18,2848,1575,136,147,528,462
"2021","South Holland 010","E02005474",6026,4193,3174,3159,15,7,1012,974,38,1833,990,48,80,314,401
"2021","South Holland 011","E02005475",5868,4064,2979,2953,26,5,1080,1062,18,1804,1034,34,82,334,320
"2021","South Kesteven 001","E02005476",6055,4208,3457,3439,18,2,749,728,21,1847,1011,32,86,325,393
"2021","South Kesteven 002","E02005477",7667,5381,4530,4508,22,7,844,822,22,2286,1121,48,99,425,593
"2021","South Kesteven 003","E02005478",8052,4818,3734,3722,12,4,1080,1032,48,3234,1777,75,133,605,644
"2021","South Kesteven 004","E02005479",8008,5234,3936,3912,24,10,1288,1230,58,2774,1553,47,135,591,448
"2021","South Kesteven 005","E02005480",5560,3088,2145,2133,12,9,934,914,20,2472,1560,47,138,411,316
"2021","South Kesteven 006","E02005481",9800,5476,3513,3491,22,5,1958,1878,80,4324,2608,92,275,882,467
"2021","South Kesteven 007","E02005482",8050,5666,4444,4426,18,2,1220,1180,40,2384,1316,38,127,477,426
"2021","South Kesteven 008","E02005483",6589,4532,3656,3636,20,6,870,850,20,2057,1173,39,91,364,390
"2021","South Kesteven 009","E02005484",5993,4080,3109,3088,21,6,965,930,35,1913,1011,26,108,403,365
"2021","South Kesteven 010","E02005485",6676,4428,3327,3306,21,7,1094,1068,26,2248,1198,53,137,456,404
"2021","South Kesteven 011","E02005486",7599,4704,3546,3534,12,8,1150,1118,32,2895,1542,50,159,613,531
"2021","South Kesteven 012","E02005487",8179,5826,4933,4907,26,5,888,866,22,2353,1265,48,102,445,493
"2021","South Kesteven 013","E02005488",5787,3782,2988,2978,10,10,784,754,30,2005,1050,42,122,420,371
"2021","South Kesteven 014","E02005489",5972,3992,3135,3117,18,5,852,826,26,1980,1096,26,100,437,321
"2021","South Kesteven 015","E02005490",7503,4466,3187,3169,18,5,1274,1226,48,3037,1731,43,138,650,475
"2021","South Kesteven 016","E02005491",9431,5874,4442,4404,38,4,1428,1358,70,3557,1891,54,180,762,670
"2021","West Lindsey 001","E02005492",8182,5459,4352,4344,8,6,1101,1058,43,2723,1430,53,161,513,566
"2021","West Lindsey 002","E02005493",8295,5642,4341,4309,32,5,1296,1256,40,2653,1487,60,139,450,517
"2021","West Lindsey 003","E02005494",8135,5173,3995,3966,29,6,1172,1148,24,2962,1529,57,133,624,619
"2021","West Lindsey 004","E02005495",8392,4196,2739,2719,20,3,1454,1404,50,4196,2409,77,291,913,506
"2021","West Lindsey 005","E02005496",5327,3646,2914,2884,30,12,720,694,26,1681,873,47,98,357,306
"2021","West Lindsey 006","E02005497",5590,3130,2112,2090,22,0,1018,984,34,2460,1463,36,157,443,361
"2021","West Lindsey 007","E02005498",6324,4474,3660,3638,22,8,806,776,30,1850,875,55,100,342,478
"2021","West Lindsey 008","E02005499",6939,4668,3794,3778,16,4,870,846,24,2271,1219,34,94,452,472
"2021","West Lindsey 009","E02005500",6046,4104,3230,3214,16,0,874,842,32,1942,988,55,126,428,345
"2021","West Lindsey 010","E02005501",6737,4762,3816,3792,24,4,942,906,36,1975,1002,31,72,365,505
"2021","West Lindsey 011","E02005502",8032,5456,4285,4261,24,9,1162,1118,44,2576,1375,31,115,488,567
"2021","Ashfield 001","E02005819",5200,3264,2363,2349,14,1,900,856,44,1936,1088,41,111,332,364
"2021","Ashfield 002","E02005820",4711,3018,2290,2288,2,0,728,700,28,1693,931,43,77,299,343
"2021","Ashfield 003","E02005821",5355,3165,2132,2108,24,4,1029,996,33,2190,1245,40,117,449,339
"2021","Ashfield 004","E02005822",7919,4496,2897,2888,9,11,1588,1512,76,3423,2166,63,184,637,373
"2021","Ashfield 005","E02005823",5886,3014,2003,1989,14,3,1008,970,38,2872,1691,45,133,560,443
"2021","Ashfield 006","E02005824",8064,5240,3855,3825,30,9,1376,1316,60,2824,1689,46,109,490,490
"2021","Ashfield 007","E02005825",6219,3904,2833,2819,14,7,1064,1026,38,2315,1424,45,106,385,355
"2021","Ashfield 008","E02005826",4722,2560,1655,1643,12,3,902,854,48,2162,1277,33,120,392,340
"2021","Ashfield 009","E02005827",7704,5032,3596,3572,24,6,1430,1364,66,2672,1581,68,128,458,437
"2021","Ashfield 010","E02005828",6357,4164,3086,3052,34,4,1074,1032,42,2193,1208,36,117,404,428
"2021","Ashfield 011","E02005829",5387,3396,2556,2542,14,2,838,812,26,1991,1174,26,90,316,385
"2021","Ashfield 012","E02005830",5051,3218,2467,2451,16,3,748,724,24,1833,1009,26,86,325,387
"2021","Ashfield 013","E02005831",8405,5540,4071,4039,32,3,1466,1392,74,2865,1753,50,124,485,453
"2021","Ashfield 014","E02005832",7481,4034,2527,2495,32,7,1500,1428,72,3447,2133,55,180,682,397
"2021","Ashfield 015","E02005833",6319,4232,3316,3310,6,2,914,884,30,2087,1279,30,81,313,384
"2021","Ashfield 016","E02005834",6951,4118,2700,2670,30,10,1408,1362,46,2833,1820,43,154,427,389
"2021","Bassetlaw 001","E02005835",9044,5652,4004,3976,28,6,1642,1586,56,3392,1925,61,191,613,602
"2021","Bassetlaw 002","E02005836",7719,5299,4176,4142,34,7,1116,1084,32,2420,1297,55,93,430,545
"2021","Bassetlaw 003","E02005837",5811,4084,3270,3248,22,2,812,782,30,1727,920,44,68,340,355
"2021","Bassetlaw 004","E02005838",6802,4289,3235,3222,13,6,1048,1021,27,2513,1318,61,124,510,500
"2021","Bassetlaw 005","E02005839",5342,3291,2396,2390,6,2,893,856,37,2051,1003,40,93,448,467
"2021","Bassetlaw 006","E02005840",7694,5056,3760,3750,10,4,1292,1254,38,2638,1652,43,141,456,346
"2021","Bassetlaw 008","E02005842",7119,4224,3136,3118,18,4,1084,1040,44,2895,1619,56,161,581,478
"2021","Bassetlaw 009","E02005843",5621,3648,2650,2638,12,6,992,934,58,1973,1202,32,98,372,269
"2021","Bassetlaw 010","E02005844",7014,4125,2947,2922,25,6,1172,1112,60,2889,1625,48,158,617,441
"2021","Bassetlaw 012","E02005846",5183,2576,1590,1574,16,2,984,948,36,2607,1653,78,148,454,274
"2021","Bassetlaw 013","E02005847",5780,3620,2624,2600,24,0,996,956,40,2160,1300,60,93,363,344
"2021","Bassetlaw 014","E02005848",5272,3538,2710,2693,17,9,819,780,39,1734,961,29,107,259,378
"2021","Bassetlaw 015","E02005849",7639,5158,4142,4120,22,4,1012,986,26,2481,1313,75,121,485,487
"2021","Bassetlaw 016","E02006903",9107,5636,4278,4254,24,16,1342,1288,54,3471,1886,77,162,660,686
"2021","Broxtowe 001","E02005850",5508,3620,2759,2739,20,7,854,834,20,1888,1059,27,81,342,379
"2021","Broxtowe 002","E02005851",4947,2844,1904,1888,16,2,938,908,30,2103,1219,32,113,415,324
"2021","Broxtowe 003","E02005852",6995,4725,3663,3649,14,6,1056,1008,48,2270,1278,36,99,363,494
"2021","Broxtowe 004","E02005853",7569,4849,3738,3727,11,3,1108,1074,34,2720,1584,32,135,491,478
"2021","Broxtowe 007","E02005856",6058,4090,3449,3431,18,1,640,616,24,1968,1105,65,67,290,441
"2021","Broxtowe 008","E02005857",4957,2912,1919,1912,7,0,993,944,49,2045,1229,34,90,354,338
"2021","Broxtowe 009","E02005858",6163,3466,2564,2538,26,4,898,852,46,2697,1916,78,94,340,269
"2021","Broxtowe 010","E02005859",7523,4461,3204,3186,18,9,1248,1202,46,3062,1846,45,171,556,444
"2021","Broxtowe 011","E02005860",7534,3633,2453,2426,27,2,1178,1118,60,3901,2810,117,103,458,413
"2021","Broxtowe 012","E02005861",4507,2578,1657,1647,10,7,914,872,42,1929,1298,36,63,308,224
"2021","Broxtowe 013","E02005862",6100,3680,2817,2787,30,15,848,822,26,2420,1471,51,95,404,399
"2021","Broxtowe 014","E02005863",6034,3963,3203,3194,9,2,758,742,16,2071,1211,45,83,331,401
"2021","Broxtowe 015","E02005864",6497,4358,3518,3510,8,10,830,796,34,2139,1262,39,97,365,376
"2021","Broxtowe 016","E02006906",10136,6675,5157,5143,14,10,1508,1436,72,3461,2028,84,170,555,624
"2021","Gedling 001","E02005865",7167,5000,4097,4067,30,5,898,866,32,2167,1205,56,83,322,501
"2021","Gedling 002","E02005866",7584,4934,3862,3840,22,4,1068,1032,36,2650,1434,43,135,518,520
"2021","Gedling 004","E02005868",5937,3734,2828,2816,12,4,902,862,40,2203,1356,43,80,359,365
"2021","Gedling 005","E02005869",4569,2548,1675,1657,18,5,868,836,32,2021,1250,28,96,352,295
"2021","Gedling 006","E02005870",5324,2796,1842,1812,30,4,950,902,48,2528,1546,41,141,493,307
"2021","Gedling 007","E02005871",5956,3798,2886,2874,12,8,904,870,34,2158,1249,36,68,401,404
"2021","Gedling 008","E02005872",5412,3665,2893,2868,25,0,772,750,22,1747,967,35,70,285,390
"2021","Gedling 009","E02005873",8220,5505,4451,4409,42,1,1053,1004,49,2715,1579,52,106,456,522
"2021","Gedling 010","E02005874",6995,4485,3305,3265,40,9,1171,1102,69,2510,1474,44,116,439,437
"2021","Gedling 011","E02005875",6558,4062,2867,2845,22,9,1186,1142,44,2496,1604,44,112,384,352
"2021","Gedling 012","E02005876",7187,4466,3252,3218,34,4,1210,1168,42,2721,1666,46,128,432,449
"2021","Gedling 013","E02005877",5988,3459,2426,2392,34,4,1029,991,38,2529,1598,53,106,384,388
"2021","Gedling 014","E02005878",8066,4443,3097,3065,32,7,1339,1266,73,3623,2144,96,176,668,539
"2021","Gedling 015","E02005879",5928,3198,1898,1870,28,12,1288,1232,56,2730,1765,44,134,521,266
"2021","Gedling 016","E02006835",4958,3094,2327,2314,13,5,762,746,16,1864,1189,31,95,325,224
"2021","Mansfield 001","E02005880",5095,3110,2246,2236,10,2,862,828,34,1985,1144,32,98,322,389
"2021","Mansfield 002","E02005881",4987,3113,2276,2258,18,1,836,800,36,1874,1038,42,94,373,327
"2021","Mansfield 003","E02005882",6528,4390,3404,3392,12,0,986,956,30,2138,1141,34,86,371,506
"2021","Mansfield 004","E02005883",6602,3808,2588,2576,12,10,1210,1172,38,2794,1620,55,134,571,414
"2021","Mansfield 005","E02005884",5128,3196,2328,2317,11,8,860,824,36,1932,1078,40,110,386,318
"2021","Mansfield 006","E02005885",7187,4368,3035,3025,10,3,1330,1288,42,2819,1609,54,126,543,487
"2021","Mansfield 007","E02005886",9210,6038,4576,4556,20,8,1454,1394,60,3172,1839,46,142,554,591
"2021","Mansfield 008","E02005887",8136,4150,2452,2434,18,2,1696,1602,94,3986,2479,133,219,743,412
"2021","Mansfield 009","E02005888",6706,3408,2124,2112,12,6,1278,1218,60,3298,2069,72,175,658,324
"2021","Mansfield 010","E02005889",8591,5210,3760,3732,28,10,1440,1380,60,3381,1990,74,149,611,557
"2021","Mansfield 011","E02005890",5520,3770,2870,2856,14,4,896,866,30,1750,967,40,66,329,348
"2021","Mansfield 012","E02005891",5017,2557,1691,1677,14,6,860,824,36,2460,1539,66,123,469,263
"2021","Mansfield 013","E02005892",10681,7387,5653,5623,30,6,1728,1666,62,3294,1871,74,173,527,649
"2021","Newark and Sherwood 001","E02005893",9128,5504,3809,3791,18,9,1686,1622,64,3624,2087,72,238,639,588
"2021","Newark and Sherwood 002","E02005894",9312,6161,4372,4350,22,14,1775,1706,69,3151,1803,60,138,594,556
"2021","Newark and Sherwood 003","E02005895",6895,4870,3982,3952,30,6,882,856,26,2025,1037,58,97,350,483
"2021","Newark and Sherwood 004","E02005896",6445,4426,3608,3588,20,0,818,784,34,2019,1040,45,91,363,480
"2021","Newark and Sherwood 005","E02005897",7685,5175,4138,4122,16,0,1037,986,51,2510,1420,37,103,447,503
"2021","Newark and Sherwood 006","E02005898",9143,5629,3946,3900,46,4,1679,1624,55,3514,2026,48,183,680,577
"2021","Newark and Sherwood 007","E02005899",9607,5087,3127,3101,26,11,1949,1861,88,4520,2685,123,263,925,524
"2021","Newark and Sherwood 008","E02005900",5956,3793,3249,3237,12,0,544,522,22,2163,1150,39,72,397,505
"2021","Newark and Sherwood 009","E02005901",7746,4718,3332,3308,24,12,1374,1308,66,3028,1825,82,141,588,392
"2021","Newark and Sherwood 010","E02005902",6549,3816,2713,2683,30,5,1098,1046,52,2733,1541,65,168,502,457
"2021","Newark and Sherwood 011","E02005903",8579,5384,3974,3950,24,8,1402,1356,46,3195,1717,68,143,643,624
"2021","Newark and Sherwood 012","E02005904",7624,5273,4141,4115,26,9,1123,1074,49,2351,1334,54,106,440,417
"2021","Newark and Sherwood 013","E02005905",4988,3518,2982,2968,14,2,534,512,22,1470,803,38,48,282,299
"2021","Rushcliffe 001","E02005906",5420,3780,3118,3108,10,0,662,650,12,1640,916,38,67,267,352
"2021","Rushcliffe 002","E02005907",8032,5184,4031,4023,8,13,1140,1112,28,2848,1578,45,150,563,512
"2021","Rushcliffe 003","E02005908",7599,4978,4009,3965,44,13,956,884,72,2621,1359,51,132,479,600
"2021","Rushcliffe 004","E02005909",6553,4252,3282,3232,50,6,964,920,44,2301,1656,48,68,287,242
"2021","Rushcliffe 005","E02005910",7378,3684,2544,2526,18,2,1138,1080,58,3694,2782,59,130,438,285
"2021","Rushcliffe 006","E02005911",6788,4417,3581,3560,21,10,826,802,24,2371,1514,53,88,404,312
"2021","Rushcliffe 007","E02005912",7538,4846,4016,4000,16,4,826,770,56,2692,1549,77,112,468,486
"2021","Rushcliffe 008","E02005913",6725,4498,3709,3689,20,3,786,756,30,2227,1353,50,100,364,360
"2021","Rushcliffe 009","E02005914",6496,4267,2998,2969,29,9,1260,1204,56,2229,1394,38,82,399,316
"2021","Rushcliffe 010","E02005915",4810,3390,2771,2755,16,1,618,598,20,1420,796,29,72,232,291
"2021","Rushcliffe 011","E02005916",6075,3955,3005,2983,22,3,947,914,33,2120,1218,25,105,414,358
"2021","Rushcliffe 012","E02005917",4993,3696,3198,3184,14,0,498,488,10,1297,683,22,54,191,347
"2021","Rushcliffe 013","E02005918",4296,2683,2198,2184,14,4,481,469,12,1613,854,33,64,282,380
"2021","Rushcliffe 014","E02005919",5337,3541,2725,2695,30,4,812,780,32,1796,1076,29,92,281,318
"2021","Rushcliffe 015","E02005920",7147,5070,4062,4038,24,4,1004,946,58,2077,1174,31,79,350,443
"2021","Herefordshire 001","E02002905",5384,3720,3012,2978,34,6,702,676,26,1664,908,49,60,290,357
"2021","Herefordshire 002","E02002906",4574,2770,1999,1993,6,7,764,744,20,1804,1014,28,84,353,325
"2021","Herefordshire 003","E02002907",5125,2888,2070,2056,14,0,818,796,22,2237,1230,51,98,486,372
"2021","Herefordshire 004","E02002908",7554,5252,4250,4214,36,4,998,966,32,2302,1226,50,87,411,528
"2021","Herefordshire 005","E02002909",9089,5986,4745,4715,30,10,1231,1176,55,3103,1644,90,169,565,635
"2021","Herefordshire 006","E02002910",6635,4331,3443,3424,19,6,882,842,40,2304,1240,65,105,447,447
"2021","Herefordshire 007","E02002911",7744,5218,4325,4299,26,15,878,836,42,2526,1383,70,114,438,521
"2021","Herefordshire 008","E02002912",6273,4174,3306,3288,18,12,856,836,20,2099,1213,48,102,360,376
"2021","Herefordshire 009","E02002913",4852,3398,2863,2833,30,3,532,516,16,1454,749,50,68,283,304
"2021","Herefordshire 010","E02002914",7388,4304,3190,3180,10,8,1106,1072,34,3084,1719,71,122,665,507
"2021","Herefordshire 011","E02002915",6433,3987,3114,3108,6,5,868,834,34,2446,1381,67,112,452,434
"2021","Herefordshire 012","E02002916",8076,4022,2704,2690,14,8,1310,1276,34,4054,2453,121,183,832,465
"2021","Herefordshire 013","E02002917",5702,3214,2231,2223,8,7,976,940,36,2488,1456,52,108,497,375
"2021","Herefordshire 014","E02002918",4739,3105,2580,2576,4,6,519,489,30,1634,903,29,64,265,373
"2021","Herefordshire 015","E02002919",7143,4006,2941,2925,16,7,1058,1012,46,3137,1876,57,168,623,413
"2021","Herefordshire 016","E02002920",5418,3518,2736,2716,20,4,778,750,28,1900,1088,36,97,355,324
"2021","Herefordshire 017","E02002921",5999,3224,2169,2149,20,13,1042,996,46,2775,1731,56,139,546,303
"2021","Herefordshire 018","E02002922",5517,3686,3088,3070,18,2,596,576,20,1831,1050,69,77,315,320
"2021","Herefordshire 019","E02002923",7984,4865,3880,3858,22,5,980,954,26,3119,1609,60,144,611,695
"2021","Herefordshire 020","E02002924",5060,3334,2768,2742,26,2,564,542,22,1726,914,64,67,313,368
"2021","Herefordshire 021","E02002925",8960,5988,4756,4732,24,8,1224,1174,50,2972,1735,78,127,550,482
"2021","Herefordshire 022","E02002926",9164,5450,4111,4091,20,7,1332,1298,34,3714,1945,91,164,766,748
"2021","Herefordshire 023","E02002927",10028,7048,5763,5723,40,13,1272,1200,72,2980,1639,96,119,515,611
"2021","Telford and Wrekin 001","E02002928",5020,2985,2458,2448,10,3,524,513,11,2035,1259,36,73,359,308
"2021","Telford and Wrekin 002","E02002929",5019,3472,2906,2894,12,2,564,538,26,1547,938,38,55,218,298
"2021","Telford and Wrekin 003","E02002930",5641,3266,2408,2396,12,2,856,820,36,2375,1385,39,102,432,417
"2021","Telford and Wrekin 004","E02002931",5451,3709,3056,3044,12,4,649,626,23,1742,1050,46,81,291,274
"2021","Telford and Wrekin 005","E02002932",6889,3810,2517,2505,12,7,1286,1246,40,3079,1972,75,171,523,338
"2021","Telford and Wrekin 006","E02002933",6625,4196,3188,3172,16,2,1006,966,40,2429,1398,61,94,450,426
"2021","Telford and Wrekin 007","E02002934",5060,3138,2408,2396,12,8,722,708,14,1922,1143,53,89,366,271
"2021","Telford and Wrekin 008","E02002935",5558,3354,2485,2469,16,1,868,826,42,2204,1266,63,92,392,391
"2021","Telford and Wrekin 009","E02002936",8466,4974,3340,3326,14,10,1624,1562,62,3492,2254,151,183,568,336
"2021","Telford and Wrekin 010","E02002937",8993,6148,4801,4765,36,15,1332,1292,40,2845,1653,66,130,506,490
"2021","Telford and Wrekin 011","E02002938",5687,3170,2415,2405,10,3,752,704,48,2517,1554,139,117,446,261
"2021","Telford and Wrekin 012","E02002939",6229,3603,2532,2514,18,6,1065,1004,61,2626,1489,79,129,481,448
"2021","Telford and Wrekin 013","E02002940",4859,2794,1939,1923,16,13,842,796,46,2065,1187,39,93,427,319
"2021","Telford and Wrekin 014","E02002941",8567,5125,3658,3630,28,6,1461,1390,71,3442,2003,79,152,662,546
"2021","Telford and Wrekin 015","E02002942",6147,4328,3350,3338,12,2,976,950,26,1819,1190,56,92,256,225
"2021","Telford and Wrekin 017","E02002944",6496,3474,2209,2181,28,3,1262,1218,44,3022,1906,77,155,542,342
"2021","Telford and Wrekin 018","E02002945",7459,4204,3084,3064,20,6,1114,1060,54,3255,2018,135,171,566,365
"2021","Telford and Wrekin 019","E02002946",6284,3684,2629,2609,20,9,1046,1006,40,2600,1496,48,136,531,389
"2021","Telford and Wrekin 020","E02002947",5315,2965,2106,2086,20,4,855,818,37,2350,1505,46,141,421,237
"2021","Telford and Wrekin 021","E02002948",5430,2746,1702,1674,28,1,1043,1000,43,2684,1827,57,157,407,236
"2021","Telford and Wrekin 022","E02002949",4515,2544,1859,1837,22,5,680,644,36,1971,1068,42,115,405,341
"2021","Telford and Wrekin 023","E02002950",4493,2424,1717,1713,4,1,706,680,26,2069,1268,48,117,354,282
"2021","Telford and Wrekin 024","E02007050",6312,4060,2644,2616,28,6,1410,1344,66,2252,1496,37,122,375,222
"2021","Telford and Wrekin 025","E02007051",6327,4338,2928,2906,22,8,1402,1336,66,1989,1284,40,105,375,185
"2021","Stoke-on-Trent 001","E02002951",6333,3978,2930,2916,14,0,1048,1008,40,2355,1386,47,91,417,414
"2021","Stoke-on-Trent 002","E02002952",5707,3490,2334,2322,12,4,1152,1102,50,2217,1355,59,121,384,298
"2021","Stoke-on-Trent 003","E02002953",5838,3314,2382,2378,4,0,932,894,38,2524,1495,61,117,371,480
"2021","Stoke-on-Trent 004","E02002954",6546,3812,2719,2697,22,1,1092,1066,26,2734,1573,60,132,514,455
"2021","Stoke-on-Trent 005","E02002955",5548,2839,2014,2002,12,6,819,768,51,2709,1715,155,143,434,262
"2021","Stoke-on-Trent 006","E02002956",7103,3942,2797,2775,22,12,1133,1097,36,3161,2039,75,167,495,385
"2021","Stoke-on-Trent 007","E02002957",7943,5162,3944,3936,8,4,1214,1168,46,2781,1521,67,124,478,591
"2021","Stoke-on-Trent 008","E02002958",6669,3834,2595,2575,20,2,1237,1184,53,2835,1707,68,126,479,455
"2021","Stoke-on-Trent 009","E02002959",6878,3409,2188,2165,23,11,1210,1160,50,3469,2201,147,199,578,344
"2021","Stoke-on-Trent 010","E02002960",4766,2999,2293,2288,5,0,706,678,28,1767,1080,32,82,272,301
"2021","Stoke-on-Trent 011","E02002961",5585,3016,2185,2175,10,5,826,776,50,2569,1659,161,138,352,259
"2021","Stoke-on-Trent 012","E02002962",5967,3104,1963,1953,10,9,1132,1090,42,2863,1746,43,148,463,463
"2021","Stoke-on-Trent 013","E02002963",5772,2872,1847,1837,10,1,1024,968,56,2900,1820,117,141,509,313
"2021","Stoke-on-Trent 014","E02002964",7063,4141,2991,2985,6,5,1145,1078,67,2922,1688,48,131,476,579
"2021","Stoke-on-Trent 015","E02002965",5741,2744,2119,2107,12,5,620,580,40,2997,2060,229,139,356,213
"2021","Stoke-on-Trent 016","E02002966",7923,3302,2123,2109,14,7,1172,1044,128,4621,3454,205,200,480,282
"2021","Stoke-on-Trent 017","E02002967",7518,3728,2355,2345,10,7,1366,1308,58,3790,2384,62,275,649,420
"2021","Stoke-on-Trent 018","E02002968",7624,4198,2862,2844,18,8,1328,1256,72,3426,2308,120,159,506,333
"2021","Stoke-on-Trent 019","E02002969",7432,3715,2281,2263,18,0,1434,1353,81,3717,2510,111,186,552,358
"2021","Stoke-on-Trent 020","E02002970",6310,3109,1926,1924,2,6,1177,1104,73,3201,1922,72,186,616,405
"2021","Stoke-on-Trent 023","E02002973",6450,3492,2494,2476,18,4,994,946,48,2958,1937,93,141,459,328
"2021","Stoke-on-Trent 024","E02002974",4919,3200,2412,2396,16,0,788,758,30,1719,968,31,79,266,375
"2021","Stoke-on-Trent 025","E02002975",6032,4087,2973,2957,16,3,1111,1080,31,1945,1145,24,87,338,351
"2021","Stoke-on-Trent 026","E02002976",4704,2920,2088,2070,18,5,827,797,30,1784,1120,26,91,258,289
"2021","Stoke-on-Trent 027","E02002977",4626,2581,1875,1858,17,4,702,670,32,2045,1022,52,110,410,451
"2021","Stoke-on-Trent 028","E02002978",5137,2734,1795,1783,12,7,932,878,54,2403,1400,63,229,405,306
"2021","Stoke-on-Trent 029","E02002979",4441,2432,1955,1951,4,7,470,434,36,2009,1251,161,104,280,213
"2021","Stoke-on-Trent 030","E02002980",4956,3270,2608,2592,16,0,662,640,22,1686,894,26,67,302,397
"2021","Stoke-on-Trent 031","E02002981",6481,3824,2824,2802,22,8,992,938,54,2657,1695,80,147,399,336
"2021","Stoke-on-Trent 032","E02002982",6641,3596,2390,2350,40,6,1200,1146,54,3045,2017,51,159,485,333
"2021","Stoke-on-Trent 033","E02002983",4423,3014,2428,2426,2,4,582,564,18,1409,845,20,60,194,290
"2021","Stoke-on-Trent 034","E02002984",4449,3178,2545,2539,6,3,630,598,32,1271,721,32,45,220,253
"2021","Stoke-on-Trent 035","E02006974",8870,4991,3444,3420,24,6,1541,1463,78,3879,2287,90,195,709,598
"2021","Shropshire 025","E02006008",8539,5632,4123,4107,16,3,1506,1462,44,2907,1692,50,169,520,476
"2021","Shropshire 027","E02006009",5347,3472,2840,2826,14,10,622,602,20,1875,955,68,84,326,442
"2021","Shropshire 029","E02006010",9869,6498,5121,5071,50,5,1372,1336,36,3371,1897,66,151,609,648
"2021","Shropshire 031","E02006011",4786,2990,2435,2427,8,3,552,542,10,1796,923,39,82,330,422
"2021","Shropshire 033","E02006012",5256,3292,2538,2522,16,0,754,734,20,1964,1038,37,87,417,385
"2021","Shropshire 034","E02006013",6637,4594,3802,3772,30,4,788,754,34,2043,1194,47,90,316,396
"2021","Shropshire 035","E02006014",8406,5626,4439,4419,20,5,1182,1152,30,2780,1511,94,102,454,619
"2021","Shropshire 001","E02006015",8331,5188,3798,3764,34,6,1384,1358,26,3143,1794,49,155,574,571
"2021","Shropshire 002","E02006016",6898,4862,3879,3851,28,5,978,956,22,2036,1147,61,100,321,407
"2021","Shropshire 004","E02006017",6639,4324,3460,3438,22,2,862,826,36,2315,1244,54,84,461,472
"2021","Shropshire 005","E02006018",10235,6396,4686,4670,16,4,1706,1630,76,3839,2137,132,141,672,757
"2021","Shropshire 008","E02006019",5258,3058,2426,2398,28,2,630,622,8,2200,1261,37,83,386,433
"2021","Shropshire 009","E02006020",5393,3788,2999,2985,14,4,785,755,30,1605,950,36,80,266,273
"2021","Shropshire 010","E02006021",7251,5070,4121,4107,14,13,936,898,38,2181,1286,50,90,331,424
"2021","Shropshire 013","E02006022",4872,3402,2768,2748,20,4,630,598,32,1470,863,29,60,222,296
"2021","Shropshire 003","E02006023",7996,5178,3997,3975,22,17,1164,1108,56,2818,1516,72,139,517,574
"2021","Shropshire 006","E02006024",8004,4780,3457,3435,22,9,1314,1236,78,3224,1829,86,122,624,563
"2021","Shropshire 007","E02006025",8031,4491,3279,3265,14,8,1204,1158,46,3540,1952,94,243,670,581
"2021","Shropshire 011","E02006026",6132,4128,3332,3318,14,2,794,774,20,2004,1156,78,65,323,382
"2021","Shropshire 012","E02006027",4622,3202,2556,2540,16,6,640,632,8,1420,810,27,47,247,289
"2021","Shropshire 014","E02006028",8073,5320,4277,4265,12,3,1040,1006,34,2753,1554,119,104,458,518
"2021","Shropshire 015","E02006029",6414,3680,2536,2526,10,6,1138,1056,82,2734,1749,43,118,459,365
"2021","Shropshire 016","E02006030",7316,4075,2755,2735,20,1,1319,1284,35,3241,2151,46,231,497,316
"2021","Shropshire 017","E02006031",6637,3555,2307,2279,28,11,1237,1183,54,3082,1905,65,144,640,328
"2021","Shropshire 018","E02006032",6963,3954,2850,2834,16,6,1098,1034,64,3009,1827,55,115,595,417
"2021","Shropshire 019","E02006033",7183,3788,2713,2681,32,3,1072,1002,70,3395,1941,66,151,725,512
"2021","Shropshire 020","E02006034",8619,5493,4268,4233,35,7,1218,1140,78,3126,1884,78,155,568,441
"2021","Shropshire 021","E02006035",4987,3266,2558,2542,16,0,708,670,38,1721,888,32,62,304,435
"2021","Shropshire 022","E02006036",5616,3182,2222,2194,28,0,960,910,50,2434,1344,40,130,510,410
"2021","Shropshire 023","E02006037",7709,4838,3923,3893,30,11,904,878,26,2871,1668,59,100,562,482
"2021","Shropshire 024","E02006038",6884,4576,3583,3567,16,7,986,956,30,2308,1309,35,99,403,462
"2021","Shropshire 026","E02006039",6787,4569,3596,3570,26,10,963,934,29,2218,1201,53,78,403,483
"2021","Shropshire 028","E02006040",6387,4442,3656,3622,34,2,784,752,32,1945,1084,81,86,328,366
"2021","Shropshire 030","E02006041",4825,3166,2451,2429,22,3,712,686,26,1659,951,42,64,297,305
"2021","Shropshire 032","E02006042",5014,3288,2776,2762,14,4,508,492,16,1726,838,50,62,326,450
"2021","Shropshire 036","E02006043",5690,3783,2913,2893,20,6,864,838,26,1907,1078,66,84,320,359
"2021","Shropshire 037","E02006044",5323,3721,3055,3019,36,5,661,631,30,1602,875,41,60,277,349
"2021","Shropshire 038","E02006045",8999,5339,4052,4021,31,3,1284,1220,64,3660,1918,87,143,742,770
"2021","Shropshire 039","E02006046",7548,5104,4142,4122,20,8,954,926,28,2444,1319,60,122,439,504
"2021","Cannock Chase 001","E02006118",6267,4330,3389,3383,6,9,932,910,22,1937,1094,36,75,313,419
"2021","Cannock Chase 002","E02006119",6573,3658,2551,2535,16,5,1102,1034,68,2915,1734,44,129,582,426
"2021","Cannock Chase 003","E02006120",7461,4629,3306,3295,11,5,1318,1276,42,2832,1646,52,117,525,492
"2021","Cannock Chase 004","E02006121",4843,3160,2219,2205,14,3,938,906,32,1683,978,28,80,301,296
"2021","Cannock Chase 005","E02006122",6573,4211,2837,2814,23,4,1370,1328,42,2362,1458,37,122,418,327
"2021","Cannock Chase 006","E02006123",5256,3474,2626,2622,4,4,844,814,30,1782,1090,32,93,305,262
"2021","Cannock Chase 007","E02006124",5818,3313,2269,2259,10,5,1039,1001,38,2505,1527,33,105,437,403
"2021","Cannock Chase 008","E02006125",6053,3493,2387,2373,14,3,1103,1056,47,2560,1508,38,132,451,431
"2021","Cannock Chase 009","E02006126",6811,4422,3229,3209,20,5,1188,1140,48,2389,1386,46,129,435,393
"2021","Cannock Chase 010","E02006127",5640,3922,2875,2857,18,3,1044,994,50,1718,1185,25,75,301,132
"2021","Cannock Chase 011","E02006128",7216,4547,3545,3534,11,8,994,952,42,2669,1424,48,132,473,592
"2021","Cannock Chase 012","E02006129",6710,3765,2333,2311,22,1,1431,1359,72,2945,1787,55,157,529,417
"2021","Cannock Chase 013","E02006130",6772,4461,3111,3085,26,8,1342,1286,56,2311,1363,35,123,373,417
"2021","East Staffordshire 001","E02006131",6318,4278,3441,3418,23,6,831,800,31,2040,1208,51,85,334,362
"2021","East Staffordshire 002","E02006132",5594,3551,2539,2523,16,0,1012,974,38,2043,1220,32,82,355,354
"2021","East Staffordshire 003","E02006133",5693,3516,2557,2543,14,3,956,918,38,2177,1251,45,118,397,366
"2021","East Staffordshire 004","E02006134",8650,5867,4672,4660,12,5,1190,1156,34,2783,1563,42,117,481,580
"2021","East Staffordshire 005","E02006135",6531,4428,3573,3559,14,11,844,820,24,2103,1191,24,85,336,467
"2021","East Staffordshire 006","E02006136",6757,4733,3989,3969,20,6,738,706,32,2024,1110,34,75,327,478
"2021","East Staffordshire 007","E02006137",7086,3944,2881,2857,24,9,1054,998,56,3142,1880,78,172,539,473
"2021","East Staffordshire 008","E02006138",6075,3428,2313,2297,16,3,1112,1040,72,2647,1695,138,145,420,249
"2021","East Staffordshire 009","E02006139",6440,3473,2477,2465,12,6,990,946,44,2967,1928,178,163,406,292
"2021","East Staffordshire 010","E02006140",6653,4068,2996,2970,26,20,1052,1000,52,2585,1580,54,132,419,400
"2021","East Staffordshire 011","E02006141",9461,4922,3215,3189,26,6,1701,1634,67,4539,2941,270,234,709,385
"2021","East Staffordshire 012","E02006142",4386,2965,2337,2333,4,3,625,608,17,1421,824,24,59,245,269
"2021","East Staffordshire 013","E02006143",7494,5028,3633,3603,30,11,1384,1330,54,2466,1526,64,113,381,382
"2021","East Staffordshire 014","E02006144",6563,3482,2370,2358,12,12,1100,1070,30,3081,1897,40,150,549,445
"2021","East Staffordshire 015","E02006145",4898,3340,2842,2834,8,2,496,482,14,1558,795,29,63,332,339
"2021","Lichfield 001","E02006146",7148,4746,3588,3566,22,2,1156,1122,34,2402,1353,50,123,452,424
"2021","Lichfield 002","E02006147",6875,4734,3812,3804,8,0,922,882,40,2141,1263,45,91,367,375
"2021","Lichfield 003","E02006148",6089,4259,3582,3570,12,3,674,624,50,1830,1071,47,64,271,377
"2021","Lichfield 004","E02006149",8729,4700,3392,3360,32,4,1304,1256,48,4029,2261,70,221,760,717
"2021","Lichfield 005","E02006150",9647,6434,5269,5243,26,9,1156,1114,42,3213,1785,53,131,577,667
"2021","Lichfield 006","E02006151",8003,5096,3714,3694,20,8,1374,1340,34,2907,1688,53,124,536,506
"2021","Lichfield 007","E02006152",8481,5478,4185,4165,20,11,1282,1208,74,3003,1724,40,160,569,510
"2021","Lichfield 008","E02006153",7375,5236,3966,3934,32,2,1268,1198,70,2139,1301,42,87,331,378
"2021","Lichfield 009","E02006154",8239,5477,4407,4389,18,8,1062,1028,34,2762,1447,31,98,470,716
"2021","Lichfield 010","E02006155",4480,2609,1788,1775,13,5,816,790,26,1871,1126,37,109,354,245
"2021","Lichfield 011","E02006156",6633,4641,4028,4008,20,0,613,586,27,1992,1168,91,56,268,409
"2021","Lichfield 012","E02006157",5501,3506,2646,2644,2,4,856,826,30,1995,1191,42,84,336,342
"2021","Newcastle-under-Lyme 001","E02006158",6958,4794,3758,3752,6,2,1034,1006,28,2164,1276,34,80,336,438
"2021","Newcastle-under-Lyme 002","E02006159",4569,2733,1918,1910,8,2,813,783,30,1836,1040,24,103,338,331
"2021","Newcastle-under-Lyme 003","E02006160",7049,4291,3035,3024,11,4,1252,1206,46,2758,1578,43,150,499,488
"2021","Newcastle-under-Lyme 004","E02006161",5509,3676,2940,2914,26,2,734,710,24,1833,1074,39,65,273,382
"2021","Newcastle-under-Lyme 005","E02006162",6957,4466,3319,3293,26,5,1142,1077,65,2491,1431,44,104,422,490
"2021","Newcastle-under-Lyme 006","E02006163",6225,3724,2674,2660,14,6,1044,998,46,2501,1602,40,111,397,351
"2021","Newcastle-under-Lyme 007","E02006164",5640,3074,1949,1937,12,5,1120,1082,38,2566,1579,52,144,436,355
"2021","Newcastle-under-Lyme 008","E02006165",6154,3588,2361,2346,15,2,1225,1158,67,2566,1500,50,131,511,374
"2021","Newcastle-under-Lyme 009","E02006166",5867,3747,2793,2786,7,10,944,898,46,2120,1262,35,108,346,369
"2021","Newcastle-under-Lyme 010","E02006167",7906,4141,2679,2669,10,13,1449,1385,64,3765,2503,70,161,590,441
"2021","Newcastle-under-Lyme 011","E02006168",6840,2912,1987,1963,24,3,922,862,60,3928,2718,80,137,570,423
"2021","Newcastle-under-Lyme 012","E02006169",4486,2654,1930,1912,18,0,724,700,24,1832,1132,24,91,282,303
"2021","Newcastle-under-Lyme 013","E02006170",4370,2777,2186,2177,9,7,584,564,20,1593,851,35,66,311,330
"2021","Newcastle-under-Lyme 014","E02006171",7460,4398,3398,3384,14,4,996,940,56,3062,1851,61,117,508,525
"2021","Newcastle-under-Lyme 015","E02006172",7979,5351,4530,4513,17,5,816,776,40,2628,1460,61,102,413,592
"2021","Newcastle-under-Lyme 016","E02006173",6015,4270,3556,3534,22,2,712,690,22,1745,1003,53,53,263,373
"2021","South Staffordshire 001","E02006174",9174,6072,4852,4820,32,6,1214,1148,66,3102,1726,62,141,525,648
"2021","South Staffordshire 002","E02006175",5510,3564,2542,2530,12,2,1020,990,30,1946,1186,30,98,319,313
"2021","South Staffordshire 003","E02006176",6197,4242,3564,3546,18,2,676,650,26,1955,1035,53,98,310,459
"2021","South Staffordshire 004","E02006177",8224,5466,4386,4372,14,6,1074,1052,22,2758,1573,53,113,434,585
"2021","South Staffordshire 005","E02006178",6337,3970,3118,3096,22,2,850,818,32,2367,1394,44,96,388,445
"2021","South Staffordshire 006","E02006179",5542,3740,2968,2954,14,6,766,744,22,1802,995,30,79,291,407
"2021","South Staffordshire 007","E02006180",5521,3479,2659,2649,10,9,811,784,27,2042,1209,45,106,321,361
"2021","South Staffordshire 008","E02006181",4588,2691,2015,2009,6,1,675,654,21,1897,1065,28,78,360,366
"2021","South Staffordshire 009","E02006182",5794,3982,3254,3246,8,8,720,692,28,1812,1008,51,58,259,436
"2021","South Staffordshire 012","E02006185",5930,3518,2774,2756,18,6,738,708,30,2412,1296,45,100,406,565
"2021","South Staffordshire 013","E02006186",10527,7068,5934,5908,26,2,1132,1086,46,3459,1946,92,125,509,787
"2021","South Staffordshire 014","E02006187",6059,4094,3387,3371,16,3,704,686,18,1965,1037,51,70,327,480
"2021","South Staffordshire 015","E02006982",10158,6582,5224,5206,18,12,1346,1314,32,3576,2071,44,150,668,643
"2021","Stafford 001","E02006188",5001,3431,2747,2737,10,4,680,654,26,1570,908,34,49,245,334
"2021","Stafford 002","E02006189",5986,4124,3379,3351,28,7,738,710,28,1862,1000,42,99,303,418
"2021","Stafford 003","E02006190",8968,5348,3812,3788,24,6,1530,1444,86,3620,1964,57,198,752,649
"2021","Stafford 004","E02006191",6769,4806,3976,3960,16,4,826,800,26,1963,1078,39,93,362,391
"2021","Stafford 005","E02006192",7484,5257,4148,4134,14,2,1107,1072,35,2227,1229,39,112,433,414
"2021","Stafford 006","E02006193",6203,4300,3234,3206,28,8,1058,1012,46,1903,1053,42,82,328,398
"2021","Stafford 007","E02006194",6604,3947,2675,2649,26,6,1266,1204,62,2657,1594,42,127,501,393
"2021","Stafford 008","E02006195",7353,5202,4294,4270,24,10,898,874,24,2151,1124,30,99,426,472
"2021","Stafford 009","E02006196",5203,2863,1902,1892,10,9,952,912,40,2340,1485,51,119,443,242
"2021","Stafford 010","E02006197",7705,3902,2283,2249,34,3,1616,1522,94,3803,2350,67,220,765,401
"2021","Stafford 011","E02006198",7020,4812,3736,3702,34,8,1068,1032,36,2208,1268,32,108,431,369
"2021","Stafford 012","E02006199",6962,4778,3868,3842,26,2,908,868,40,2184,1266,53,83,345,437
"2021","Stafford 013","E02006200",6147,3350,2269,2249,20,3,1078,1026,52,2797,1622,42,152,566,415
"2021","Stafford 014","E02006201",9948,6986,5933,5917,16,9,1044,1000,44,2962,1562,55,131,506,708
"2021","Stafford 015","E02006202",7880,5461,4391,4372,19,6,1064,1040,24,2419,1351,56,84,410,518
"2021","Stafford 016","E02006203",6182,3598,2523,2511,12,3,1072,1024,48,2584,1546,54,117,493,374
"2021","Staffordshire Moorlands 001","E02006204",6012,3678,2681,2665,16,11,986,960,26,2334,1332,59,104,402,437
"2021","Staffordshire Moorlands 002","E02006205",6252,4436,3681,3665,16,7,748,714,34,1816,978,39,57,266,476
"2021","Staffordshire Moorlands 003","E02006206",6284,3563,2472,2458,14,6,1085,1046,39,2721,1615,36,165,508,397
"2021","Staffordshire Moorlands 004","E02006207",5364,3660,2954,2950,4,6,700,690,10,1704,872,24,63,273,472
"2021","Staffordshire Moorlands 005","E02006208",6579,3512,2307,2281,26,1,1204,1160,44,3067,1766,60,170,657,414
"2021","Staffordshire Moorlands 006","E02006209",8816,5944,4718,4710,8,2,1224,1190,34,2872,1591,53,111,486,631
"2021","Staffordshire Moorlands 007","E02006210",4445,3078,2540,2530,10,6,532,518,14,1367,763,56,42,221,285
"2021","Staffordshire Moorlands 008","E02006211",5390,3697,3061,3047,14,5,631,610,21,1693,931,32,58,233,439
"2021","Staffordshire Moorlands 009","E02006212",6471,4440,3549,3533,16,1,890,872,18,2031,1093,48,76,294,520
"2021","Staffordshire Moorlands 010","E02006213",5494,3532,2643,2625,18,3,886,850,36,1962,1132,45,89,331,365
"2021","Staffordshire Moorlands 011","E02006214",5140,3059,2316,2301,15,5,738,700,38,2081,1163,30,101,387,400
"2021","Staffordshire Moorlands 012","E02006215",6688,4541,3617,3610,7,2,922,880,42,2147,1184,47,65,340,511
"2021","Staffordshire Moorlands 013","E02006216",7055,4860,3993,3970,23,11,856,832,24,2195,1254,61,96,334,450
"2021","Tamworth 001","E02006217",8247,5472,4134,4118,16,4,1334,1288,46,2775,1556,74,116,489,540
"2021","Tamworth 002","E02006218",6996,3636,2372,2354,18,4,1260,1190,70,3360,1828,66,177,716,573
"2021","Tamworth 003","E02006219",6722,4300,3212,3202,10,12,1076,1036,40,2422,1552,36,101,410,323
"2021","Tamworth 004","E02006220",6103,3848,2915,2907,8,5,928,886,42,2255,1289,58,102,399,407
"2021","Tamworth 005","E02006221",4854,3065,2302,2294,8,3,760,738,22,1789,1119,25,107,321,217
"2021","Tamworth 006","E02006222",5476,3240,2302,2292,10,5,933,901,32,2236,1352,21,116,399,348
"2021","Tamworth 007","E02006223",5089,2596,1731,1721,10,7,858,840,18,2493,1621,36,124,449,263
"2021","Tamworth 008","E02006224",6100,4101,2987,2971,16,8,1106,1062,44,1999,1321,32,74,343,229
"2021","Tamworth 009","E02006225",6055,4160,3258,3236,22,2,900,874,26,1895,1139,29,84,297,346
"2021","Tamworth 010","E02006226",7824,4893,3427,3415,12,4,1462,1422,40,2931,1858,56,161,499,357
"2021","North Warwickshire 001","E02006468",9015,5910,4562,4536,26,8,1340,1290,50,3105,1855,40,129,511,570
"2021","North Warwickshire 002","E02006469",7040,4349,3117,3101,16,4,1228,1176,52,2691,1614,52,147,447,431
"2021","North Warwickshire 003","E02006470",9567,5560,3944,3906,38,4,1612,1548,64,4007,2331,92,226,718,640
"2021","North Warwickshire 004","E02006471",5906,3917,3105,3089,16,0,812,770,42,1989,1189,37,90,301,372
"2021","North Warwickshire 005","E02006472",7935,4978,3543,3523,20,5,1430,1380,50,2957,1803,47,125,550,432
"2021","North Warwickshire 006","E02006473",8548,5265,3986,3963,23,9,1270,1228,42,3283,1985,52,161,519,566
"2021","North Warwickshire 007","E02006474",5232,3502,2634,2608,26,2,866,840,26,1730,1041,37,72,295,285
"2021","Nuneaton and Bedworth 001","E02006475",7669,5096,3937,3913,24,3,1156,1118,38,2573,1507,62,103,444,457
"2021","Nuneaton and Bedworth 002","E02006476",7293,4114,2685,2665,20,5,1424,1346,78,3179,2056,65,171,508,379
"2021","Nuneaton and Bedworth 003","E02006477",7018,4768,3815,3797,18,9,944,910,34,2250,1397,56,99,321,377
"2021","Nuneaton and Bedworth 004","E02006478",6732,4396,3194,3176,18,8,1194,1162,32,2336,1494,32,123,379,308
"2021","Nuneaton and Bedworth 005","E02006479",7446,3805,2747,2732,15,12,1046,996,50,3641,2248,165,207,637,384
"2021","Nuneaton and Bedworth 006","E02006480",6030,3543,2492,2464,28,2,1049,1009,40,2487,1513,55,127,467,325
"2021","Nuneaton and Bedworth 007","E02006481",5673,3308,2301,2293,8,5,1002,962,40,2365,1420,42,139,408,356
"2021","Nuneaton and Bedworth 008","E02006482",5803,3627,2651,2626,25,2,974,940,34,2176,1332,50,119,359,316
"2021","Nuneaton and Bedworth 009","E02006483",6201,3282,2458,2442,16,2,822,778,44,2919,1804,137,133,457,388
"2021","Nuneaton and Bedworth 010","E02006484",6209,3514,2554,2540,14,4,956,920,36,2695,1657,57,132,474,375
"2021","Nuneaton and Bedworth 011","E02006485",5750,3996,3395,3385,10,3,598,590,8,1754,982,52,48,250,422
"2021","Nuneaton and Bedworth 012","E02006486",5862,3584,2746,2738,8,2,836,808,28,2278,1327,44,111,391,405
"2021","Nuneaton and Bedworth 013","E02006487",5607,3131,2237,2229,8,7,887,862,25,2476,1468,35,145,435,393
"2021","Nuneaton and Bedworth 014","E02006488",5246,3382,2770,2754,16,2,610,582,28,1864,918,49,85,276,536
"2021","Nuneaton and Bedworth 015","E02006489",6372,3636,2617,2609,8,9,1010,978,32,2736,1619,88,139,518,372
"2021","Nuneaton and Bedworth 016","E02006490",6166,3728,2784,2772,12,12,932,906,26,2438,1491,60,119,337,431
"2021","Nuneaton and Bedworth 018","E02006806",6786,3948,2969,2945,24,7,972,934,38,2838,1736,75,145,463,419
"2021","Rugby 002","E02006493",8546,5361,3924,3875,49,5,1432,1382,50,3185,2073,103,154,552,303
"2021","Rugby 003","E02006494",5915,2897,1864,1844,20,8,1025,986,39,3018,1882,87,128,543,378
"2021","Rugby 004","E02006495",6489,4300,3442,3432,10,0,858,826,32,2189,1300,40,73,359,417
"2021","Rugby 005","E02006496",5838,3014,1893,1885,8,9,1112,1066,46,2824,1807,184,149,459,225
"2021","Rugby 006","E02006497",6513,3541,2253,2245,8,6,1282,1220,62,2972,1894,130,130,536,282
"2021","Rugby 007","E02006498",10667,7020,5483,5473,10,9,1528,1474,54,3647,2341,77,175,594,460
"2021","Rugby 008","E02006499",5134,3434,2778,2762,16,8,648,630,18,1700,985,55,64,265,331
"2021","Rugby 009","E02006500",4487,2605,1986,1978,8,2,617,599,18,1882,1049,42,105,368,318
"2021","Rugby 010","E02006501",8101,5229,4120,4104,16,5,1104,1064,40,2872,1661,69,135,496,511
"2021","Rugby 011","E02006502",8969,5699,4659,4634,25,12,1028,984,44,3270,1773,82,130,613,672
"2021","Rugby 012","E02006503",8087,5530,4490,4474,16,4,1036,978,58,2557,1413,61,135,440,508
"2021","Rugby 013","E02007048",6026,4220,3361,3345,16,3,856,808,48,1806,1024,63,78,281,360
"2021","Rugby 014","E02007049",5995,4212,2986,2958,28,6,1220,1178,42,1783,1159,65,102,303,154
"2021","Stratford-on-Avon 001","E02006504",4953,3516,2963,2947,16,3,550,542,8,1437,866,51,62,209,249
"2021","Stratford-on-Avon 002","E02006505",5944,3798,3144,3134,10,4,650,610,40,2146,1048,53,80,418,547
"2021","Stratford-on-Avon 003","E02006506",4876,3012,2336,2330,6,0,676,658,18,1864,1011,38,76,386,353
"2021","Stratford-on-Avon 004","E02006507",9001,5852,4400,4382,18,2,1450,1404,46,3149,1872,55,171,522,529
"2021","Stratford-on-Avon 005","E02006508",9106,6328,4992,4962,30,12,1324,1286,38,2778,1572,66,131,509,500
"2021","Stratford-on-Avon 006","E02006509",4955,2928,2280,2270,10,4,644,616,28,2027,1019,27,117,434,430
"2021","Stratford-on-Avon 007","E02006510",5738,3995,3330,3312,18,7,658,642,16,1743,939,35,70,340,359
"2021","Stratford-on-Avon 008","E02006511",8614,5852,4715,4703,12,5,1132,1072,60,2762,1490,60,132,515,565
"2021","Stratford-on-Avon 009","E02006512",10285,5976,4276,4246,30,10,1690,1614,76,4309,2524,154,206,860,565
"2021","Stratford-on-Avon 010","E02006513",6854,4440,3651,3623,28,9,780,760,20,2414,1284,72,111,445,502
"2021","Stratford-on-Avon 011","E02006514",7531,4506,3608,3592,16,10,888,826,62,3025,1575,79,127,618,626
"2021","Stratford-on-Avon 012","E02006515",9120,6236,4925,4903,22,7,1304,1260,44,2884,1601,63,123,582,515
"2021","Stratford-on-Avon 013","E02006516",8027,5508,4379,4343,36,5,1124,1082,42,2519,1424,71,130,479,415
"2021","Stratford-on-Avon 014","E02006517",7888,5421,4221,4200,21,12,1188,1146,42,2467,1401,57,145,471,393
"2021","Stratford-on-Avon 015","E02006518",8612,5585,4429,4398,31,8,1148,1096,52,3027,1585,81,134,620,607
"2021","Warwick 001","E02006519",6669,4244,3366,3342,24,6,872,830,42,2425,1350,42,105,449,479
"2021","Warwick 002","E02006520",6926,4519,3742,3727,15,5,772,752,20,2407,1395,58,102,454,398
"2021","Warwick 003","E02006521",6070,3938,3417,3411,6,7,514,496,18,2132,1179,35,56,357,505
"2021","Warwick 004","E02006522",4882,3372,2822,2802,20,2,548,530,18,1510,851,53,61,262,283
"2021","Warwick 005","E02006523",8497,5764,4700,4680,20,6,1058,1028,30,2733,1606,62,94,449,522
"2021","Warwick 006","E02006524",4400,2414,1776,1770,6,8,630,612,18,1986,1292,33,78,330,253
"2021","Warwick 007","E02006525",10983,6152,4682,4638,44,4,1466,1398,68,4831,3347,104,125,639,616
"2021","Warwick 008","E02006526",7138,4361,3276,3257,19,3,1082,1052,30,2777,1693,57,118,501,408
"2021","Warwick 009","E02006527",7725,4442,3230,3200,30,0,1212,1176,36,3283,2201,109,103,511,359
"2021","Warwick 010","E02006528",9450,4600,3163,3123,40,19,1418,1354,64,4850,3662,140,116,567,365
"2021","Warwick 011","E02006529",10056,5902,4164,4134,30,16,1722,1692,30,4154,2578,83,227,790,476
"2021","Warwick 012","E02006530",10561,6722,5214,5178,36,16,1492,1408,84,3839,2421,97,123,664,534
"2021","Warwick 013","E02006531",8665,3610,2574,2556,18,14,1022,954,68,5055,3922,126,146,527,334
"2021","Warwick 014","E02006532",9118,6275,4833,4796,37,4,1438,1398,40,2843,1738,49,146,493,417
"2021","Warwick 015","E02006533",8293,5280,4136,4122,14,12,1132,1076,56,3013,1877,80,123,493,440
"2021","Bromsgrove 001","E02006696",5703,3815,3272,3258,14,4,539,526,13,1888,1063,31,84,308,402
"2021","Bromsgrove 002","E02006697",6138,4138,3435,3419,16,3,700,674,26,2000,1162,45,82,316,395
"2021","Bromsgrove 003","E02006698",5269,3393,2592,2576,16,4,797,766,31,1876,1121,24,76,268,387
"2021","Bromsgrove 004","E02006699",4794,3112,2559,2552,7,8,545,534,11,1682,917,26,63,278,398
"2021","Bromsgrove 005","E02006700",5125,3486,2972,2962,10,4,510,486,24,1639,967,32,53,211,376
"2021","Bromsgrove 006","E02006701",5909,4238,3526,3496,30,2,710,660,50,1671,1017,50,72,228,304
"2021","Bromsgrove 007","E02006702",4799,2877,2156,2146,10,3,718,684,34,1922,1126,29,75,388,304
"2021","Bromsgrove 008","E02006703",6414,4474,3604,3588,16,10,860,812,48,1940,1123,57,91,307,362
"2021","Bromsgrove 009","E02006704",5576,3694,3017,2997,20,9,668,636,32,1882,1038,50,97,332,365
"2021","Bromsgrove 010","E02006705",5870,3476,2583,2564,19,3,890,852,38,2394,1415,30,124,480,345
"2021","Bromsgrove 011","E02006706",5551,3068,2319,2311,8,3,746,720,26,2483,1269,50,142,545,477
"2021","Bromsgrove 012","E02006707",5422,3808,3184,3174,10,4,620,606,14,1614,961,25,81,252,295
"2021","Bromsgrove 013","E02006708",6306,3556,2422,2406,16,4,1130,1066,64,2750,1716,36,126,533,339
"2021","Bromsgrove 014","E02006709",6437,4387,3405,3392,13,2,980,936,44,2050,1199,48,117,373,313
"2021","Malvern Hills 001","E02006710",7072,4751,3868,3832,36,8,875,850,25,2321,1276,57,89,444,455
"2021","Malvern Hills 002","E02006711",7069,4827,4059,4040,19,6,762,730,32,2242,1294,59,89,368,432
"2021","Malvern Hills 003","E02006712",6362,4488,3620,3594,26,4,864,846,18,1874,1058,47,67,293,409
"2021","Malvern Hills 004","E02006713",5280,3117,2332,2324,8,3,782,738,44,2163,1102,28,114,438,481
"2021","Malvern Hills 005","E02006714",4890,3370,2818,2798,20,4,548,532,16,1520,827,27,62,251,353
"2021","Malvern Hills 006","E02006715",7161,4552,3439,3413,26,7,1106,1072,34,2609,1584,59,127,488,351
"2021","Malvern Hills 007","E02006716",5057,2785,1923,1913,10,7,855,812,43,2272,1336,48,117,473,298
"2021","Malvern Hills 008","E02006717",5700,3996,3175,3151,24,3,818,790,28,1704,894,56,66,283,405
"2021","Malvern Hills 009","E02006718",4951,2962,2342,2330,12,2,618,576,42,1989,1043,52,83,394,417
"2021","Malvern Hills 010","E02006719",5980,3714,3025,2997,28,1,688,646,42,2266,1153,60,126,464,463
"2021","Malvern Hills 011","E02006720",6131,4025,3269,3255,14,6,750,726,24,2106,1115,49,98,405,439
"2021","Redditch 001","E02006721",5439,3710,2917,2897,20,3,790,764,26,1729,1056,20,81,267,305
"2021","Redditch 002","E02006722",4190,2277,1484,1476,8,13,780,766,14,1913,1192,27,121,386,187
"2021","Redditch 003","E02006723",7142,4196,2826,2794,32,6,1364,1306,58,2946,1889,53,158,518,328
"2021","Redditch 004","E02006724",5521,2808,1938,1934,4,6,864,816,48,2713,1767,147,120,434,245
"2021","Redditch 005","E02006725",4470,2624,1924,1918,6,0,700,686,14,1846,1122,43,77,379,225
"2021","Redditch 006","E02006726",5169,2964,2181,2179,2,5,778,746,32,2205,1394,79,104,350,278
"2021","Redditch 007","E02006727",4928,3174,2509,2501,8,1,664,642,22,1754,987,52,81,301,333
"2021","Redditch 008","E02006728",6305,4210,3269,3251,18,8,933,902,31,2095,1189,42,101,377,386
"2021","Redditch 009","E02006729",6155,4009,2918,2884,34,10,1081,1045,36,2146,1332,54,101,379,280
"2021","Redditch 010","E02006730",5120,2902,1874,1864,10,0,1028,978,50,2218,1447,47,139,374,211
"2021","Redditch 011","E02006731",4635,2789,2043,2031,12,2,744,704,40,1846,1035,33,91,402,285
"2021","Redditch 012","E02006732",5820,3812,3008,2994,14,6,798,766,32,2008,1165,35,84,350,374
"2021","Redditch 013","E02006733",5026,3302,2574,2550,24,4,724,694,30,1724,970,37,76,346,295
"2021","Worcester 001","E02006734",6686,4507,3604,3580,24,2,901,887,14,2179,1235,20,83,382,459
"2021","Worcester 002","E02006735",4184,2058,1332,1314,18,2,724,690,34,2126,1363,36,86,391,250
"2021","Worcester 003","E02006736",5355,3498,2516,2504,12,0,982,950,32,1857,1159,24,80,396,198
"2021","Worcester 004","E02006737",6882,4108,2966,2946,20,10,1132,1074,58,2774,1641,49,126,546,412
"2021","Worcester 005","E02006738",7115,3916,2521,2501,20,13,1382,1298,84,3199,2093,88,144,506,368
"2021","Worcester 006","E02006739",4329,2452,1848,1842,6,0,604,566,38,1877,1306,22,47,216,286
"2021","Worcester 007","E02006740",6357,3052,1725,1703,22,5,1322,1238,84,3305,2208,92,142,540,323
"2021","Worcester 008","E02006741",4881,3250,2510,2498,12,2,738,706,32,1631,1065,44,75,273,174
"2021","Worcester 009","E02006742",7339,3651,2436,2432,4,2,1213,1141,72,3688,2529,62,121,598,378
"2021","Worcester 010","E02006743",5399,3132,2306,2300,6,2,824,794,30,2267,1474,79,102,356,256
"2021","Worcester 011","E02006744",6042,3105,2092,2062,30,5,1008,958,50,2937,1916,104,130,540,247
"2021","Worcester 012","E02006745",7184,4578,3441,3421,20,11,1126,1076,50,2606,1545,47,110,447,457
"2021","Worcester 013","E02006746",7334,4584,3340,3300,40,4,1240,1190,50,2750,1718,55,128,450,399
"2021","Worcester 014","E02006747",4740,3116,2326,2314,12,4,786,768,18,1624,1003,30,53,289,249
"2021","Wychavon 001","E02006748",7085,4844,3707,3683,24,5,1132,1086,46,2241,1289,48,106,403,395
"2021","Wychavon 002","E02006749",4262,2402,1688,1676,12,4,710,684,26,1860,1142,29,85,350,254
"2021","Wychavon 003","E02006750",4578,2652,2053,2035,18,3,596,574,22,1926,952,40,88,363,483
"2021","Wychavon 004","E02006751",4775,2848,2181,2165,16,1,666,640,26,1927,1076,18,87,392,354
"2021","Wychavon 005","E02006752",6799,4750,3725,3707,18,7,1018,972,46,2049,1243,25,60,376,345
"2021","Wychavon 006","E02006753",6048,4176,3379,3355,24,5,792,752,40,1872,1058,41,80,338,355
"2021","Wychavon 007","E02006754",4891,3536,2959,2947,12,5,572,544,28,1355,786,29,30,247,263
"2021","Wychavon 008","E02006755",5015,3646,3100,3080,20,7,539,515,24,1369,779,28,48,206,308
"2021","Wychavon 009","E02006756",5378,3680,2876,2850,26,8,796,758,38,1698,1061,33,80,302,222
"2021","Wychavon 010","E02006757",6160,4211,3482,3471,11,7,722,704,18,1949,1073,40,83,340,413
"2021","Wychavon 011","E02006758",4949,3438,2682,2668,14,12,744,732,12,1511,852,43,68,265,283
"2021","Wychavon 012","E02006759",7002,4245,3221,3199,22,2,1022,1000,22,2757,1425,45,124,554,609
"2021","Wychavon 013","E02006760",7463,5046,4000,3978,22,20,1026,976,50,2417,1271,60,116,457,513
"2021","Wychavon 014","E02006761",5280,2676,1654,1640,14,6,1016,980,36,2604,1465,80,140,572,347
"2021","Wychavon 015","E02006762",5883,3882,2880,2868,12,0,1002,956,46,2001,1132,23,100,401,345
"2021","Wychavon 016","E02006763",6807,4513,3353,3329,24,7,1153,1124,29,2294,1367,51,122,389,365
"2021","Wychavon 017","E02006764",4657,2914,2086,2076,10,2,826,790,36,1743,1017,51,71,358,246
"2021","Wychavon 018","E02006765",5485,3703,3038,3022,16,1,664,636,28,1782,864,50,66,350,452
"2021","Wychavon 019","E02006766",6730,4814,4092,4072,20,2,720,692,28,1916,1034,49,81,328,424
"2021","Wyre Forest 001","E02006767",7876,5157,4114,4097,17,1,1042,1014,28,2719,1470,47,126,521,555
"2021","Wyre Forest 002","E02006768",5745,3782,2829,2818,11,11,942,902,40,1963,1101,42,83,351,386
"2021","Wyre Forest 003","E02006769",5841,3782,2777,2753,24,7,998,942,56,2059,1177,32,90,390,370
"2021","Wyre Forest 004","E02006770",6536,3354,2102,2070,32,6,1246,1202,44,3182,2055,71,169,558,329
"2021","Wyre Forest 005","E02006771",5740,3638,2872,2854,18,8,758,726,32,2102,1084,47,109,454,408
"2021","Wyre Forest 006","E02006772",5457,3449,2569,2565,4,10,870,834,36,2008,1150,31,67,361,399
"2021","Wyre Forest 007","E02006773",6744,3870,2828,2812,16,4,1038,1004,34,2874,1586,54,151,583,500
"2021","Wyre Forest 008","E02006774",6178,3564,2413,2405,8,3,1148,1116,32,2614,1493,43,142,563,373
"2021","Wyre Forest 009","E02006775",4705,2594,1645,1639,6,5,944,880,64,2111,1294,36,131,376,274
"2021","Wyre Forest 010","E02006776",5327,3450,2664,2646,18,2,784,764,20,1877,1123,28,82,353,291
"2021","Wyre Forest 011","E02006777",6263,4041,3278,3266,12,3,760,738,22,2222,1118,48,91,464,501
"2021","Wyre Forest 012","E02006778",5812,3797,2945,2937,8,0,852,826,26,2015,1102,46,87,369,411
"2021","Wyre Forest 013","E02006779",6489,3810,2884,2874,10,6,920,894,26,2679,1387,56,149,568,519
"2021","Wyre Forest 014","E02006780",4995,3043,2333,2312,21,2,708,680,28,1952,982,35,113,366,456
"2021","Birmingham 001","E02001827",5141,3208,2746,2740,6,4,458,452,6,1933,1115,47,70,330,371
"2021","Birmingham 002","E02001828",5819,3590,3012,3002,10,2,576,542,34,2229,1267,47,95,354,466
"2021","Birmingham 003","E02001829",7134,4816,4135,4117,18,3,678,670,8,2318,1379,59,67,366,447
"2021","Birmingham 004","E02001830",8027,5411,4664,4646,18,9,738,712,26,2616,1604,85,87,323,517
"2021","Birmingham 005","E02001831",8296,4413,3347,3327,20,14,1052,1012,40,3883,2445,77,178,688,495
"2021","Birmingham 006","E02001832",6575,4170,3443,3421,22,5,722,682,40,2405,1460,56,87,368,434
"2021","Birmingham 007","E02001833",4810,2998,2484,2478,6,4,510,486,24,1812,1206,38,68,220,280
"2021","Birmingham 008","E02001834",4647,2296,1610,1604,6,0,686,664,22,2351,1587,53,118,337,256
"2021","Birmingham 009","E02001835",6713,4060,3100,3080,20,2,958,914,44,2653,1645,60,100,463,385
"2021","Birmingham 010","E02001836",7389,4798,4001,3961,40,9,788,746,42,2591,1581,62,117,362,469
"2021","Birmingham 011","E02001837",7977,3462,2430,2426,4,1,1031,970,61,4515,3166,106,245,596,402
"2021","Birmingham 012","E02001838",6269,4140,3414,3402,12,6,720,686,34,2129,1258,55,76,327,413
"2021","Birmingham 013","E02001839",5155,2672,1959,1951,8,9,704,684,20,2483,1573,63,109,354,384
"2021","Birmingham 014","E02001840",7181,3082,2211,2203,8,13,858,830,28,4099,2832,109,206,582,370
"2021","Birmingham 015","E02001841",4905,3276,2894,2880,14,4,378,362,16,1629,987,51,65,195,331
"2021","Birmingham 016","E02001842",6414,3474,2778,2770,8,10,686,658,28,2940,1931,115,138,372,384
"2021","Birmingham 017","E02001843",5293,2833,2054,2036,18,9,770,740,30,2460,1631,74,93,323,339
"2021","Birmingham 018","E02001844",7829,4246,3262,3222,40,12,972,906,66,3583,2138,79,158,629,579
"2021","Birmingham 019","E02001845",5193,2826,2066,2054,12,4,756,732,24,2367,1569,59,99,378,262
"2021","Birmingham 020","E02001846",6279,2944,2042,2024,18,4,898,842,56,3335,2218,107,177,487,346
"2021","Birmingham 021","E02001847",4565,2841,2290,2282,8,7,544,526,18,1724,1056,35,54,288,291
"2021","Birmingham 022","E02001848",5236,2349,1772,1766,6,12,565,537,28,2887,2064,108,133,327,255
"2021","Birmingham 023","E02001849",6472,2853,1790,1772,18,10,1053,992,61,3619,2552,95,190,536,246
"2021","Birmingham 024","E02001850",6622,3366,2833,2824,9,6,527,515,12,3256,2218,181,144,339,374
"2021","Birmingham 025","E02001851",7160,3654,2668,2632,36,6,980,952,28,3506,2322,78,174,516,416
"2021","Birmingham 026","E02001852",5565,2475,1870,1858,12,11,594,554,40,3090,2095,158,138,376,323
"2021","Birmingham 029","E02001855",7611,3106,2066,2060,6,8,1032,974,58,4505,3103,72,209,621,500
"2021","Birmingham 030","E02001856",7296,3232,2489,2445,44,9,734,702,32,4064,2946,197,200,444,277
"2021","Birmingham 031","E02001857",10720,4210,2982,2962,20,18,1210,1116,94,6510,4683,280,327,825,395
"2021","Birmingham 032","E02001858",6570,2687,2281,2279,2,12,394,366,28,3883,2644,241,202,487,309
"2021","Birmingham 033","E02001859",7564,3478,3174,3168,6,4,300,286,14,4086,2801,345,214,377,349
"2021","Birmingham 034","E02001860",6336,2809,2423,2423,0,9,377,352,25,3527,2332,336,166,371,322
"2021","Birmingham 035","E02001861",8251,3336,2975,2975,0,11,350,326,24,4915,3518,395,217,445,340
"2021","Birmingham 036","E02001862",7423,3291,2862,2860,2,13,416,380,36,4132,2768,283,250,447,384
"2021","Birmingham 037","E02001863",6085,2538,2319,2317,2,3,216,208,8,3547,2473,288,171,318,297
"2021","Birmingham 039","E02001865",8590,3638,3289,3285,4,17,332,300,32,4952,3329,494,247,440,442
"2021","Birmingham 040","E02001866",7075,2816,2567,2560,7,3,246,231,15,4259,2987,372,202,349,349
"2021","Birmingham 041","E02001867",6190,2402,2198,2194,4,10,194,190,4,3788,2691,282,202,314,299
"2021","Birmingham 042","E02001868",7195,3761,3410,3403,7,9,342,318,24,3434,2461,286,131,232,324
"2021","Birmingham 043","E02001869",4649,1602,1303,1303,0,9,290,266,24,3047,2107,199,202,344,195
"2021","Birmingham 044","E02001870",9061,4423,4010,4006,4,25,388,368,20,4638,3207,392,249,397,393
"2021","Birmingham 045","E02001871",6331,2902,2026,2012,14,4,872,833,39,3429,2255,91,172,473,438
"2021","Birmingham 046","E02001872",5593,2582,1669,1657,12,3,910,864,46,3011,2088,45,122,416,340
"2021","Birmingham 047","E02001873",8282,3076,2500,2490,10,8,568,520,48,5206,3661,360,339,515,331
"2021","Birmingham 048","E02001874",7007,3112,2823,2823,0,5,284,280,4,3895,2645,403,230,301,316
"2021","Birmingham 049","E02001875",6452,2540,1825,1805,20,17,698,644,54,3912,2887,214,233,343,235
"2021","Birmingham 050","E02001876",6547,2222,1577,1569,8,3,642,598,44,4325,3301,250,201,379,194
"2021","Birmingham 051","E02001877",8641,3794,3552,3548,4,14,228,226,2,4847,3329,498,263,369,388
"2021","Birmingham 052","E02001878",6749,2853,2574,2564,10,10,269,258,11,3896,2671,356,201,373,295
"2021","Birmingham 053","E02001879",7050,2756,2354,2342,12,4,398,354,44,4294,3096,333,181,385,299
"2021","Birmingham 054","E02001880",7079,3120,2299,2295,4,3,818,780,38,3959,2818,109,203,490,339
"2021","Birmingham 055","E02001881",7288,3376,3044,3042,2,6,326,316,10,3912,2728,327,222,325,310
"2021","Birmingham 056","E02001882",6598,3022,2540,2526,14,12,470,452,18,3576,2423,216,165,414,358
"2021","Birmingham 057","E02001883",6390,2750,1897,1875,22,13,840,788,52,3640,2497,84,181,495,383
"2021","Birmingham 058","E02001884",6875,3246,3023,3019,4,9,214,214,0,3629,2537,360,189,261,282
"2021","Birmingham 060","E02001886",7797,3566,2940,2918,22,10,616,536,80,4231,3115,290,176,365,285
"2021","Birmingham 062","E02001888",5245,2451,1892,1883,9,7,552,526,26,2794,1919,96,126,329,324
"2021","Birmingham 063","E02001889",6258,3006,2852,2848,4,4,150,134,16,3252,2289,329,158,220,256
"2021","Birmingham 064","E02001890",8035,3512,2634,2582,52,10,868,804,64,4523,3344,245,166,464,304
"2021","Birmingham 066","E02001892",7955,3822,3357,3353,4,11,454,432,22,4133,2868,295,210,413,347
"2021","Birmingham 067","E02001893",6808,3518,2951,2941,10,9,558,530,28,3290,2166,150,119,453,402
"2021","Birmingham 069","E02001895",6794,3103,2226,2214,12,11,866,826,40,3691,2520,84,164,508,415
"2021","Birmingham 070","E02001896",7210,3278,3083,3083,0,9,186,170,16,3932,2579,502,199,271,381
"2021","Birmingham 071","E02001897",6106,2388,2096,2086,10,14,278,268,10,3718,2531,274,248,397,268
"2021","Birmingham 072","E02001898",5329,3128,2444,2432,12,8,676,656,20,2201,1418,61,93,296,333
"2021","Birmingham 073","E02001899",6901,4145,3525,3490,35,10,610,562,48,2756,1632,143,104,371,506
"2021","Birmingham 074","E02001900",5118,2146,1774,1746,28,6,366,328,38,2972,2024,167,142,406,233
"2021","Birmingham 075","E02001901",6713,3745,2646,2594,52,5,1094,992,102,2968,2095,82,104,398,289
"2021","Birmingham 076","E02001902",4879,2750,2074,2068,6,6,670,650,20,2129,1434,60,90,270,275
"2021","Birmingham 077","E02001903",5833,2514,2400,2392,8,8,106,98,8,3319,2120,380,186,316,317
"2021","Birmingham 078","E02001904",5507,2610,2160,2153,7,8,442,412,30,2897,1980,188,138,328,263
"2021","Birmingham 079","E02001905",5198,2792,2221,2187,34,3,568,516,52,2406,1728,130,60,242,246
"2021","Birmingham 080","E02001906",7664,4186,3270,3250,20,12,904,862,42,3478,2350,74,143,493,418
"2021","Birmingham 081","E02001907",8414,4590,3397,3381,16,3,1190,1132,58,3824,2461,116,166,557,524
"2021","Birmingham 082","E02001908",6512,2992,2805,2793,12,12,175,171,4,3520,2337,422,185,248,328
"2021","Birmingham 083","E02001909",5975,2578,2350,2344,6,6,222,212,10,3397,2362,337,169,292,237
"2021","Birmingham 084","E02001910",5430,2124,1857,1853,4,7,260,244,16,3306,2261,296,166,303,280
"2021","Birmingham 085","E02001911",6377,2790,2121,2109,12,3,666,616,50,3587,2488,89,196,503,311
"2021","Birmingham 087","E02001913",5986,2366,1690,1672,18,2,674,624,50,3620,2727,133,107,382,271
"2021","Birmingham 088","E02001914",5410,2712,2213,2185,28,3,496,462,34,2698,1837,204,114,243,300
"2021","Birmingham 089","E02001915",9373,4491,3402,3359,43,9,1080,1010,70,4882,3265,191,211,718,497
"2021","Birmingham 090","E02001916",7172,3512,2960,2952,8,10,542,506,36,3660,2562,180,195,415,308
"2021","Birmingham 092","E02001918",6937,3123,2232,2186,46,9,882,810,72,3814,2701,179,142,510,282
"2021","Birmingham 093","E02001919",5581,2495,2069,2051,18,4,422,392,30,3086,2125,249,115,324,273
"2021","Birmingham 094","E02001920",5925,2723,2060,2048,12,3,660,636,24,3202,2232,66,142,442,320
"2021","Birmingham 095","E02001921",6017,3064,2245,2225,20,9,810,762,48,2953,2032,77,130,410,304
"2021","Birmingham 096","E02001922",12771,1269,718,702,16,2,549,500,49,11502,11035,109,87,156,115
"2021","Birmingham 097","E02001923",8423,4162,3774,3768,6,12,376,350,26,4261,2809,389,164,398,501
"2021","Birmingham 098","E02001924",5433,2832,2424,2414,10,8,400,390,10,2601,1728,117,135,359,262
"2021","Birmingham 099","E02001925",5374,2745,2110,2094,16,3,632,582,50,2629,1811,77,94,326,321
"2021","Birmingham 100","E02001926",6194,2942,2128,2088,40,2,812,740,72,3252,2435,114,100,328,275
"2021","Birmingham 101","E02001927",5696,2657,1974,1970,4,0,683,648,35,3039,2100,58,153,421,307
"2021","Birmingham 102","E02001928",5317,2533,1880,1864,16,5,648,630,18,2784,1841,46,135,461,301
"2021","Birmingham 103","E02001929",7480,3481,2677,2667,10,14,790,762,28,3999,2794,154,226,471,354
"2021","Birmingham 104","E02001930",6231,3494,2462,2410,52,8,1024,922,102,2737,1865,90,104,405,273
"2021","Birmingham 105","E02001931",6834,3712,3205,3195,10,5,502,482,20,3122,1996,195,143,384,404
"2021","Birmingham 106","E02001932",5454,2550,1803,1789,14,9,738,690,48,2904,1978,53,146,434,293
"2021","Birmingham 107","E02001933",5993,2978,2134,2106,28,6,838,798,40,3015,2078,67,149,428,293
"2021","Birmingham 108","E02001934",5519,3036,2685,2681,4,5,346,338,8,2483,1707,122,83,244,327
"2021","Birmingham 109","E02001935",6312,3420,2738,2708,30,6,676,646,30,2892,1844,67,144,398,439
"2021","Birmingham 110","E02001936",5075,3056,2612,2576,36,2,442,420,22,2019,1300,58,65,268,328
"2021","Birmingham 111","E02001937",6303,2956,2350,2332,18,2,604,574,30,3347,2321,104,155,430,337
"2021","Birmingham 112","E02001938",6378,3463,2245,2209,36,9,1209,1100,109,2915,2075,65,110,406,259
"2021","Birmingham 113","E02001939",5109,2522,2051,2043,8,3,468,452,16,2587,1581,54,122,422,408
"2021","Birmingham 115","E02001941",4785,2235,1618,1608,10,14,603,574,29,2550,1694,72,142,380,262
"2021","Birmingham 116","E02001942",5357,2712,1984,1958,26,6,722,666,56,2645,1742,52,130,418,303
"2021","Birmingham 117","E02001943",5091,2618,1921,1899,22,5,692,658,34,2473,1657,71,100,362,283
"2021","Birmingham 118","E02001944",6409,3394,2437,2407,30,3,954,916,38,3015,2022,63,115,488,327
"2021","Birmingham 119","E02001945",5896,2640,1797,1787,10,13,830,782,48,3256,2299,70,142,499,246
"2021","Birmingham 120","E02001946",6139,3656,2850,2830,20,6,800,764,36,2483,1559,50,109,392,373
"2021","Birmingham 121","E02001947",4600,1808,1254,1250,4,6,548,520,28,2792,1905,60,127,422,278
"2021","Birmingham 122","E02001948",5828,3238,2269,2251,18,9,960,940,20,2590,1652,66,157,362,353
"2021","Birmingham 123","E02001949",4664,2373,1572,1560,12,3,798,764,34,2291,1519,57,106,376,233
"2021","Birmingham 124","E02001950",6936,3952,2894,2872,22,2,1056,1006,50,2984,1909,42,147,431,455
"2021","Birmingham 125","E02001951",7084,3144,2074,2050,24,8,1062,1038,24,3940,2731,59,176,609,365
"2021","Birmingham 126","E02001952",6943,2862,1898,1878,20,14,950,908,42,4081,2704,96,199,701,381
"2021","Birmingham 127","E02001953",5657,3304,2570,2540,30,4,730,700,30,2353,1523,56,84,335,355
"2021","Birmingham 128","E02001954",5683,2456,1632,1625,7,6,818,782,36,3227,2146,67,163,551,300
"2021","Birmingham 129","E02001955",6240,3154,2001,1979,22,7,1146,1096,50,3086,1976,58,150,523,379
"2021","Birmingham 130","E02001956",5336,2943,2055,2033,22,14,874,856,18,2393,1592,21,115,389,276
"2021","Birmingham 131","E02001957",6275,3627,2550,2538,12,6,1071,1047,24,2648,1742,54,91,407,354
"2021","Birmingham 132","E02006807",6420,3832,3263,3249,14,7,562,534,28,2588,1706,105,108,305,364
"2021","Birmingham 133","E02006809",8142,4369,4050,4048,2,11,308,296,12,3773,2495,286,139,366,487
"2021","Birmingham 134","E02006895",6764,2575,1527,1510,17,2,1046,956,90,4189,3369,186,146,354,134
"2021","Birmingham 135","E02006896",4903,1922,941,913,28,3,978,882,96,2981,2426,147,101,216,91
"2021","Birmingham 136","E02006897",6395,2257,1268,1254,14,5,984,896,88,4138,3337,148,190,336,127
"2021","Birmingham 137","E02006898",6926,2940,1252,1216,36,8,1680,1524,156,3986,3265,170,142,315,94
"2021","Birmingham 138","E02006899",5828,2327,875,843,32,0,1452,1322,130,3501,2976,138,112,224,51
"2021","Birmingham 139","E02006900",11038,5005,4701,4699,2,19,285,262,23,6033,4209,622,298,419,485
"2021","Birmingham 141","E02007038",10227,4825,3715,3689,26,11,1099,1054,45,5402,3629,217,272,722,562
"2021","Birmingham 142","E02007039",5990,2902,2680,2673,7,2,220,204,16,3088,2088,299,150,251,300
"2021","Birmingham 143","E02007040",5152,2540,2313,2313,0,7,220,210,10,2612,1715,308,161,240,188
"2021","Coventry 001","E02001958",6409,3370,2333,2317,16,7,1030,998,32,3039,1928,105,124,531,351
"2021","Coventry 002","E02001959",5433,3108,2422,2410,12,2,684,668,16,2325,1492,89,104,311,329
"2021","Coventry 004","E02001961",6085,2852,2083,2077,6,7,762,726,36,3233,2123,130,146,487,347
"2021","Coventry 005","E02001962",5361,2832,2157,2151,6,7,668,622,46,2529,1686,133,135,330,245
"2021","Coventry 006","E02001963",5046,2920,2195,2191,4,3,722,700,22,2126,1294,61,83,354,334
"2021","Coventry 007","E02001964",7792,3815,2597,2581,16,8,1210,1160,50,3977,2675,122,260,571,349
"2021","Coventry 008","E02001965",6519,3756,2962,2952,10,6,788,749,39,2763,1677,74,136,455,421
"2021","Coventry 009","E02001966",5397,2649,2199,2194,5,6,444,392,52,2748,1914,263,129,226,216
"2021","Coventry 010","E02001967",5621,3621,2888,2869,19,3,730,704,26,2000,1182,38,65,346,369
"2021","Coventry 011","E02001968",6009,3201,2476,2458,18,14,711,674,37,2808,1870,149,140,359,290
"2021","Coventry 012","E02001969",5205,2596,1905,1897,8,5,686,656,30,2609,1709,81,126,421,272
"2021","Coventry 013","E02001970",4669,2622,1975,1969,6,1,646,618,28,2047,1161,65,103,329,389
"2021","Coventry 014","E02001971",4924,2964,2246,2231,15,4,714,688,26,1960,1244,52,80,329,255
"2021","Coventry 015","E02001972",8428,4128,3210,3202,8,16,902,784,118,4300,2844,362,295,489,310
"2021","Coventry 016","E02001973",6633,3266,2325,2317,8,13,928,908,20,3367,2278,133,167,480,309
"2021","Coventry 017","E02001974",7666,4552,3496,3474,22,2,1054,1002,52,3114,1941,76,138,514,445
"2021","Coventry 018","E02001975",5992,3451,2637,2631,6,0,814,790,24,2541,1599,86,110,400,346
"2021","Coventry 019","E02001976",5866,3210,2569,2565,4,5,636,610,26,2656,1629,89,131,453,354
"2021","Coventry 020","E02001977",7961,3001,2033,2020,13,6,962,918,44,4960,3521,362,182,599,296
"2021","Coventry 021","E02001978",5305,2986,2323,2315,8,7,656,616,40,2319,1535,112,88,314,270
"2021","Coventry 022","E02001979",4594,2878,2194,2181,13,9,675,639,36,1716,977,33,69,271,366
"2021","Coventry 023","E02001980",4901,3251,2633,2623,10,3,615,593,22,1650,905,38,73,258,376
"2021","Coventry 024","E02001981",8858,3604,2658,2654,4,2,944,900,44,5254,3803,421,241,471,318
"2021","Coventry 025","E02001982",6729,4057,3016,3002,14,2,1039,988,51,2672,1713,65,143,421,330
"2021","Coventry 026","E02001983",6170,3433,2488,2468,20,1,944,902,42,2737,1782,56,108,465,326
"2021","Coventry 027","E02001984",8193,4540,3417,3391,26,9,1114,1062,52,3653,2498,168,132,473,382
"2021","Coventry 028","E02001985",7209,1655,989,989,0,3,663,585,78,5554,4798,256,102,247,151
"2021","Coventry 029","E02001986",6267,3018,2101,2085,16,3,914,878,36,3249,2171,73,143,535,327
"2021","Coventry 030","E02001987",5209,1974,1068,1050,18,0,906,854,52,3235,2447,98,87,356,247
"2021","Coventry 031","E02001988",5613,1822,1096,1084,12,2,724,660,64,3791,2860,161,119,472,179
"2021","Coventry 032","E02001989",4965,2708,1959,1939,20,3,746,718,28,2257,1575,57,98,281,246
"2021","Coventry 033","E02001990",7448,4728,3807,3793,14,11,910,880,30,2720,1647,82,111,408,472
"2021","Coventry 034","E02001991",7116,4120,3302,3275,27,4,814,764,50,2996,1976,80,94,411,435
"2021","Coventry 035","E02001992",8087,4025,2993,2980,13,10,1022,992,30,4062,2704,139,208,581,430
"2021","Coventry 036","E02001993",7006,3037,2339,2329,10,9,689,633,56,3969,3042,90,120,410,307
"2021","Coventry 037","E02001994",6443,3676,3050,3036,14,14,612,578,34,2767,1733,140,99,388,407
"2021","Coventry 038","E02001995",7508,3926,2825,2793,32,7,1094,1030,64,3582,2370,179,157,486,390
"2021","Coventry 039","E02001996",5724,2517,1715,1703,12,5,797,745,52,3207,2114,129,175,467,322
"2021","Coventry 040","E02001997",7017,4476,3983,3976,7,10,483,457,26,2541,1535,70,67,335,534
"2021","Coventry 041","E02001998",4897,3091,2642,2638,4,4,445,431,14,1806,1117,38,54,261,336
"2021","Coventry 042","E02001999",5044,2573,2274,2262,12,2,297,276,21,2471,1855,92,53,198,273
"2021","Coventry 043","E02006805",6862,3589,2688,2676,12,15,886,856,30,3273,2209,134,146,451,333
"2021","Dudley 001","E02002000",6773,3727,2640,2634,6,0,1087,1046,41,3046,1974,59,184,392,437
"2021","Dudley 002","E02002001",5019,2808,2095,2081,14,5,708,686,22,2211,1372,42,103,348,346
"2021","Dudley 003","E02002002",5890,3946,3389,3383,6,1,556,542,14,1944,1059,38,58,285,504
"2021","Dudley 004","E02002003",7361,4422,3403,3385,18,7,1012,974,38,2939,1789,59,126,430,535
"2021","Dudley 005","E02002004",6010,3375,2444,2432,12,9,922,894,28,2635,1684,40,135,330,446
"2021","Dudley 006","E02002005",7226,3857,2773,2754,19,0,1084,1038,46,3369,2370,81,172,391,355
"2021","Dudley 007","E02002006",5195,2860,2059,2051,8,3,798,762,36,2335,1448,35,123,412,317
"2021","Dudley 008","E02002007",7503,4707,3596,3580,16,4,1107,1064,43,2796,1589,34,118,390,665
"2021","Dudley 009","E02002008",6627,4290,3428,3424,4,8,854,808,46,2337,1601,47,116,296,277
"2021","Dudley 010","E02002009",5304,2714,2067,2061,6,5,642,616,26,2590,1726,174,121,315,254
"2021","Dudley 011","E02002010",6460,2836,2077,2063,14,2,757,710,47,3624,2285,172,191,593,383
"2021","Dudley 012","E02002011",4937,3234,2576,2562,14,2,656,642,14,1703,928,32,79,301,363
"2021","Dudley 013","E02002012",6580,3354,2410,2400,10,8,936,888,48,3226,1928,86,178,517,517
"2021","Dudley 014","E02002013",5524,3624,3035,3025,10,1,588,560,28,1900,1032,32,82,284,470
"2021","Dudley 015","E02002014",6260,3324,2396,2382,14,8,920,830,90,2936,1988,161,142,332,313
"2021","Dudley 016","E02002015",5679,3609,2635,2620,15,8,966,928,38,2070,1317,34,66,300,353
"2021","Dudley 017","E02002016",6131,3176,2187,2171,16,7,982,950,32,2955,1968,53,141,415,378
"2021","Dudley 018","E02002017",6372,3510,2512,2510,2,4,994,938,56,2862,1751,87,125,491,408
"2021","Dudley 019","E02002018",7439,4945,4104,4091,13,7,834,798,36,2494,1456,48,88,317,585
"2021","Dudley 020","E02002019",6057,3422,2505,2489,16,9,908,864,44,2635,1780,54,122,322,357
"2021","Dudley 021","E02002020",7886,5056,3842,3812,30,0,1214,1180,34,2830,1612,32,121,483,582
"2021","Dudley 022","E02002021",6158,2906,1818,1804,14,2,1086,1014,72,3252,2098,105,174,536,339
"2021","Dudley 023","E02002022",6888,4006,2645,2625,20,3,1358,1314,44,2882,1791,40,206,493,352
"2021","Dudley 024","E02002023",4482,2884,2142,2122,20,2,740,716,24,1598,918,13,80,281,306
"2021","Dudley 025","E02002024",7024,4310,3129,3107,22,9,1172,1134,38,2714,1752,58,107,396,401
"2021","Dudley 026","E02002025",7034,4003,2949,2891,58,6,1048,1004,44,3031,1921,82,164,458,406
"2021","Dudley 027","E02002026",5665,3636,2880,2870,10,4,752,736,16,2029,1200,40,79,321,389
"2021","Dudley 028","E02002027",4572,3176,2584,2570,14,4,588,570,18,1396,895,16,81,222,182
"2021","Dudley 029","E02002028",4802,3000,2310,2306,4,0,690,658,32,1802,961,27,72,327,415
"2021","Dudley 030","E02002029",5075,3114,2504,2494,10,6,604,578,26,1961,1209,50,62,267,373
"2021","Dudley 031","E02002030",5467,3018,2138,2126,12,0,880,842,38,2449,1485,48,112,432,372
"2021","Dudley 032","E02002031",5087,2978,2265,2253,12,3,710,672,38,2109,1320,90,110,305,284
"2021","Dudley 033","E02002032",8082,4543,3139,3098,41,8,1396,1294,102,3539,2232,100,146,628,433
"2021","Dudley 034","E02002033",6365,3847,2955,2937,18,4,888,844,44,2518,1546,52,93,401,426
"2021","Dudley 035","E02002034",6791,3849,2596,2574,22,6,1247,1220,27,2942,1688,57,146,620,431
"2021","Dudley 036","E02002035",5028,3319,2808,2796,12,5,506,474,32,1709,1027,40,64,237,341
"2021","Dudley 037","E02002036",5313,2724,1939,1929,10,9,776,750,26,2589,1571,121,148,431,318
"2021","Dudley 038","E02002037",4907,3092,2398,2388,10,3,691,662,29,1815,1093,16,61,330,315
"2021","Dudley 039","E02002038",7899,4347,3213,3187,26,12,1122,1054,68,3552,2070,59,194,661,568
"2021","Dudley 040","E02002039",4935,3056,2380,2364,16,0,676,638,38,1879,1044,43,152,300,340
"2021","Dudley 041","E02002040",5006,3400,2944,2930,14,4,452,436,16,1606,874,43,53,236,400
"2021","Dudley 042","E02002041",5167,3317,2815,2805,10,6,496,468,28,1850,1005,56,60,286,443
"2021","Dudley 043","E02002042",6617,4366,3606,3592,14,6,754,734,20,2251,1270,44,92,339,506
"2021","Sandwell 001","E02002043",6653,3830,2765,2755,10,15,1050,1010,40,2823,1907,86,124,336,370
"2021","Sandwell 002","E02002044",6186,3360,2607,2601,6,21,732,694,38,2826,1912,102,120,360,332
"2021","Sandwell 003","E02002045",6131,3490,2536,2524,12,4,950,916,34,2641,1680,62,131,337,431
"2021","Sandwell 004","E02002046",4150,2198,1564,1558,6,6,628,604,24,1952,1312,45,108,213,274
"2021","Sandwell 005","E02002047",5988,3291,2496,2484,12,3,792,762,30,2697,1697,77,142,362,419
"2021","Sandwell 006","E02002048",5713,3396,2824,2814,10,8,564,550,14,2317,1368,108,76,330,435
"2021","Sandwell 007","E02002049",4979,2854,2134,2132,2,6,714,680,34,2125,1435,49,95,261,285
"2021","Sandwell 009","E02002051",4473,2398,1648,1642,6,2,748,726,22,2075,1397,56,109,233,280
"2021","Sandwell 010","E02002052",8641,4520,3445,3435,10,17,1058,1012,46,4121,2777,165,165,514,500
"2021","Sandwell 011","E02002053",5056,2700,2182,2180,2,4,514,496,18,2356,1469,81,113,326,367
"2021","Sandwell 012","E02002054",4722,2466,2010,2004,6,10,446,426,20,2256,1415,115,89,294,343
"2021","Sandwell 013","E02002055",8630,4604,3616,3606,10,2,986,946,40,4026,2598,207,187,485,549
"2021","Sandwell 014","E02002056",7410,3878,2678,2673,5,9,1191,1149,42,3532,2401,82,162,442,445
"2021","Sandwell 015","E02002057",8327,4339,3275,3269,6,11,1053,999,54,3988,2516,194,244,541,493
"2021","Sandwell 016","E02002058",10440,5438,4287,4269,18,9,1142,1086,56,5002,3280,276,260,674,512
"2021","Sandwell 017","E02002059",9302,4704,3802,3788,14,4,898,838,60,4598,2936,250,218,611,583
"2021","Sandwell 018","E02002060",5443,2782,2254,2248,6,4,524,498,26,2661,1775,154,112,295,325
"2021","Sandwell 019","E02002061",5459,2663,2269,2267,2,5,389,370,19,2796,1826,225,113,289,343
"2021","Sandwell 020","E02002062",6924,3268,2576,2568,8,8,684,634,50,3656,2389,248,161,465,393
"2021","Sandwell 021","E02002063",7907,4216,3234,3216,18,18,964,920,44,3691,2401,200,171,526,393
"2021","Sandwell 022","E02002064",9596,5505,4107,4101,6,1,1397,1360,37,4091,2751,133,183,557,467
"2021","Sandwell 023","E02002065",10474,5402,4760,4744,16,24,618,588,30,5072,3301,557,246,431,537
"2021","Sandwell 024","E02002066",6229,2998,2506,2498,8,4,488,468,20,3231,2113,205,144,458,311
"2021","Sandwell 025","E02002067",4985,3072,2270,2252,18,6,796,744,52,1913,1194,44,80,243,352
"2021","Sandwell 027","E02002069",5675,2888,2113,2103,10,1,774,734,40,2787,1722,95,131,424,415
"2021","Sandwell 028","E02002070",7578,3480,2873,2869,4,9,598,551,47,4098,2635,329,192,487,455
"2021","Sandwell 029","E02002071",5255,2876,2046,2032,14,6,824,806,18,2379,1499,55,133,324,368
"2021","Sandwell 030","E02002072",7093,3768,2877,2867,10,5,886,848,38,3325,2010,138,179,569,429
"2021","Sandwell 031","E02002073",6320,3194,2558,2554,4,6,630,604,26,3126,2056,120,121,447,382
"2021","Sandwell 032","E02002074",6462,3506,2733,2729,4,13,760,720,40,2956,1890,106,143,368,449
"2021","Sandwell 033","E02002075",7002,3812,2784,2768,16,10,1018,970,48,3190,1960,105,150,502,473
"2021","Sandwell 034","E02002076",8477,4502,3045,2991,54,7,1450,1328,122,3975,2674,156,225,539,381
"2021","Sandwell 035","E02002077",8619,4459,3276,3257,19,3,1180,1138,42,4160,2617,202,198,617,526
"2021","Sandwell 036","E02002078",5287,3094,2579,2571,8,3,512,490,22,2193,1345,82,90,285,391
"2021","Sandwell 037","E02002079",6843,3678,2791,2783,8,5,882,852,30,3165,1978,81,143,509,454
"2021","Sandwell 038","E02002080",5728,3182,2285,2281,4,11,886,856,30,2546,1589,54,128,429,346
"2021","Sandwell 039","E02006810",8760,4900,3933,3926,7,11,956,856,100,3860,2463,161,217,457,562
"2021","Sandwell 040","E02006943",5443,2438,2006,2002,4,10,422,390,32,3005,2045,227,164,317,252
"2021","Sandwell 041","E02006944",5696,2766,2338,2332,6,12,416,388,28,2930,1924,321,216,292,177
"2021","Solihull 001","E02002081",4577,2758,2189,2179,10,7,562,542,20,1819,1085,43,72,259,360
"2021","Solihull 002","E02002082",4399,1987,1377,1368,9,0,610,588,22,2412,1675,29,112,347,249
"2021","Solihull 003","E02002083",5041,3264,2622,2614,8,16,626,612,14,1777,1096,51,56,187,387
"2021","Solihull 004","E02002084",5085,2475,1705,1694,11,4,766,732,34,2610,1791,40,125,369,285
"2021","Solihull 005","E02002085",5075,2619,1806,1788,18,7,806,772,34,2456,1665,36,105,315,335
"2021","Solihull 006","E02002086",4537,2000,1319,1315,4,9,672,646,26,2537,1697,48,109,427,256
"2021","Solihull 007","E02002087",4742,2106,1426,1420,6,0,680,654,26,2636,1808,38,121,364,305
"2021","Solihull 008","E02002088",7263,3279,2162,2146,16,6,1111,1060,51,3984,2669,60,209,607,439
"2021","Solihull 009","E02002089",6501,3872,2844,2828,16,6,1022,964,58,2629,1692,68,97,364,408
"2021","Solihull 010","E02002090",4800,2960,2349,2343,6,5,606,578,28,1840,1174,75,75,242,274
"2021","Solihull 011","E02002091",6245,3749,2896,2881,15,9,844,816,28,2496,1488,76,83,360,489
"2021","Solihull 012","E02002092",5872,3314,2557,2547,10,11,746,728,18,2558,1555,70,92,424,417
"2021","Solihull 013","E02002093",5477,3094,2463,2451,12,3,628,588,40,2383,1474,80,95,373,361
"2021","Solihull 014","E02002094",4920,3172,2802,2798,4,4,366,354,12,1748,1040,56,49,222,381
"2021","Solihull 015","E02002095",7041,4230,3442,3432,10,6,782,760,22,2811,1745,75,108,462,421
"2021","Solihull 016","E02002096",8331,5229,4456,4434,22,10,763,724,39,3102,1711,118,109,504,660
"2021","Solihull 017","E02002097",6076,3938,3276,3256,20,0,662,636,26,2138,1251,46,79,366,396
"2021","Solihull 018","E02002098",7752,4703,4046,4029,17,7,650,634,16,3049,1844,90,121,440,554
"2021","Solihull 019","E02002099",5648,3815,3476,3468,8,7,332,310,22,1833,1052,89,66,232,394
"2021","Solihull 021","E02002101",5171,2948,2303,2289,14,5,640,620,20,2223,1293,38,93,414,385
"2021","Solihull 022","E02002102",6914,4186,3493,3483,10,15,678,648,30,2728,1615,81,126,451,455
"2021","Solihull 023","E02002103",5050,3278,2764,2759,5,6,508,488,20,1772,991,40,68,282,391
"2021","Solihull 024","E02002104",4836,3228,2868,2860,8,2,358,342,16,1608,952,28,57,291,280
"2021","Solihull 025","E02002105",6740,4552,3905,3890,15,8,639,614,25,2188,1284,47,79,314,464
"2021","Solihull 026","E02002106",7857,5249,4681,4665,16,7,561,554,7,2608,1433,66,103,411,595
"2021","Solihull 027","E02002107",4475,2985,2601,2589,12,9,375,365,10,1490,870,42,64,260,254
"2021","Solihull 028","E02002108",7832,5324,4739,4729,10,5,580,550,30,2508,1429,53,74,399,553
"2021","Solihull 029","E02002109",9625,6291,4801,4787,14,10,1480,1410,70,3334,2200,79,147,545,363
"2021","Solihull 030","E02006808",5344,3302,2634,2624,10,4,664,650,14,2042,1278,52,82,277,353
"2021","Walsall 001","E02002110",5586,3462,2512,2506,6,6,944,902,42,2124,1323,35,99,353,314
"2021","Walsall 002","E02002111",5085,2816,1949,1928,21,10,857,830,27,2269,1356,39,85,386,403
"2021","Walsall 003","E02002112",4362,2764,2154,2148,6,2,608,594,14,1598,929,25,61,261,322
"2021","Walsall 004","E02002113",5117,2960,2178,2160,18,4,778,762,16,2157,1349,42,99,357,310
"2021","Walsall 005","E02002114",5064,3100,2370,2352,18,4,726,696,30,1964,1047,27,83,355,452
"2021","Walsall 006","E02002115",5440,3044,2218,2208,10,4,822,794,28,2396,1477,38,81,330,470
"2021","Walsall 007","E02002116",5682,3666,2891,2881,10,8,767,748,19,2016,1155,39,74,298,450
"2021","Walsall 008","E02002117",5187,3058,2242,2228,14,2,814,774,40,2129,1323,27,89,359,331
"2021","Walsall 009","E02002118",5740,3088,2032,2025,7,3,1053,1009,44,2652,1656,46,127,380,443
"2021","Walsall 010","E02002119",4904,2943,2270,2262,8,2,671,638,33,1961,1213,45,84,255,364
"2021","Walsall 011","E02002120",4948,3194,2528,2512,16,4,662,654,8,1754,1176,28,62,243,245
"2021","Walsall 012","E02002121",4896,2616,1772,1766,6,8,836,798,38,2280,1541,50,103,279,307
"2021","Walsall 013","E02002122",5035,2762,1826,1820,6,4,932,890,42,2273,1656,54,112,214,237
"2021","Walsall 014","E02002123",5171,3000,2104,2098,6,6,890,864,26,2171,1365,54,88,304,360
"2021","Walsall 015","E02002124",5672,3169,2334,2328,6,3,832,798,34,2503,1396,38,109,429,531
"2021","Walsall 016","E02002125",5080,2848,2015,2009,6,3,830,806,24,2232,1406,42,106,374,304
"2021","Walsall 017","E02002126",4966,2471,1544,1528,16,7,920,884,36,2495,1606,50,130,407,302
"2021","Walsall 018","E02002127",7028,3694,2733,2720,13,7,954,900,54,3334,2211,202,197,415,309
"2021","Walsall 019","E02002128",4580,2725,2053,2049,4,1,671,645,26,1855,1071,51,71,276,386
"2021","Walsall 020","E02002129",5006,3032,2293,2287,6,9,730,712,18,1974,1204,43,75,245,407
"2021","Walsall 021","E02002130",5136,2751,2003,1989,14,5,743,703,40,2385,1565,82,115,335,288
"2021","Walsall 022","E02002131",6523,4225,3571,3557,14,0,654,640,14,2298,1340,87,78,303,490
"2021","Walsall 023","E02002132",4896,2661,1948,1940,8,2,711,671,40,2235,1419,70,90,322,334
"2021","Walsall 024","E02002133",5669,2927,2316,2298,18,6,605,568,37,2742,1672,139,120,482,329
"2021","Walsall 025","E02002134",7019,3750,2594,2572,22,2,1154,1098,56,3269,2136,95,160,498,380
"2021","Walsall 026","E02002135",5957,2928,2222,2214,8,6,700,658,42,3029,2016,199,149,390,275
"2021","Walsall 027","E02002136",6266,3444,2487,2479,8,9,948,912,36,2822,1731,215,152,427,297
"2021","Walsall 028","E02002137",5072,3333,2890,2884,6,6,437,420,17,1739,942,44,58,217,478
"2021","Walsall 029","E02002138",5058,2786,2396,2392,4,10,380,352,28,2272,1449,135,92,285,311
"2021","Walsall 030","E02002139",8015,3610,2730,2716,14,20,860,802,58,4405,2869,281,285,549,421
"2021","Walsall 031","E02002140",6256,3278,2766,2758,8,8,504,474,30,2978,1903,173,181,344,377
"2021","Walsall 032","E02002141",5293,3494,2906,2898,8,10,578,556,22,1799,1035,64,65,255,380
"2021","Walsall 033","E02002142",5478,2795,2091,2080,11,2,702,674,28,2683,1818,118,142,340,265
"2021","Walsall 034","E02002143",7345,3814,3386,3380,6,12,416,382,34,3531,2332,282,193,351,373
"2021","Walsall 035","E02002144",5661,3555,3293,3288,5,8,254,242,12,2106,1230,131,63,208,474
"2021","Walsall 036","E02002145",6167,3188,2326,2312,14,10,852,818,34,2979,1954,92,174,453,306
"2021","Walsall 037","E02002146",4933,2634,2182,2174,8,4,448,422,26,2299,1496,130,69,312,292
"2021","Walsall 038","E02002147",6779,3702,2521,2501,20,11,1170,1114,56,3077,2098,107,131,378,363
"2021","Walsall 039","E02002148",9316,5721,4462,4448,14,2,1257,1232,25,3595,2140,77,138,492,748
"2021","Wolverhampton 001","E02002149",8145,4568,3382,3358,24,8,1178,1138,40,3577,2140,101,172,508,656
"2021","Wolverhampton 002","E02002150",4520,2524,1922,1914,8,8,594,574,20,1996,1312,53,72,286,273
"2021","Wolverhampton 003","E02002151",4414,2214,1554,1540,14,6,654,626,28,2200,1403,41,107,415,234
"2021","Wolverhampton 004","E02002152",4565,2230,1608,1608,0,0,622,604,18,2335,1584,48,108,322,273
"2021","Wolverhampton 005","E02002153",6107,3407,2374,2365,9,1,1032,990,42,2700,1628,39,96,417,520
"2021","Wolverhampton 006","E02002154",5702,3216,2261,2233,28,7,948,902,46,2486,1640,119,115,345,267
"2021","Wolverhampton 007","E02002155",4487,2042,1364,1356,8,4,674,660,14,2445,1666,105,164,257,253
"2021","Wolverhampton 008","E02002156",6657,3814,2944,2932,12,6,864,836,28,2843,1752,76,113,437,465
"2021","Wolverhampton 009","E02002157",6348,3814,3029,3011,18,1,784,764,20,2534,1574,87,101,380,392
"2021","Wolverhampton 010","E02002158",6079,3368,2510,2500,10,4,854,818,36,2711,1586,69,110,437,509
"2021","Wolverhampton 011","E02002159",4530,2245,1606,1602,4,3,636,608,28,2285,1562,95,117,267,244
"2021","Wolverhampton 012","E02002160",6020,3607,2871,2857,14,9,727,694,33,2413,1555,85,80,317,376
"2021","Wolverhampton 013","E02002161",5262,2632,1978,1962,16,2,652,628,24,2630,1750,176,121,386,197
"2021","Wolverhampton 014","E02002162",6396,3845,3212,3194,18,2,631,602,29,2551,1349,98,111,403,590
"2021","Wolverhampton 015","E02002163",8893,3953,2889,2879,10,11,1053,988,65,4940,3315,244,224,703,454
"2021","Wolverhampton 016","E02002164",4668,1931,1408,1402,6,3,520,484,36,2737,1907,200,136,278,216
"2021","Wolverhampton 017","E02002165",6401,2812,1970,1952,18,10,832,796,36,3589,2458,186,166,522,257
"2021","Wolverhampton 018","E02002166",7213,3450,2468,2454,14,6,976,908,68,3763,2468,122,164,546,463
"2021","Wolverhampton 019","E02002167",5526,3272,2536,2526,10,6,730,698,32,2254,1316,70,114,403,351
"2021","Wolverhampton 020","E02002168",8369,3516,2468,2454,14,10,1038,976,62,4853,3294,325,241,639,354
"2021","Wolverhampton 021","E02002169",7189,4476,3806,3780,26,8,662,636,26,2713,1601,116,91,401,504
"2021","Wolverhampton 022","E02002170",4986,2801,2147,2140,7,2,652,638,14,2185,1462,76,83,247,317
"2021","Wolverhampton 023","E02002171",6024,3160,2325,2321,4,7,828,800,28,2864,1791,114,128,402,429
"2021","Wolverhampton 026","E02002174",6244,3506,2849,2833,16,3,654,622,32,2738,1673,81,121,437,426
"2021","Wolverhampton 027","E02002175",6012,3080,2300,2292,8,10,770,730,40,2932,1937,106,132,392,365
"2021","Wolverhampton 028","E02002176",6247,3438,2612,2600,12,3,823,784,39,2809,1796,57,126,458,372
"2021","Wolverhampton 029","E02002177",8707,4462,3189,3167,22,9,1264,1200,64,4245,2716,263,209,589,468
"2021","Wolverhampton 030","E02002178",6533,3862,3464,3456,8,10,388,366,22,2671,1658,205,90,299,419
"2021","Wolverhampton 031","E02002179",5269,3292,2719,2705,14,11,562,534,28,1977,1207,62,71,294,343
"2021","Wolverhampton 032","E02002180",5217,2940,2376,2362,14,4,560,538,22,2277,1401,77,101,291,407
"2021","Wolverhampton 033","E02002181",6446,3547,2480,2466,14,2,1065,1012,53,2899,1963,64,137,367,368
"2021","Wolverhampton 034","E02002182",5213,2831,2177,2175,2,8,646,632,14,2382,1562,86,94,326,314
"2021","Wolverhampton 035","E02006894",10691,5467,4395,4383,12,5,1067,1000,67,5224,3371,418,240,601,594
"2021","Peterborough 001","E02003237",5184,3492,2854,2846,8,8,630,608,22,1692,976,29,64,307,316
"2021","Peterborough 002","E02003238",4666,2792,2052,2046,6,4,736,718,18,1874,1141,28,80,431,194
"2021","Peterborough 003","E02003239",6871,4596,3520,3514,6,4,1072,1040,32,2275,1301,59,111,381,423
"2021","Peterborough 004","E02003240",5193,3584,2858,2842,16,6,720,700,20,1609,911,40,115,309,234
"2021","Peterborough 005","E02003241",5819,3687,2807,2793,14,5,875,844,31,2132,1206,49,126,393,358
"2021","Peterborough 006","E02003242",6935,4220,3202,3188,14,4,1014,982,32,2715,1479,63,133,512,528
"2021","Peterborough 007","E02003243",8926,4635,2945,2931,14,17,1673,1611,62,4291,2735,122,236,835,363
"2021","Peterborough 008","E02003244",7396,3927,2850,2837,13,15,1062,1034,28,3469,2086,146,170,617,450
"2021","Peterborough 009","E02003245",6077,2903,1974,1968,6,7,922,894,28,3174,2085,104,163,563,259
"2021","Peterborough 010","E02003246",7016,3394,2535,2513,22,13,846,814,32,3622,2330,308,178,487,319
"2021","Peterborough 011","E02003247",6685,3556,2559,2543,16,17,980,936,44,3129,1922,100,179,569,359
"2021","Peterborough 012","E02003248",8573,4406,3522,3514,8,12,872,844,28,4167,2715,380,165,527,380
"2021","Peterborough 013","E02003249",9621,5000,3510,3492,18,32,1458,1404,54,4621,2929,242,217,746,487
"2021","Peterborough 014","E02003250",9378,4426,3050,3046,4,14,1362,1270,92,4952,3172,436,217,749,378
"2021","Peterborough 015","E02003251",6338,4049,3541,3531,10,7,501,483,18,2289,1300,152,90,335,412
"2021","Peterborough 016","E02003252",9410,5206,3730,3710,20,10,1466,1410,56,4204,2678,246,230,710,340
"2021","Peterborough 017","E02003253",8144,4446,2785,2771,14,11,1650,1546,104,3698,2393,107,192,661,345
"2021","Peterborough 018","E02003254",7672,5150,4161,4136,25,1,988,930,58,2522,1412,45,109,465,491
"2021","Peterborough 019","E02003255",10636,6634,4688,4662,26,8,1938,1860,78,4002,2416,118,203,692,573
"2021","Peterborough 021","E02003257",7223,3456,2364,2354,10,14,1078,1040,38,3767,2356,120,193,748,350
"2021","Peterborough 022","E02006877",8339,5238,3662,3630,32,6,1570,1526,44,3101,2001,100,164,506,330
"2021","Peterborough 023","E02006878",9270,5720,4018,3990,28,10,1692,1626,66,3550,2464,147,197,557,185
"2021","Luton 001","E02003258",7074,4380,3579,3569,10,7,794,772,22,2694,1652,107,96,403,436
"2021","Luton 002","E02003259",5244,2908,2328,2328,0,8,572,562,10,2336,1492,74,109,375,286
"2021","Luton 003","E02003260",6535,2997,2304,2300,4,10,683,654,29,3538,2355,152,199,521,311
"2021","Luton 004","E02003261",5114,2894,2389,2375,14,7,498,482,16,2220,1359,88,71,303,399
"2021","Luton 005","E02003262",8435,4211,3365,3355,10,17,829,802,27,4224,2719,187,208,638,472
"2021","Luton 006","E02003263",9746,5336,4549,4543,6,19,768,728,40,4410,2867,282,199,543,519
"2021","Luton 007","E02003264",7568,4576,4013,3999,14,13,550,532,18,2992,2001,188,92,332,379
"2021","Luton 008","E02003265",6803,4098,3189,3181,8,5,904,878,26,2705,1574,73,111,478,469
"2021","Luton 009","E02003266",7525,3742,2974,2968,6,8,760,720,40,3783,2462,145,166,618,392
"2021","Luton 010","E02003267",10553,5740,5311,5305,6,15,414,388,26,4813,3314,603,190,325,381
"2021","Luton 011","E02003268",9222,4792,4189,4175,14,9,594,580,14,4430,2948,387,186,459,450
"2021","Luton 012","E02003269",8501,4730,3609,3593,16,7,1114,1068,46,3771,2405,178,207,524,457
"2021","Luton 013","E02003270",6869,3781,3255,3249,6,6,520,500,20,3088,1938,196,108,360,486
"2021","Luton 014","E02003271",8198,5041,3759,3739,20,4,1278,1226,52,3157,2095,107,149,455,351
"2021","Luton 015","E02003272",8176,4148,3835,3833,2,7,306,290,16,4028,2672,550,159,289,358
"2021","Luton 016","E02003273",9278,4890,3724,3714,10,16,1150,1084,66,4388,3001,218,183,545,441
"2021","Luton 017","E02003274",8118,4118,3667,3661,6,3,448,436,12,4000,2604,460,205,423,308
"2021","Luton 019","E02003276",6725,3271,2738,2731,7,11,522,486,36,3454,2340,374,143,398,199
"2021","Luton 020","E02003277",8680,4182,3242,3236,6,8,932,888,44,4498,3037,306,211,538,406
"2021","Luton 021","E02003278",9908,4682,3214,3200,14,16,1452,1392,60,5226,3572,400,279,645,330
"2021","Luton 022","E02006937",7380,3315,2036,2018,18,10,1269,1210,59,4065,2837,216,236,593,183
"2021","Luton 023","E02006938",4750,1819,1146,1135,11,5,668,624,44,2931,1981,252,159,384,155
"2021","Southend-on-Sea 001","E02003279",7873,5010,3890,3872,18,2,1118,1068,50,2863,1575,36,109,516,627
"2021","Southend-on-Sea 002","E02003280",8560,5128,3784,3760,24,8,1336,1284,52,3432,1965,65,147,668,587
"2021","Southend-on-Sea 003","E02003281",7871,4791,3782,3768,14,0,1009,968,41,3080,1626,55,127,604,668
"2021","Southend-on-Sea 004","E02003282",8529,5118,4008,3984,24,6,1104,1056,48,3411,2112,87,156,571,485
"2021","Southend-on-Sea 005","E02003283",8697,5086,3766,3744,22,18,1302,1262,40,3611,2201,71,185,639,515
"2021","Southend-on-Sea 006","E02003284",8848,4974,3480,3432,48,4,1490,1432,58,3874,2467,81,192,693,441
"2021","Southend-on-Sea 007","E02003285",8715,4623,3062,3028,34,11,1550,1450,100,4092,2776,117,193,736,270
"2021","Southend-on-Sea 008","E02003286",7516,5131,4153,4128,25,6,972,934,38,2385,1429,52,98,401,405
"2021","Southend-on-Sea 009","E02003287",8054,4708,3749,3733,16,9,950,916,34,3346,2012,79,155,545,555
"2021","Southend-on-Sea 010","E02003288",10136,4648,2878,2852,26,10,1760,1674,86,5488,3599,154,326,987,422
"2021","Southend-on-Sea 011","E02003289",8103,4688,3119,3067,52,15,1554,1490,64,3415,2096,60,158,713,388
"2021","Southend-on-Sea 012","E02003290",7767,4373,3133,3117,16,8,1232,1190,42,3394,2090,82,194,616,412
"2021","Southend-on-Sea 013","E02003291",9440,5165,3658,3631,27,15,1492,1430,62,4275,2558,51,220,903,543
"2021","Southend-on-Sea 014","E02003292",9355,4236,2479,2459,20,5,1752,1632,120,5119,3318,110,306,1004,381
"2021","Southend-on-Sea 015","E02003293",9285,4121,2415,2365,50,4,1702,1542,160,5164,3241,155,295,1012,461
"2021","Southend-on-Sea 016","E02003294",7656,4862,3945,3913,32,19,898,858,40,2794,1501,67,108,472,646
"2021","Southend-on-Sea 017","E02003295",7976,4735,3645,3626,19,2,1088,1046,42,3241,2072,56,154,502,457
"2021","Thurrock 001","E02003296",5914,3952,3156,3156,0,6,790,772,18,1962,1237,40,74,260,351
"2021","Thurrock 002","E02003297",5871,3398,2630,2623,7,11,757,733,24,2473,1517,35,104,405,412
"2021","Thurrock 003","E02003298",5779,3488,2671,2669,2,5,812,784,28,2291,1380,57,87,347,420
"2021","Thurrock 004","E02003299",5318,3455,2652,2645,7,15,788,758,30,1863,1181,58,79,256,289
"2021","Thurrock 005","E02003300",7098,4342,3092,3074,18,8,1242,1188,54,2756,1779,65,127,416,369
"2021","Thurrock 006","E02003301",9175,5326,3899,3887,12,19,1408,1350,58,3849,2538,168,201,549,393
"2021","Thurrock 007","E02003302",7873,4074,2905,2891,14,13,1156,1126,30,3799,2577,149,183,557,333
"2021","Thurrock 008","E02003303",7319,4194,3045,3041,4,9,1140,1100,40,3125,2041,110,139,490,345
"2021","Thurrock 009","E02003304",7654,4410,3544,3536,8,10,856,826,30,3244,1942,123,149,500,530
"2021","Thurrock 010","E02003305",5568,3569,2853,2845,8,5,711,697,14,1999,1263,55,86,263,332
"2021","Thurrock 012","E02003307",8032,4391,3237,3229,8,10,1144,1114,30,3641,2323,115,146,494,563
"2021","Thurrock 013","E02003308",5829,3594,2631,2612,19,10,953,936,17,2235,1519,73,99,306,238
"2021","Thurrock 014","E02003309",6328,3805,2966,2957,9,9,830,796,34,2523,1590,101,99,377,356
"2021","Thurrock 016","E02003311",7221,4034,2989,2969,20,11,1034,1004,30,3187,2078,228,151,471,259
"2021","Thurrock 017","E02003312",6932,3778,2457,2451,6,11,1310,1274,36,3154,2103,171,185,518,177
"2021","Thurrock 018","E02003313",10651,5423,3753,3744,9,20,1650,1590,60,5228,3508,218,292,745,465
"2021","Thurrock 019","E02006859",5735,3593,2741,2731,10,14,838,810,28,2142,1529,132,109,270,102
"2021","Thurrock 020","E02006926",6169,3830,2932,2920,12,26,872,844,28,2339,1637,109,117,314,162
"2021","Thurrock 021","E02007004",4938,2536,1724,1718,6,10,802,768,34,2402,1579,148,148,396,131
"2021","Thurrock 022","E02007005",6298,3631,2454,2448,6,10,1167,1120,47,2667,1804,145,155,391,172
"2021","Bedford 001","E02003616",4678,3224,2731,2717,14,7,486,466,20,1454,858,22,67,245,262
"2021","Bedford 002","E02003617",7465,4942,4023,3985,38,5,914,874,40,2523,1442,57,124,412,488
"2021","Bedford 003","E02003618",7005,4424,3542,3516,26,8,874,856,18,2581,1493,43,106,486,453
"2021","Bedford 004","E02003619",9457,6448,5065,5023,42,9,1374,1330,44,3009,1822,72,150,518,447
"2021","Bedford 005","E02003620",6679,4100,3390,3380,10,8,702,680,22,2579,1452,56,114,444,513
"2021","Bedford 006","E02003621",6704,4304,3662,3648,14,8,634,616,18,2400,1373,65,84,357,521
"2021","Bedford 007","E02003622",7262,3764,2783,2775,8,19,962,930,32,3498,2164,93,139,651,451
"2021","Bedford 008","E02003623",10069,6780,5366,5346,20,10,1404,1350,54,3289,2050,93,146,538,462
"2021","Bedford 009","E02003624",4259,2296,1688,1672,16,0,608,582,26,1963,1234,67,95,327,240
"2021","Bedford 010","E02003625",6963,3218,2108,2078,30,8,1102,1014,88,3745,2377,141,202,678,347
"2021","Bedford 011","E02003626",4589,2764,2058,2048,10,10,696,662,34,1825,1168,55,86,296,220
"2021","Bedford 012","E02003627",8709,4428,2887,2873,14,11,1530,1436,94,4281,2750,208,227,724,372
"2021","Bedford 013","E02003628",7118,3774,3121,3103,18,7,646,626,20,3344,2159,283,160,388,354
"2021","Bedford 014","E02003629",8275,4220,3015,3003,12,9,1196,1128,68,4055,2564,158,217,694,422
"2021","Bedford 015","E02003630",8890,4368,3177,3167,10,21,1170,1111,59,4522,3004,278,227,577,436
"2021","Bedford 016","E02003631",4489,2403,1878,1872,6,0,525,506,19,2086,1286,69,104,378,249
"2021","Bedford 017","E02003632",4986,2805,2105,2101,4,6,694,672,22,2181,1316,95,103,392,275
"2021","Bedford 018","E02003633",8238,4886,3701,3677,24,9,1176,1134,42,3352,2188,96,178,505,385
"2021","Bedford 020","E02003635",7763,5262,3746,3720,26,6,1510,1454,56,2501,1608,49,113,396,335
"2021","Bedford 021","E02007010",6713,4394,3136,3122,14,4,1254,1196,58,2319,1413,68,117,407,314
"2021","Bedford 022","E02007011",5541,3672,2664,2622,42,14,994,954,40,1869,1193,59,88,300,229
"2021","Central Bedfordshire 001","E02003599",4549,2882,2144,2126,18,8,730,702,28,1667,1019,29,95,294,230
"2021","Central Bedfordshire 002","E02003600",5187,3332,2439,2421,18,7,886,868,18,1855,1104,48,109,314,280
"2021","Central Bedfordshire 003","E02003601",6665,4552,3458,3450,8,12,1082,1046,36,2113,1232,25,107,408,341
"2021","Central Bedfordshire 004","E02003602",5461,3696,2965,2943,22,5,726,704,22,1765,999,49,76,297,344
"2021","Central Bedfordshire 005","E02003603",9096,5670,3910,3878,32,10,1750,1686,64,3426,2062,56,186,637,485
"2021","Central Bedfordshire 006","E02003604",8788,5984,4305,4259,46,5,1674,1622,52,2804,1761,56,144,463,380
"2021","Central Bedfordshire 007","E02003605",7586,5030,3785,3763,22,7,1238,1204,34,2556,1573,79,120,414,370
"2021","Central Bedfordshire 008","E02003606",7667,5222,4054,4030,24,4,1164,1114,50,2445,1481,58,125,364,417
"2021","Central Bedfordshire 009","E02003607",8819,5933,4535,4493,42,9,1389,1348,41,2886,1727,56,143,531,429
"2021","Central Bedfordshire 010","E02003608",9804,6372,4758,4717,41,7,1607,1552,55,3432,2035,60,178,677,482
"2021","Central Bedfordshire 011","E02003609",9003,5968,4462,4438,24,20,1486,1432,54,3035,1836,46,162,573,418
"2021","Central Bedfordshire 012","E02003610",7194,4668,3691,3665,26,5,972,946,26,2526,1453,61,144,473,395
"2021","Central Bedfordshire 013","E02003611",7790,5396,4174,4144,30,8,1214,1156,58,2394,1410,48,120,455,361
"2021","Central Bedfordshire 014","E02003612",9560,6546,5064,5030,34,14,1468,1432,36,3014,1764,87,194,530,439
"2021","Central Bedfordshire 015","E02003613",4682,2852,2176,2166,10,4,672,654,18,1830,1142,27,83,304,274
"2021","Central Bedfordshire 016","E02003614",6650,4484,3360,3346,14,10,1114,1078,36,2166,1319,38,105,420,284
"2021","Central Bedfordshire 017","E02003615",8397,5809,4746,4722,24,11,1052,1026,26,2588,1572,48,119,421,428
"2021","Central Bedfordshire 018","E02003636",6024,3812,2995,2989,6,7,810,798,12,2212,1359,46,93,362,352
"2021","Central Bedfordshire 019","E02003637",8812,6010,4657,4633,24,11,1342,1288,54,2802,1662,59,146,472,463
"2021","Central Bedfordshire 020","E02003638",6169,4210,3408,3394,14,2,800,758,42,1959,1187,31,92,352,297
"2021","Central Bedfordshire 021","E02003639",7636,4294,2930,2906,24,0,1364,1310,54,3342,1984,66,178,638,476
"2021","Central Bedfordshire 022","E02003640",4978,3207,2436,2420,16,9,762,728,34,1771,1069,41,101,325,235
"2021","Central Bedfordshire 023","E02003641",4364,2995,2405,2388,17,4,586,574,12,1369,864,21,55,238,191
"2021","Central Bedfordshire 025","E02003642",7273,4010,2902,2882,20,18,1090,1056,34,3263,2145,102,164,527,325
"2021","Central Bedfordshire 024","E02003643",10400,7023,4828,4796,32,14,2181,2106,75,3377,2113,60,195,620,389
"2021","Central Bedfordshire 026","E02003644",7860,4741,3412,3390,22,14,1315,1272,43,3119,2016,100,134,491,378
"2021","Central Bedfordshire 027","E02003645",5639,3534,2810,2805,5,7,717,696,21,2105,1321,59,76,309,340
"2021","Central Bedfordshire 028","E02003646",8288,5040,3754,3734,20,14,1272,1228,44,3248,2083,92,179,519,375
"2021","Central Bedfordshire 029","E02003647",8442,4876,3352,3338,14,6,1518,1474,44,3566,2184,107,178,674,423
"2021","Central Bedfordshire 030","E02003648",4317,2324,1694,1682,12,0,630,622,8,1993,1266,66,80,334,247
"2021","Central Bedfordshire 031","E02003649",5538,3538,2838,2822,16,8,692,664,28,2000,1196,51,86,331,336
"2021","Central Bedfordshire 032","E02003650",5909,3926,3195,3187,8,5,726,716,10,1983,1087,46,97,362,391
"2021","Central Bedfordshire 033","E02003651",5772,3720,2865,2841,24,5,850,824,26,2052,1157,40,85,360,410
"2021","Cambridge 001","E02003719",8309,3866,2468,2444,24,10,1388,1312,76,4443,3191,215,144,604,289
"2021","Cambridge 002","E02003720",7788,3981,2870,2840,30,5,1106,1042,64,3807,2760,155,103,463,326
"2021","Cambridge 003","E02003721",7891,3979,2581,2559,22,1,1397,1344,53,3912,2792,110,131,544,335
"2021","Cambridge 004","E02003722",7006,3857,2873,2835,38,4,980,922,58,3149,2290,98,83,416,262
"2021","Cambridge 005","E02003723",5457,3027,2258,2170,88,1,768,724,44,2430,1833,124,39,254,180
"2021","Cambridge 006","E02003724",8408,4151,2777,2749,28,3,1371,1304,67,4257,3153,150,140,543,271
"2021","Cambridge 007","E02003725",7106,3419,2510,2476,34,0,909,846,63,3687,2834,135,91,341,286
"2021","Cambridge 008","E02003726",6487,3097,1954,1914,40,3,1140,1068,72,3390,2714,122,64,324,166
"2021","Cambridge 009","E02003727",8545,3868,2347,2309,38,3,1518,1412,106,4677,3766,225,104,361,221
"2021","Cambridge 010","E02003728",9023,4086,2939,2914,25,4,1143,1069,74,4937,3811,256,106,510,254
"2021","Cambridge 011","E02003729",7476,4417,3547,3528,19,4,866,812,54,3059,2080,135,99,425,320
"2021","Cambridge 013","E02003731",9685,4662,3685,3653,32,3,974,940,34,5023,3868,251,124,413,367
"2021","Cambridge 015","E02007086",8233,5102,3724,3702,22,6,1372,1284,88,3131,2225,120,142,431,213
"2021","Cambridge 014","E02007087",4283,2194,1520,1492,28,2,672,624,48,2089,1579,81,65,224,140
"2021","East Cambridgeshire 001","E02003732",7847,5115,3658,3628,30,4,1453,1414,39,2732,1621,79,152,484,396
"2021","East Cambridgeshire 002","E02003733",6925,4756,3778,3748,30,12,966,942,24,2169,1216,60,108,398,387
"2021","East Cambridgeshire 003","E02003734",9589,6065,4667,4625,42,4,1394,1342,52,3524,2065,71,165,643,580
"2021","East Cambridgeshire 004","E02003735",6903,4498,3446,3410,36,6,1046,994,52,2405,1363,76,102,457,407
"2021","East Cambridgeshire 005","E02003736",8417,5746,4632,4600,32,10,1104,1056,48,2671,1475,76,141,501,478
"2021","East Cambridgeshire 006","E02003737",10460,6654,4826,4798,28,8,1820,1760,60,3806,2174,95,233,725,579
"2021","East Cambridgeshire 007","E02003738",5198,3527,2794,2786,8,1,732,708,24,1671,917,55,79,328,292
"2021","East Cambridgeshire 008","E02003739",5247,3493,2742,2726,16,1,750,732,18,1754,984,34,67,329,340
"2021","East Cambridgeshire 009","E02003740",4974,3319,2719,2703,16,0,600,586,14,1655,985,27,86,297,260
"2021","East Cambridgeshire 011","E02006825",5189,3505,2870,2850,20,7,628,602,26,1684,972,44,80,302,286
"2021","Fenland 001","E02003742",5772,3763,2910,2896,14,13,840,794,46,2009,1056,56,81,371,445
"2021","Fenland 002","E02003743",8726,4952,3136,3114,22,2,1814,1750,64,3774,2287,86,185,693,523
"2021","Fenland 003","E02003744",11186,6214,4151,4125,26,15,2048,1972,76,4972,2772,173,214,993,820
"2021","Fenland 004","E02003745",8627,5619,4139,4110,29,24,1456,1402,54,3008,1667,74,164,506,597
"2021","Fenland 005","E02003746",5952,3749,2729,2719,10,1,1019,981,38,2203,1276,42,103,370,412
"2021","Fenland 006","E02003747",10305,6537,4755,4729,26,9,1773,1720,53,3768,2068,53,225,719,703
"2021","Fenland 007","E02003748",6307,3800,2664,2651,13,10,1126,1080,46,2507,1304,47,145,536,475
"2021","Fenland 008","E02003749",5071,3458,2599,2589,10,9,850,810,40,1613,910,39,82,284,298
"2021","Fenland 009","E02003750",6196,3842,2914,2898,16,7,921,882,39,2354,1284,39,111,413,507
"2021","Fenland 010","E02003751",6158,4280,3252,3234,18,2,1026,992,34,1878,1041,29,97,321,390
"2021","Fenland 011","E02003752",9144,5750,4058,4030,28,16,1676,1604,72,3394,1941,69,163,654,567
"2021","Huntingdonshire 001","E02003753",8981,5830,4431,4407,24,13,1386,1356,30,3151,1836,77,137,627,474
"2021","Huntingdonshire 002","E02003754",4749,3216,2644,2627,17,8,564,544,20,1533,850,47,87,281,268
"2021","Huntingdonshire 003","E02003755",7060,4502,3312,3292,20,4,1186,1152,34,2558,1442,59,143,486,428
"2021","Huntingdonshire 004","E02003756",5851,3918,3022,3008,14,4,892,864,28,1933,1114,29,100,334,356
"2021","Huntingdonshire 005","E02003757",5659,3823,2986,2971,15,5,832,806,26,1836,1013,51,76,359,337
"2021","Huntingdonshire 006","E02003758",7657,5288,4209,4175,34,13,1066,1038,28,2369,1382,35,129,433,390
"2021","Huntingdonshire 007","E02003759",4946,3468,2867,2849,18,3,598,580,18,1478,822,46,65,242,303
"2021","Huntingdonshire 008","E02003760",6943,3608,2484,2470,14,6,1118,1076,42,3335,2134,133,177,558,333
"2021","Huntingdonshire 009","E02003761",4933,3222,2601,2589,12,3,618,586,32,1711,992,66,71,292,290
"2021","Huntingdonshire 010","E02003762",9015,6089,4603,4550,53,8,1478,1422,56,2926,1654,78,137,541,516
"2021","Huntingdonshire 011","E02003763",7881,5034,3744,3732,12,4,1286,1248,38,2847,1759,59,107,529,393
"2021","Huntingdonshire 012","E02003764",8363,4920,3542,3524,18,10,1368,1302,66,3443,2146,127,212,611,347
"2021","Huntingdonshire 013","E02003765",6001,3528,2642,2628,14,10,876,828,48,2473,1357,67,141,469,439
"2021","Huntingdonshire 014","E02003766",6285,3984,2896,2878,18,2,1086,1042,44,2301,1374,59,96,432,340
"2021","Huntingdonshire 015","E02003767",5344,3774,3173,3155,18,7,594,576,18,1570,933,37,60,261,279
"2021","Huntingdonshire 016","E02003768",8266,5690,4594,4574,20,0,1096,1066,30,2576,1375,48,145,477,531
"2021","Huntingdonshire 017","E02003769",5333,3639,2952,2934,18,0,687,666,21,1694,900,34,89,330,341
"2021","Huntingdonshire 018","E02003770",8371,5750,4421,4381,40,5,1324,1266,58,2621,1590,58,149,453,371
"2021","Huntingdonshire 019","E02003771",5257,3004,2219,2193,26,7,778,756,22,2253,1285,40,112,450,366
"2021","Huntingdonshire 020","E02003772",5649,3860,3096,3088,8,4,760,746,14,1789,1052,43,59,325,310
"2021","Huntingdonshire 021","E02003773",8636,5255,3659,3637,22,13,1583,1542,41,3381,1988,72,179,688,454
"2021","Huntingdonshire 022","E02003774",4635,2830,2033,2021,12,9,788,762,26,1805,1012,28,83,377,305
"2021","South Cambridgeshire 001","E02003775",5844,3978,3163,3147,16,3,812,788,24,1866,1076,43,107,347,293
"2021","South Cambridgeshire 002","E02003776",5488,3551,2786,2768,18,4,761,740,21,1937,1076,31,144,373,313
"2021","South Cambridgeshire 003","E02003777",7668,5191,3918,3893,25,9,1264,1204,60,2477,1538,66,137,466,270
"2021","South Cambridgeshire 004","E02003778",5135,3436,2544,2524,20,2,890,854,36,1699,1025,66,84,286,238
"2021","South Cambridgeshire 006","E02003780",9104,5512,4285,4236,49,7,1220,1148,72,3592,2381,87,140,532,452
"2021","South Cambridgeshire 007","E02003781",5118,3266,2492,2470,22,0,774,740,34,1852,1176,54,144,233,245
"2021","South Cambridgeshire 010","E02003784",7202,4837,4072,4050,22,12,753,715,38,2365,1486,67,81,368,363
"2021","South Cambridgeshire 011","E02003785",7170,4633,3669,3658,11,10,954,910,44,2537,1627,81,109,344,376
"2021","South Cambridgeshire 012","E02003786",5297,3565,2968,2940,28,3,594,578,16,1732,992,53,66,282,339
"2021","South Cambridgeshire 013","E02003787",6326,4310,3482,3456,26,2,826,794,32,2016,1049,39,97,433,398
"2021","South Cambridgeshire 014","E02003788",6445,4366,3640,3610,30,6,720,702,18,2079,1206,57,109,368,339
"2021","South Cambridgeshire 015","E02003789",5815,3692,3011,2999,12,7,674,666,8,2123,1169,70,102,375,407
"2021","South Cambridgeshire 016","E02003790",7679,5128,4235,4209,26,7,886,864,22,2551,1448,56,107,448,492
"2021","South Cambridgeshire 017","E02003791",6674,4586,3737,3707,30,5,844,820,24,2088,1202,58,91,372,365
"2021","South Cambridgeshire 018","E02003792",7928,5346,4388,4366,22,4,954,930,24,2582,1416,81,109,462,514
"2021","South Cambridgeshire 019","E02003793",5749,3927,3146,3134,12,11,770,752,18,1822,1112,28,78,303,301
"2021","South Cambridgeshire 020","E02006873",6959,4595,3600,3577,23,9,986,944,42,2364,1624,68,128,390,154
"2021","South Cambridgeshire 021","E02006874",7983,5453,4410,4382,28,7,1036,994,42,2530,1591,83,117,439,300
"2021","South Cambridgeshire 022","E02007085",9480,6242,5032,4988,44,24,1186,1140,46,3238,1840,86,147,592,573
"2021","Basildon 001","E02004424",5691,3996,3426,3412,14,2,568,564,4,1695,1038,38,55,261,303
"2021","Basildon 002","E02004425",5938,3786,2955,2944,11,5,826,806,20,2152,1248,32,113,399,360
"2021","Basildon 003","E02004426",6535,4228,3294,3286,8,4,930,894,36,2307,1348,46,106,403,404
"2021","Basildon 004","E02004427",6584,4308,3590,3580,10,0,718,698,20,2276,1255,40,81,356,544
"2021","Basildon 005","E02004428",5633,3450,2602,2594,8,4,844,826,18,2183,1282,47,93,351,410
"2021","Basildon 006","E02004429",6400,4086,3354,3348,6,8,724,704,20,2314,1327,58,87,330,512
"2021","Basildon 007","E02004430",6761,4478,3456,3446,10,6,1016,994,22,2283,1377,38,88,397,383
"2021","Basildon 008","E02004431",7736,4770,3381,3371,10,11,1378,1354,24,2966,1856,69,151,533,357
"2021","Basildon 009","E02004432",5331,3516,2868,2856,12,2,646,618,28,1815,1103,26,86,294,306
"2021","Basildon 010","E02004433",6974,3989,2860,2841,19,15,1114,1088,26,2985,1810,75,190,560,350
"2021","Basildon 011","E02004434",6786,3904,2720,2704,16,6,1178,1126,52,2882,1752,88,165,539,338
"2021","Basildon 012","E02004435",7458,4204,2886,2876,10,10,1308,1256,52,3254,2062,81,190,546,375
"2021","Basildon 013","E02004436",5901,2840,1954,1938,16,12,874,842,32,3061,1924,78,199,562,298
"2021","Basildon 014","E02004437",7926,4646,3232,3214,18,6,1408,1362,46,3280,1955,70,170,628,457
"2021","Basildon 015","E02004438",7240,3736,2558,2546,12,14,1164,1110,54,3504,2238,119,175,560,412
"2021","Basildon 016","E02004439",7149,3580,2422,2414,8,22,1136,1090,46,3569,2463,78,202,520,306
"2021","Basildon 017","E02004440",7090,3961,2826,2812,14,13,1122,1084,38,3129,2004,105,165,471,384
"2021","Basildon 018","E02004441",6210,3348,2500,2498,2,6,842,812,30,2862,1675,70,128,560,429
"2021","Basildon 019","E02004442",6403,3224,2159,2149,10,11,1054,1006,48,3179,2062,89,176,523,329
"2021","Basildon 020","E02004443",8293,4993,3680,3652,28,16,1297,1259,38,3300,2134,118,156,466,426
"2021","Basildon 021","E02004444",7306,4768,3673,3653,20,9,1086,1046,40,2538,1683,58,106,391,300
"2021","Basildon 022","E02004445",6531,3640,2551,2543,8,7,1082,1042,40,2891,1817,88,148,505,333
"2021","Braintree 001","E02004446",5878,4116,3293,3281,12,7,816,780,36,1762,1072,35,66,302,287
"2021","Braintree 002","E02004447",5151,3618,2906,2886,20,0,712,688,24,1533,862,28,77,288,278
"2021","Braintree 003","E02004448",6323,4192,3161,3139,22,1,1030,992,38,2131,1217,46,85,421,362
"2021","Braintree 004","E02004449",7053,4086,2850,2838,12,2,1234,1182,52,2967,1670,65,159,643,430
"2021","Braintree 005","E02004450",5346,3687,3049,3034,15,0,638,616,22,1659,940,38,69,317,295
"2021","Braintree 006","E02004451",7733,5171,4012,3993,19,3,1156,1130,26,2562,1432,29,91,508,502
"2021","Braintree 007","E02004452",7392,4939,3927,3904,23,18,994,964,30,2453,1441,46,107,455,404
"2021","Braintree 008","E02004453",5830,3374,2306,2286,20,10,1058,1032,26,2456,1503,39,107,470,337
"2021","Braintree 009","E02004454",7700,4365,2906,2871,35,5,1454,1360,94,3335,1962,77,157,713,426
"2021","Braintree 010","E02004455",6451,4398,3554,3540,14,6,838,810,28,2053,1308,41,81,301,322
"2021","Braintree 011","E02004456",7804,4618,3135,3119,16,13,1470,1404,66,3186,1944,65,141,615,421
"2021","Braintree 012","E02004457",8329,5308,3848,3824,24,8,1452,1404,48,3021,1867,83,117,525,429
"2021","Braintree 013","E02004458",7549,5002,3975,3955,20,5,1022,1002,20,2547,1478,40,107,493,429
"2021","Braintree 014","E02004459",8550,5532,4411,4383,28,7,1114,1058,56,3018,1687,60,131,557,583
"2021","Braintree 015","E02004460",7849,4970,3592,3568,24,2,1376,1340,36,2879,1767,47,117,496,452
"2021","Braintree 016","E02004461",4455,2566,1787,1781,6,3,776,752,24,1889,1197,36,84,364,208
"2021","Braintree 017","E02004462",9345,5571,3770,3754,16,9,1792,1734,58,3774,2202,73,184,766,549
"2021","Braintree 018","E02004463",6608,4343,3480,3458,22,5,858,832,26,2265,1295,54,118,381,417
"2021","Brentwood 001","E02004464",8136,5446,4588,4574,14,12,846,820,26,2690,1678,69,97,351,495
"2021","Brentwood 002","E02004465",5265,3218,2554,2542,12,2,662,646,16,2047,1143,55,109,330,410
"2021","Brentwood 003","E02004466",6544,3946,3054,3042,12,8,884,850,34,2598,1572,57,120,454,395
"2021","Brentwood 004","E02004467",6427,3716,2743,2731,12,9,964,942,22,2711,1730,65,120,465,331
"2021","Brentwood 005","E02004468",8547,5818,5054,5044,10,10,754,730,24,2729,1624,86,105,360,554
"2021","Brentwood 006","E02004469",5831,3741,2969,2959,10,6,766,746,20,2090,1258,69,80,347,336
"2021","Brentwood 007","E02004470",9632,5252,3340,3294,46,10,1902,1806,96,4380,2786,125,224,773,472
"2021","Brentwood 008","E02004471",6773,3992,2957,2955,2,9,1026,984,42,2781,1758,57,136,482,348
"2021","Brentwood 009","E02004472",5111,3248,2590,2578,12,10,648,622,26,1863,1104,39,78,314,328
"2021","Castle Point 001","E02004473",6350,4087,3160,3141,19,7,920,892,28,2263,1346,45,84,348,440
"2021","Castle Point 002","E02004474",6596,4207,3335,3330,5,6,866,842,24,2389,1411,29,76,383,490
"2021","Castle Point 003","E02004475",5488,3560,2885,2884,1,7,668,648,20,1928,1166,37,68,262,395
"2021","Castle Point 004","E02004476",6713,4561,3695,3688,7,4,862,834,28,2152,1353,26,68,271,434
"2021","Castle Point 005","E02004477",5157,3440,2840,2828,12,0,600,580,20,1717,882,25,63,301,446
"2021","Castle Point 006","E02004478",5501,3110,2308,2290,18,8,794,770,24,2391,1373,39,117,420,442
"2021","Castle Point 007","E02004479",6615,4264,3286,3272,14,14,964,942,22,2351,1433,50,92,337,439
"2021","Castle Point 008","E02004480",5536,3452,2638,2628,10,10,804,776,28,2084,1331,48,82,314,309
"2021","Castle Point 009","E02004481",5778,3460,2636,2628,8,4,820,786,34,2318,1051,46,107,460,654
"2021","Castle Point 010","E02004482",6513,3486,2522,2508,14,2,962,934,28,3027,1932,61,126,463,445
"2021","Castle Point 011","E02004483",6712,4144,3279,3269,10,9,856,826,30,2568,1449,43,108,432,536
"2021","Castle Point 012","E02004484",7021,4208,3187,3179,8,5,1016,994,22,2813,1551,57,143,498,564
"2021","Chelmsford 001","E02004485",7586,5004,3832,3810,22,12,1160,1114,46,2582,1567,56,143,446,370
"2021","Chelmsford 002","E02004486",6922,4558,3768,3760,8,8,782,758,24,2364,1423,79,81,355,426
"2021","Chelmsford 003","E02004487",5977,3651,2858,2852,6,13,780,748,32,2326,1451,51,98,394,332
"2021","Chelmsford 004","E02004488",7875,5088,4013,3997,16,7,1068,1030,38,2787,1746,55,101,498,387
"2021","Chelmsford 005","E02004489",7331,4795,3861,3842,19,6,928,890,38,2536,1615,42,120,427,332
"2021","Chelmsford 006","E02004490",6129,2968,2143,2133,10,3,822,782,40,3161,1994,79,153,612,323
"2021","Chelmsford 007","E02004491",6029,3985,3198,3192,6,4,783,754,29,2044,1288,43,62,344,307
"2021","Chelmsford 008","E02004492",7575,4702,3388,3360,28,6,1308,1262,46,2873,1862,59,131,532,289
"2021","Chelmsford 009","E02004493",8266,4761,3375,3353,22,9,1377,1317,60,3505,2369,129,115,529,363
"2021","Chelmsford 011","E02004495",6785,4378,3590,3565,25,9,779,746,33,2407,1279,52,87,472,517
"2021","Chelmsford 012","E02004496",6420,4209,3242,3214,28,11,956,922,34,2211,1398,54,94,336,329
"2021","Chelmsford 013","E02004497",6517,4212,3496,3480,16,4,712,686,26,2305,1259,42,85,405,514
"2021","Chelmsford 014","E02004498",7966,4645,3490,3474,16,16,1139,1081,58,3321,2021,60,147,647,446
"2021","Chelmsford 015","E02004499",5556,3588,2838,2832,6,4,746,724,22,1968,1182,54,77,349,306
"2021","Chelmsford 016","E02004500",7573,5131,4389,4376,13,8,734,698,36,2442,1438,51,100,405,448
"2021","Chelmsford 017","E02004501",5763,3694,2972,2966,6,2,720,700,20,2069,1233,51,79,332,374
"2021","Chelmsford 018","E02004502",5786,3770,3198,3186,12,10,562,542,20,2016,1079,67,92,380,398
"2021","Chelmsford 019","E02004503",6480,4246,3340,3336,4,4,902,880,22,2234,1306,32,130,394,372
"2021","Chelmsford 020","E02004504",6522,4193,3327,3321,6,13,853,838,15,2329,1456,35,87,464,287
"2021","Chelmsford 021","E02004505",5357,3633,2872,2860,12,5,756,728,28,1724,944,33,62,274,411
"2021","Chelmsford 022","E02006978",5568,2970,1650,1628,22,2,1318,1232,86,2598,1777,71,93,391,266
"2021","Chelmsford 023","E02006979",5425,2913,1504,1484,20,3,1406,1334,72,2512,1724,90,108,387,203
"2021","Colchester 001","E02004506",5790,3960,3252,3220,32,11,697,670,27,1830,1080,40,78,298,334
"2021","Colchester 002","E02004507",7568,4460,3244,3226,18,2,1214,1174,40,3108,1955,76,197,615,265
"2021","Colchester 003","E02004508",5400,3666,3001,2991,10,5,660,626,34,1734,1012,41,76,282,323
"2021","Colchester 007","E02004512",9283,4784,3018,2966,52,6,1760,1674,86,4499,2815,141,234,855,454
"2021","Colchester 008","E02004513",8341,3230,2036,2026,10,4,1190,1084,106,5111,3871,92,156,641,351
"2021","Colchester 009","E02004514",4702,2942,2361,2345,16,5,576,558,18,1760,1021,46,84,330,279
"2021","Colchester 010","E02004515",7696,5288,4101,4071,30,15,1172,1136,36,2408,1471,39,96,448,354
"2021","Colchester 011","E02004516",9805,5036,3049,3017,32,9,1978,1866,112,4769,3239,105,272,854,299
"2021","Colchester 012","E02004517",7609,4819,3649,3630,19,6,1164,1124,40,2790,1588,65,110,549,478
"2021","Colchester 013","E02004518",6310,3802,2815,2787,28,1,986,940,46,2508,1626,59,147,427,249
"2021","Colchester 014","E02004519",6201,4007,3311,3289,22,5,691,660,31,2194,1232,26,66,393,477
"2021","Colchester 015","E02004520",6817,4114,3199,3173,26,15,900,874,26,2703,1733,73,165,483,249
"2021","Colchester 016","E02004521",7616,4348,3009,2993,16,13,1326,1272,54,3268,2019,53,176,652,368
"2021","Colchester 017","E02004522",6354,4000,3166,3124,42,12,822,774,48,2354,1331,58,122,450,393
"2021","Colchester 018","E02004523",8007,4640,3243,3225,18,7,1390,1332,58,3367,2057,86,186,663,375
"2021","Colchester 019","E02004524",6859,4853,4021,4015,6,10,822,792,30,2006,1200,46,74,315,371
"2021","Colchester 020","E02004525",6788,4306,3404,3396,8,4,898,880,18,2482,1315,38,95,444,590
"2021","Colchester 021","E02004526",6333,4038,3392,3384,8,4,642,620,22,2295,1083,51,117,460,584
"2021","Colchester 022","E02006922",11470,6874,5249,5219,30,15,1610,1550,60,4596,2825,98,206,756,711
"2021","Colchester 023","E02007056",6453,4377,3028,2996,32,9,1340,1304,36,2076,1388,60,84,353,191
"2021","Colchester 024","E02007057",5864,3512,2420,2392,28,10,1082,1012,70,2352,1628,84,132,361,147
"2021","Epping Forest 001","E02004527",7664,4747,3562,3542,20,8,1177,1126,51,2917,1754,48,124,533,458
"2021","Epping Forest 002","E02004528",7447,4789,3887,3855,32,14,888,856,32,2658,1587,92,88,364,527
"2021","Epping Forest 003","E02004529",6132,3992,3241,3221,20,9,742,714,28,2140,1361,82,82,306,309
"2021","Epping Forest 004","E02004530",5654,3519,2730,2723,7,7,782,758,24,2135,1268,52,72,321,422
"2021","Epping Forest 005","E02004531",5701,3510,2704,2670,34,6,800,778,22,2191,1308,51,85,377,370
"2021","Epping Forest 006","E02004532",5295,3306,2414,2396,18,2,890,852,38,1989,1173,43,90,344,339
"2021","Epping Forest 007","E02004533",6092,3326,2466,2450,16,20,840,822,18,2766,1748,55,126,421,416
"2021","Epping Forest 008","E02004534",7137,4007,2916,2899,17,11,1080,1054,26,3130,2049,82,143,516,340
"2021","Epping Forest 009","E02004535",4992,2616,1896,1882,14,10,710,676,34,2376,1395,65,117,477,322
"2021","Epping Forest 010","E02004536",5098,3168,2600,2594,6,6,562,538,24,1930,1164,52,68,282,364
"2021","Epping Forest 011","E02004537",7571,3904,2758,2748,10,10,1136,1100,36,3667,2506,72,150,594,345
"2021","Epping Forest 012","E02004538",7933,4982,4012,3994,18,7,963,902,61,2951,1997,95,100,379,380
"2021","Epping Forest 013","E02004539",6380,3686,2702,2688,14,12,972,918,54,2694,1780,73,98,419,324
"2021","Epping Forest 014","E02004540",4893,3090,2439,2420,19,5,646,620,26,1803,1118,66,83,264,272
"2021","Epping Forest 015","E02004541",9431,5790,4461,4423,38,9,1320,1252,68,3641,2276,104,148,595,518
"2021","Epping Forest 016","E02004542",5620,3578,3095,3083,12,9,474,452,22,2042,1282,114,72,268,306
"2021","Epping Forest 017","E02004543",5912,3427,2875,2869,6,6,546,528,18,2485,1590,179,88,322,306
"2021","Harlow 001","E02004544",8791,5474,3744,3706,38,12,1718,1668,50,3317,2034,74,162,631,416
"2021","Harlow 002","E02004545",6152,3144,2221,2213,8,19,904,860,44,3008,1949,84,147,505,323
"2021","Harlow 003","E02004546",6642,3503,2417,2400,17,8,1078,1032,46,3139,2007,99,125,538,370
"2021","Harlow 004","E02004547",7614,4133,2973,2955,18,19,1141,1102,39,3481,2276,197,164,519,325
"2021","Harlow 005","E02004548",7023,4551,3261,3245,16,14,1276,1234,42,2472,1589,79,101,449,254
"2021","Harlow 006","E02004549",6295,3473,2499,2488,11,8,966,940,26,2822,1793,61,102,488,378
"2021","Harlow 007","E02004550",6821,3532,2574,2556,18,8,950,898,52,3289,2053,99,142,572,423
"2021","Harlow 008","E02004551",5961,3250,2317,2297,20,11,922,886,36,2711,1610,76,122,522,381
"2021","Harlow 009","E02004552",5372,3190,2486,2476,10,4,700,678,22,2182,1293,72,94,409,314
"2021","Harlow 010","E02004553",6012,3307,2314,2299,15,7,986,948,38,2705,1688,110,117,440,350
"2021","Harlow 011","E02004554",6067,3306,2437,2431,6,3,866,836,30,2761,1758,90,123,474,316
"2021","Maldon 001","E02004555",5370,3603,2978,2966,12,8,617,603,14,1767,1012,41,65,317,332
"2021","Maldon 002","E02004556",6264,4428,3766,3748,18,14,648,636,12,1836,1063,39,66,286,382
"2021","Maldon 003","E02004557",7183,4610,3380,3362,18,2,1228,1206,22,2573,1521,56,108,516,372
"2021","Maldon 004","E02004558",5753,3242,2274,2262,12,2,966,924,42,2511,1268,50,135,533,525
"2021","Maldon 005","E02004559",6724,4400,3440,3426,14,4,956,920,36,2324,1355,33,99,409,428
"2021","Maldon 006","E02004560",7417,4838,3636,3620,16,4,1198,1166,32,2579,1486,47,126,459,461
"2021","Maldon 007","E02004561",8824,5978,4944,4924,20,7,1027,986,41,2846,1689,63,109,475,510
"2021","Maldon 008","E02004562",7400,4764,3684,3662,22,12,1068,1036,32,2636,1435,49,134,512,506
"2021","Rochford 001","E02004563",5694,3692,3073,3052,21,5,614,604,10,2002,1031,46,71,380,474
"2021","Rochford 002","E02004564",6638,4407,3615,3603,12,5,787,759,28,2231,1301,46,65,339,480
"2021","Rochford 004","E02004566",4472,2441,1692,1684,8,1,748,722,26,2031,1250,36,110,378,257
"2021","Rochford 005","E02004567",6735,4518,3722,3693,29,13,783,767,16,2217,1283,38,82,341,473
"2021","Rochford 006","E02004568",7057,4514,3284,3268,16,2,1228,1198,30,2543,1579,33,103,464,364
"2021","Rochford 007","E02004569",6989,4236,3001,2973,28,13,1222,1188,34,2753,1613,50,132,508,450
"2021","Rochford 008","E02004570",7088,4456,3586,3578,8,18,852,836,16,2632,1450,31,114,485,552
"2021","Rochford 009","E02004571",6435,4342,3676,3670,6,6,660,642,18,2093,1198,38,76,315,466
"2021","Rochford 010","E02004572",6491,4110,3096,3082,14,8,1006,980,26,2381,1384,45,96,442,414
"2021","Rochford 011","E02006980",6247,4322,3592,3580,12,8,722,696,26,1925,1176,24,49,273,403
"2021","Rochford 012","E02006981",6569,4242,3421,3413,8,11,810,798,12,2327,1339,52,94,376,466
"2021","Tendring 001","E02004573",5173,2514,1754,1734,20,8,752,720,32,2659,1566,64,231,511,287
"2021","Tendring 002","E02004574",6197,3506,2491,2483,8,1,1014,976,38,2691,1551,47,140,507,446
"2021","Tendring 003","E02004575",9972,6466,4862,4828,34,8,1596,1542,54,3506,1947,81,138,671,669
"2021","Tendring 004","E02004576",7670,5080,4079,4043,36,7,994,976,18,2590,1451,34,111,409,585
"2021","Tendring 005","E02004577",4990,3408,2756,2738,18,4,648,622,26,1582,939,36,66,265,276
"2021","Tendring 006","E02004578",6411,3778,2994,2970,24,10,774,734,40,2633,1221,62,115,582,653
"2021","Tendring 007","E02004579",6722,4398,3445,3429,16,7,946,914,32,2324,1210,45,106,454,509
"2021","Tendring 008","E02004580",10644,6844,5616,5594,22,6,1222,1174,48,3800,1761,90,176,703,1070
"2021","Tendring 009","E02004581",7016,4858,3827,3807,20,11,1020,974,46,2158,1209,53,83,357,456
"2021","Tendring 010","E02004582",6063,3656,2828,2800,28,4,824,796,28,2407,1133,42,82,542,608
"2021","Tendring 011","E02004583",7430,4513,3432,3417,15,11,1070,1032,38,2917,1491,103,137,643,543
"2021","Tendring 012","E02004584",5914,3706,3079,3065,14,3,624,608,16,2208,920,59,93,416,720
"2021","Tendring 013","E02004585",7423,4440,3310,3296,14,16,1114,1072,42,2983,1706,55,112,529,581
"2021","Tendring 014","E02004586",6764,3721,2791,2775,16,5,925,889,36,3043,1610,89,142,605,597
"2021","Tendring 015","E02004587",6155,3190,2232,2220,12,4,954,910,44,2965,1720,49,145,570,481
"2021","Tendring 016","E02004588",5494,2209,1318,1310,8,7,884,826,58,3285,1878,101,176,692,438
"2021","Tendring 017","E02004589",5986,3213,2346,2328,18,8,859,828,31,2773,1565,58,134,527,489
"2021","Tendring 018","E02004590",7230,3724,2827,2807,20,13,884,842,42,3506,1590,60,278,772,806
"2021","Uttlesford 001","E02004591",6099,4203,3402,3392,10,7,794,762,32,1896,1112,47,90,333,314
"2021","Uttlesford 002","E02004592",10512,6352,4892,4862,30,10,1450,1402,48,4160,2289,101,208,843,719
"2021","Uttlesford 003","E02004593",7311,5158,4258,4240,18,12,888,874,14,2153,1254,48,93,363,395
"2021","Uttlesford 004","E02004594",6663,4592,3715,3689,26,5,872,838,34,2071,1210,68,99,343,351
"2021","Uttlesford 005","E02004595",11771,7974,6165,6137,28,21,1788,1710,78,3797,2232,96,185,714,570
"2021","Uttlesford 006","E02004596",8211,5442,4152,4119,33,9,1281,1246,35,2769,1751,68,119,461,370
"2021","Uttlesford 007","E02004597",7246,4587,3476,3466,10,3,1108,1072,36,2659,1541,50,139,547,382
"2021","Uttlesford 008","E02004598",8581,5767,4716,4690,26,9,1042,1014,28,2814,1661,79,147,463,464
"2021","Uttlesford 009","E02004599",6321,4234,3482,3470,12,6,746,728,18,2087,1256,52,95,324,360
"2021","Broxbourne 001","E02004843",5799,3732,3004,3002,2,12,716,698,18,2067,1341,47,79,293,307
"2021","Broxbourne 002","E02004844",5960,3346,2465,2447,18,21,860,830,30,2614,1711,63,127,394,319
"2021","Broxbourne 003","E02004845",6432,3576,2550,2532,18,8,1018,992,26,2856,1673,83,126,537,437
"2021","Broxbourne 004","E02004846",5212,3418,2937,2925,12,9,472,454,18,1794,1138,47,63,220,326
"2021","Broxbourne 005","E02004847",7988,4429,3231,3218,13,24,1174,1146,28,3559,2276,74,182,657,370
"2021","Broxbourne 006","E02004848",6136,3624,2891,2889,2,9,724,704,20,2512,1668,60,87,385,312
"2021","Broxbourne 007","E02004849",5649,3642,3103,3099,4,3,536,524,12,2007,1345,48,55,242,317
"2021","Broxbourne 008","E02004850",6014,3376,2615,2601,14,5,756,742,14,2638,1635,85,123,426,369
"2021","Broxbourne 009","E02004851",4753,2588,1995,1989,6,3,590,574,16,2165,1341,48,88,364,324
"2021","Broxbourne 010","E02004852",6427,3527,2666,2664,2,8,853,816,37,2900,1862,85,122,404,427
"2021","Broxbourne 011","E02004853",5520,3035,2347,2341,6,15,673,652,21,2485,1584,39,99,408,355
"2021","Broxbourne 012","E02004854",6572,3610,2744,2730,14,12,854,820,34,2962,1863,91,121,421,466
"2021","Broxbourne 013","E02004855",6756,3198,2263,2246,17,4,931,902,29,3558,2341,136,186,562,333
"2021","Dacorum 001","E02004856",4581,2986,2285,2273,12,7,694,676,18,1595,970,29,81,299,216
"2021","Dacorum 002","E02004857",4756,3088,2444,2420,24,8,636,596,40,1668,967,35,87,292,287
"2021","Dacorum 003","E02004858",4002,2444,1920,1912,8,0,524,506,18,1558,950,23,60,296,229
"2021","Dacorum 004","E02004859",4274,2868,2411,2407,4,5,452,436,16,1406,759,26,60,277,284
"2021","Dacorum 005","E02004860",4537,2638,1949,1939,10,7,682,664,18,1899,1215,65,126,332,161
"2021","Dacorum 006","E02004861",4545,3008,2580,2562,18,0,428,412,16,1537,793,34,52,296,362
"2021","Dacorum 007","E02004862",6060,3339,2539,2529,10,2,798,768,30,2721,1687,91,152,505,286
"2021","Dacorum 008","E02004863",5955,3138,2198,2180,18,14,926,896,30,2817,1699,121,167,486,344
"2021","Dacorum 009","E02004864",5238,3507,2804,2778,26,7,696,676,20,1731,952,44,78,333,324
"2021","Dacorum 010","E02004865",4471,2552,1806,1796,10,4,742,704,38,1919,1214,46,80,354,225
"2021","Dacorum 011","E02004866",5295,3086,2281,2273,8,1,804,766,38,2209,1321,48,129,418,293
"2021","Dacorum 012","E02004867",4958,3287,2754,2742,12,5,528,520,8,1671,992,42,60,322,255
"2021","Dacorum 013","E02004868",5785,3440,2481,2474,7,12,947,920,27,2345,1480,70,134,372,289
"2021","Dacorum 014","E02004869",4509,2962,2397,2383,14,7,558,536,22,1547,938,38,66,274,231
"2021","Dacorum 015","E02004870",9138,5096,3550,3532,18,6,1540,1470,70,4042,2590,117,188,713,434
"2021","Dacorum 016","E02004871",4014,2399,1788,1774,14,0,611,590,21,1615,1019,27,58,278,233
"2021","Dacorum 017","E02004872",5967,3798,3139,3123,16,9,650,638,12,2169,1341,53,100,329,346
"2021","Dacorum 018","E02004873",9472,5956,4272,4243,29,10,1674,1606,68,3516,2196,83,218,625,394
"2021","Dacorum 019","E02004874",4811,2865,2225,2211,14,7,633,608,25,1946,1268,48,89,294,247
"2021","Dacorum 020","E02004875",8056,4685,3450,3440,10,17,1218,1166,52,3371,2185,111,159,538,378
"2021","Dacorum 021","E02004876",6946,4609,3817,3793,24,5,787,743,44,2337,1352,50,100,428,407
"2021","Dacorum 022","E02004877",4278,2755,2224,2215,9,9,522,502,20,1523,899,34,64,258,268
"2021","Hertsmere 001","E02004896",6721,4026,3342,3340,2,14,670,640,30,2695,1610,77,93,394,521
"2021","Hertsmere 002","E02004897",5467,3229,2743,2735,8,19,467,458,9,2238,1452,40,57,324,365
"2021","Hertsmere 003","E02004898",6203,3226,2610,2592,18,6,610,582,28,2977,1925,72,96,501,383
"2021","Hertsmere 004","E02004899",4214,2612,2180,2168,12,6,426,410,16,1602,1046,39,71,262,184
"2021","Hertsmere 005","E02004900",6592,4295,3851,3838,13,6,438,420,18,2297,1426,74,88,337,372
"2021","Hertsmere 006","E02004901",7878,4149,3109,3096,13,6,1034,1002,32,3729,2430,158,158,610,373
"2021","Hertsmere 007","E02004902",6247,3442,2755,2743,12,7,680,656,24,2805,1775,123,130,483,294
"2021","Hertsmere 008","E02004903",5877,3447,2779,2762,17,4,664,640,24,2430,1609,82,102,357,280
"2021","Hertsmere 009","E02004904",5419,2920,2201,2187,14,9,710,684,26,2499,1677,72,108,416,226
"2021","Hertsmere 010","E02004905",5081,3264,2845,2841,4,9,410,390,20,1817,1168,85,54,270,240
"2021","Hertsmere 011","E02004906",8446,4862,3906,3886,20,14,942,904,38,3584,2368,156,126,579,355
"2021","Hertsmere 012","E02004907",8577,5122,4172,4146,26,10,940,894,46,3455,2128,108,137,598,484
"2021","Hertsmere 013","E02004908",8504,5416,4856,4840,16,8,552,524,28,3088,1747,118,94,499,630
"2021","North Hertfordshire 001","E02004909",4661,2906,2090,2082,8,8,808,788,20,1755,1068,49,80,314,244
"2021","North Hertfordshire 002","E02004910",9350,6330,5024,5000,24,4,1302,1256,46,3020,1823,67,132,501,497
"2021","North Hertfordshire 003","E02004911",5462,3215,2367,2349,18,1,847,810,37,2247,1338,36,104,398,371
"2021","North Hertfordshire 004","E02004912",8574,5119,3755,3735,20,10,1354,1298,56,3455,2049,47,171,653,535
"2021","North Hertfordshire 006","E02004914",6360,3803,2686,2675,11,13,1104,1064,40,2557,1666,44,122,411,314
"2021","North Hertfordshire 007","E02004915",4541,2558,1842,1826,16,2,714,698,16,1983,1220,36,107,352,268
"2021","North Hertfordshire 008","E02004916",5993,3806,3147,3129,18,1,658,622,36,2187,1262,44,93,373,415
"2021","North Hertfordshire 009","E02004917",5176,3034,2403,2396,7,4,627,601,26,2142,1303,52,77,371,339
"2021","North Hertfordshire 010","E02004918",6613,4020,2740,2710,30,6,1274,1216,58,2593,1681,77,140,424,271
"2021","North Hertfordshire 011","E02004919",6132,3855,2889,2867,22,6,960,910,50,2277,1444,46,100,393,294
"2021","North Hertfordshire 012","E02004920",9118,5445,4143,4107,36,3,1299,1246,53,3673,2235,58,175,602,603
"2021","North Hertfordshire 013","E02004921",6197,4102,3224,3212,12,8,870,828,42,2095,1248,44,109,334,360
"2021","North Hertfordshire 014","E02004922",8166,5394,4276,4246,30,12,1106,1068,38,2772,1632,63,112,479,486
"2021","North Hertfordshire 015","E02004923",8442,5552,4453,4431,22,7,1092,1054,38,2890,1643,76,114,504,553
"2021","North Hertfordshire 016","E02007088",6281,4289,3534,3508,26,4,751,715,36,1992,1165,43,92,342,350
"2021","North Hertfordshire 017","E02007089",5656,3662,2752,2728,24,4,906,876,30,1994,1319,45,110,328,192
"2021","Three Rivers 001","E02004956",7412,4391,3452,3436,16,12,927,876,51,3021,1874,59,124,513,451
"2021","Three Rivers 002","E02004957",8282,4976,3872,3849,23,19,1085,1056,29,3306,2138,89,131,591,357
"2021","Three Rivers 003","E02004958",6281,4123,3494,3486,8,9,620,608,12,2158,1364,47,62,336,349
"2021","Three Rivers 004","E02004959",4963,3182,2814,2804,10,2,366,344,22,1781,1049,92,64,214,362
"2021","Three Rivers 005","E02004960",4550,3059,2692,2683,9,1,366,352,14,1491,942,33,44,205,267
"2021","Three Rivers 006","E02004961",7685,5000,4158,4132,26,6,836,800,36,2685,1621,62,99,447,456
"2021","Three Rivers 007","E02004962",7188,4454,3513,3499,14,5,936,888,48,2734,1770,66,113,439,346
"2021","Three Rivers 008","E02004963",5894,3447,2815,2810,5,10,622,602,20,2447,1599,98,101,374,275
"2021","Three Rivers 009","E02004964",4496,2594,1943,1929,14,9,642,612,30,1902,1171,54,94,341,242
"2021","Three Rivers 010","E02004965",5648,3402,2902,2900,2,4,496,476,20,2246,1321,85,70,337,433
"2021","Three Rivers 011","E02004966",5845,3961,3643,3625,18,6,312,294,18,1884,1155,132,54,187,356
"2021","Three Rivers 012","E02004967",6115,3282,2510,2504,6,14,758,726,32,2833,1946,92,116,435,244
"2021","Watford 001","E02004968",5948,3276,2578,2574,4,6,692,666,26,2672,1733,87,110,436,306
"2021","Watford 002","E02004969",5777,3466,2845,2839,6,9,612,586,26,2311,1514,65,106,327,299
"2021","Watford 003","E02004970",6518,3580,2805,2797,8,5,770,734,36,2938,1902,92,121,407,416
"2021","Watford 004","E02004971",6636,3700,2971,2967,4,13,716,696,20,2936,2009,147,116,377,287
"2021","Watford 005","E02004972",4992,3227,2699,2689,10,9,519,496,23,1765,1169,62,64,217,253
"2021","Watford 006","E02004973",6851,3824,2672,2659,13,8,1144,1080,64,3027,2061,207,125,458,176
"2021","Watford 007","E02004974",7091,4448,3594,3570,24,4,850,822,28,2643,1703,118,99,417,306
"2021","Watford 008","E02004975",6505,4156,3644,3636,8,0,512,498,14,2349,1555,127,83,248,336
"2021","Watford 009","E02004976",9191,4774,3093,3045,48,13,1668,1574,94,4417,3009,286,217,626,279
"2021","Watford 010","E02004977",7116,3863,3049,3040,9,10,804,760,44,3253,2183,361,114,388,207
"2021","Watford 011","E02004978",7811,4128,3268,3262,6,10,850,812,38,3683,2526,232,201,446,278
"2021","Watford 012","E02004979",5820,3451,2730,2707,23,7,714,684,30,2369,1504,89,123,398,255
"2021","Breckland 001","E02005503",6049,4187,3325,3290,35,4,858,818,40,1862,990,42,80,342,408
"2021","Breckland 002","E02005504",7779,5365,4306,4271,35,7,1052,1004,48,2414,1297,56,115,428,518
"2021","Breckland 003","E02005505",6115,3902,3008,2984,24,12,882,856,26,2213,1268,35,109,396,405
"2021","Breckland 004","E02005506",5872,3985,3100,3088,12,6,879,846,33,1887,1027,35,73,367,385
"2021","Breckland 005","E02005507",9545,5701,4067,4055,12,11,1623,1545,78,3844,2116,66,215,812,635
"2021","Breckland 006","E02005508",6118,4258,3330,3300,30,4,924,888,36,1860,1006,51,77,359,367
"2021","Breckland 007","E02005509",7067,4473,3398,3372,26,8,1067,1020,47,2594,1260,53,123,556,602
"2021","Breckland 008","E02005510",6255,4278,3369,3345,24,11,898,874,24,1977,1025,39,86,356,471
"2021","Breckland 009","E02005511",7526,4930,3620,3594,26,2,1308,1260,48,2596,1313,86,110,532,555
"2021","Breckland 010","E02005512",7521,5274,3873,3839,34,11,1390,1334,56,2247,1347,59,113,417,311
"2021","Breckland 011","E02005513",8628,5516,3906,3888,18,14,1596,1548,48,3112,1687,78,169,591,587
"2021","Breckland 012","E02005514",5784,3998,3089,3071,18,3,906,876,30,1786,907,56,94,349,380
"2021","Breckland 013","E02005515",5322,3656,2871,2850,21,8,777,746,31,1666,947,28,81,288,322
"2021","Breckland 014","E02005516",5879,4056,3205,3184,21,6,845,804,41,1823,1024,39,95,335,330
"2021","Breckland 015","E02005517",4559,2412,1534,1526,8,6,872,838,34,2147,1303,71,127,446,200
"2021","Breckland 016","E02005518",8703,5520,3835,3813,22,15,1670,1600,70,3183,1831,93,173,644,442
"2021","Breckland 017","E02005519",6733,3815,2620,2613,7,7,1188,1156,32,2918,1779,78,154,515,392
"2021","Broadland 001","E02005520",7407,4807,3776,3752,24,6,1025,992,33,2600,1307,44,132,539,578
"2021","Broadland 002","E02005521",7296,4791,3725,3714,11,4,1062,1020,42,2505,1363,31,126,513,472
"2021","Broadland 003","E02005522",4589,3086,2440,2420,20,2,644,626,18,1503,829,33,65,321,255
"2021","Broadland 004","E02005523",6953,4672,3574,3550,24,8,1090,1050,40,2281,1383,39,98,418,343
"2021","Broadland 005","E02005524",4518,3054,2420,2404,16,4,630,604,26,1464,770,26,64,275,329
"2021","Broadland 006","E02005525",7993,5342,4238,4210,28,12,1092,1050,42,2651,1523,47,121,496,464
"2021","Broadland 007","E02005526",4358,2862,2254,2242,12,4,604,588,16,1496,801,27,68,298,302
"2021","Broadland 008","E02005527",7434,5163,4020,3990,30,3,1140,1086,54,2271,1284,62,96,411,418
"2021","Broadland 009","E02005528",7136,4687,3574,3544,30,8,1105,1066,39,2449,1329,39,115,500,466
"2021","Broadland 010","E02005529",4824,3116,2470,2466,4,2,644,626,18,1708,829,33,67,324,455
"2021","Broadland 011","E02005530",4550,3000,2292,2280,12,6,702,678,24,1550,834,37,57,248,374
"2021","Broadland 012","E02005531",4435,2844,2133,2127,6,5,706,678,28,1591,913,26,71,308,273
"2021","Broadland 013","E02005532",7952,5299,3814,3795,19,5,1480,1450,30,2653,1475,52,119,447,560
"2021","Broadland 014","E02005533",7511,5136,4103,4079,24,5,1028,998,30,2375,1259,60,124,450,482
"2021","Broadland 015","E02005534",6266,4050,3167,3153,14,1,882,844,38,2216,1169,39,82,454,472
"2021","Broadland 016","E02005535",5752,3644,2724,2686,38,6,914,884,30,2108,1269,32,99,445,263
"2021","Broadland 017","E02005536",5169,3528,2788,2762,26,2,738,698,40,1641,869,38,83,337,314
"2021","Broadland 018","E02005537",5055,3260,2502,2490,12,0,758,732,26,1795,947,26,85,340,397
"2021","Great Yarmouth 001","E02005538",8337,5478,4287,4265,22,5,1186,1142,44,2859,1525,57,103,550,624
"2021","Great Yarmouth 002","E02005539",6747,4586,3577,3563,14,9,1000,958,42,2161,1232,43,77,366,443
"2021","Great Yarmouth 003","E02005540",7636,4752,3594,3576,18,4,1154,1114,40,2884,1379,58,102,615,730
"2021","Great Yarmouth 004","E02005541",4765,2611,1882,1866,16,1,728,694,34,2154,1248,32,105,456,313
"2021","Great Yarmouth 005","E02005542",5709,2603,1467,1453,14,4,1132,1084,48,3106,1985,85,151,619,266
"2021","Great Yarmouth 006","E02005543",7088,2996,1604,1600,4,4,1388,1328,60,4092,2608,96,223,825,340
"2021","Great Yarmouth 007","E02005544",5574,2800,1706,1684,22,2,1092,1036,56,2774,1710,59,155,588,262
"2021","Great Yarmouth 008","E02005545",5447,3673,2920,2904,16,1,752,726,26,1774,988,40,45,333,368
"2021","Great Yarmouth 009","E02005546",6416,3246,2142,2130,12,6,1098,1072,26,3170,1871,44,167,656,432
"2021","Great Yarmouth 010","E02005547",7068,4087,3069,3041,28,7,1011,976,35,2981,1738,76,132,563,472
"2021","Great Yarmouth 011","E02005548",5833,3314,2353,2333,20,3,958,922,36,2519,1474,88,89,427,441
"2021","Great Yarmouth 012","E02005549",4750,3166,2407,2397,10,5,754,740,14,1584,827,31,80,338,308
"2021","Great Yarmouth 013","E02005550",6393,4100,2960,2942,18,4,1136,1098,38,2293,1239,56,87,428,483
"2021","King's Lynn and West Norfolk 001","E02005551",4587,2780,2221,2197,24,1,558,538,20,1807,762,47,80,395,523
"2021","King's Lynn and West Norfolk 002","E02005552",5663,3689,2930,2895,35,5,754,720,34,1974,971,56,100,362,485
"2021","King's Lynn and West Norfolk 003","E02005553",7632,5007,4049,4031,18,4,954,924,30,2625,1175,66,103,554,727
"2021","King's Lynn and West Norfolk 004","E02005554",6096,3988,3156,3142,14,4,828,800,28,2108,996,34,83,432,563
"2021","King's Lynn and West Norfolk 005","E02005555",5658,4008,3310,3302,8,4,694,662,32,1650,890,36,67,269,388
"2021","King's Lynn and West Norfolk 006","E02005556",6330,4113,2996,2978,18,3,1114,1072,42,2217,1234,41,92,437,413
"2021","King's Lynn and West Norfolk 007","E02005557",5204,2794,1730,1710,20,8,1056,1012,44,2410,1527,58,118,450,257
"2021","King's Lynn and West Norfolk 008","E02005558",6117,4104,3153,3135,18,5,946,930,16,2013,1115,49,63,330,456
"2021","King's Lynn and West Norfolk 009","E02005559",5867,3366,2378,2362,16,8,980,956,24,2501,1471,70,110,493,357
"2021","King's Lynn and West Norfolk 010","E02005560",7030,4105,2888,2865,23,11,1206,1166,40,2925,1818,99,135,563,310
"2021","King's Lynn and West Norfolk 011","E02005561",8807,4366,2586,2560,26,6,1774,1690,84,4441,2650,118,241,915,517
"2021","King's Lynn and West Norfolk 012","E02005562",6284,4184,3250,3222,28,0,934,886,48,2100,1100,43,90,416,451
"2021","King's Lynn and West Norfolk 013","E02005563",6660,4444,3291,3277,14,7,1146,1124,22,2216,1241,61,98,365,451
"2021","King's Lynn and West Norfolk 014","E02005564",7525,5298,4267,4249,18,3,1028,980,48,2227,1212,56,107,381,471
"2021","King's Lynn and West Norfolk 015","E02005565",6117,4092,2996,2980,16,2,1094,1052,42,2025,1167,39,102,345,372
"2021","King's Lynn and West Norfolk 016","E02005566",8682,5782,4329,4299,30,7,1446,1420,26,2900,1630,78,143,492,557
"2021","King's Lynn and West Norfolk 017","E02005567",9359,5852,4365,4339,26,9,1478,1424,54,3507,1693,83,168,673,890
"2021","King's Lynn and West Norfolk 018","E02005568",6441,4410,3506,3483,23,12,892,858,34,2031,1084,42,91,351,463
"2021","King's Lynn and West Norfolk 019","E02005569",7094,4839,3735,3705,30,5,1099,1076,23,2255,1319,47,106,362,421
"2021","North Norfolk 001","E02005570",6074,3857,3172,3124,48,6,679,648,31,2217,1047,57,83,438,592
"2021","North Norfolk 002","E02005571",4997,3199,2559,2541,18,0,640,616,24,1798,852,47,75,381,443
"2021","North Norfolk 003","E02005572",6445,3652,2774,2744,30,0,878,832,46,2793,1345,102,130,632,584
"2021","North Norfolk 004","E02005573",4871,3070,2492,2464,28,0,578,542,36,1801,764,42,72,353,570
"2021","North Norfolk 005","E02005574",6053,4108,3298,3268,30,2,808,776,32,1945,963,45,93,396,448
"2021","North Norfolk 006","E02005575",6067,4103,3292,3258,34,4,807,778,29,1964,1062,54,83,328,437
"2021","North Norfolk 007","E02005576",5741,3690,2988,2958,30,8,694,670,24,2051,990,43,95,458,465
"2021","North Norfolk 008","E02005577",5066,3328,2577,2553,24,3,748,720,28,1738,912,54,75,337,360
"2021","North Norfolk 009","E02005578",4962,3266,2386,2368,18,0,880,862,18,1696,910,37,81,365,303
"2021","North Norfolk 011","E02005580",6682,4091,3009,2981,28,8,1074,1030,44,2591,1299,66,114,547,565
"2021","North Norfolk 012","E02005581",6117,4214,3239,3197,42,1,974,934,40,1903,992,46,115,394,356
"2021","North Norfolk 013","E02005582",5802,3584,2696,2672,24,6,882,846,36,2218,1125,41,167,404,481
"2021","North Norfolk 014","E02005583",7534,5108,4132,4102,30,6,970,940,30,2426,1149,64,103,431,679
"2021","North Norfolk 015","E02007032",5700,3354,2574,2548,26,2,778,744,34,2346,1205,31,107,470,533
"2021","North Norfolk 016","E02007033",5091,3038,2212,2184,28,2,824,788,36,2053,1017,40,101,491,404
"2021","Norwich 001","E02005584",8791,4712,3131,3109,22,7,1574,1494,80,4079,2639,75,216,760,389
"2021","Norwich 002","E02005585",8831,4471,2621,2583,38,9,1841,1766,75,4360,2935,92,222,749,362
"2021","Norwich 003","E02005586",8674,4510,2351,2303,48,7,2152,2028,124,4164,2953,68,187,708,248
"2021","Norwich 004","E02005587",7734,4221,2893,2852,41,10,1318,1248,70,3513,2148,63,159,650,493
"2021","Norwich 005","E02005588",10322,4744,3154,3122,32,8,1582,1496,86,5578,4161,127,177,698,415
"2021","Norwich 006","E02005589",9706,4498,2796,2770,26,8,1694,1608,86,5208,3899,98,192,651,368
"2021","Norwich 009","E02005592",7885,4039,2443,2403,40,5,1591,1484,107,3846,3004,48,152,466,176
"2021","Norwich 010","E02005593",6247,2324,1604,1584,20,12,708,672,36,3923,3081,40,82,386,334
"2021","Norwich 011","E02005594",9421,4348,2750,2692,58,4,1594,1502,92,5073,3406,115,197,882,473
"2021","Norwich 012","E02005595",7891,4702,3818,3772,46,2,882,826,56,3189,1979,82,84,470,574
"2021","Norwich 013","E02005596",7911,4099,2543,2506,37,8,1548,1458,90,3812,2408,64,178,700,462
"2021","Norwich 014","E02006907",6335,2683,1373,1339,34,3,1307,1237,70,3652,2573,108,159,603,209
"2021","Norwich 015","E02006908",4743,2347,1273,1246,27,4,1070,1000,70,2396,1573,39,135,477,172
"2021","Norwich 016","E02007052",5535,2214,1106,1094,12,1,1107,1012,95,3321,2157,65,161,680,258
"2021","Norwich 017","E02007053",4339,1754,879,839,40,1,874,810,64,2585,1781,61,104,462,177
"2021","South Norfolk 002","E02005598",7877,5465,4283,4245,38,5,1177,1135,42,2412,1396,83,104,438,391
"2021","South Norfolk 003","E02005599",5740,3894,2962,2944,18,4,928,896,32,1846,1003,28,97,390,328
"2021","South Norfolk 004","E02005600",4797,3280,2648,2606,42,2,630,602,28,1517,863,28,71,246,309
"2021","South Norfolk 005","E02005601",4714,2830,2202,2182,20,8,620,602,18,1884,893,36,92,404,459
"2021","South Norfolk 006","E02005602",10475,7138,5525,5469,56,11,1602,1550,52,3337,1762,61,147,704,663
"2021","South Norfolk 007","E02005603",9897,6542,4892,4856,36,14,1636,1590,46,3355,1968,66,200,670,451
"2021","South Norfolk 008","E02005604",7338,4832,3871,3833,38,9,952,914,38,2506,1415,36,96,447,512
"2021","South Norfolk 009","E02005605",8678,6027,4825,4795,30,6,1196,1172,24,2651,1487,58,108,512,486
"2021","South Norfolk 010","E02005606",4982,3410,2658,2638,20,2,750,722,28,1572,922,28,69,269,284
"2021","South Norfolk 011","E02005607",9499,6488,5071,5025,46,13,1404,1366,38,3011,1709,74,153,548,527
"2021","South Norfolk 012","E02005608",6433,4368,3495,3475,20,1,872,848,24,2065,1109,34,80,401,441
"2021","South Norfolk 013","E02005609",6284,4088,3066,3050,16,2,1020,980,40,2196,1117,42,118,484,435
"2021","South Norfolk 014","E02005610",6861,4727,3674,3644,30,2,1051,1014,37,2134,1125,55,89,418,447
"2021","South Norfolk 015","E02005611",9164,5611,4045,4008,37,6,1560,1488,72,3553,1871,70,174,762,676
"2021","South Norfolk 016","E02007054",6660,4524,3097,3063,34,7,1420,1358,62,2136,1337,57,131,401,210
"2021","South Norfolk 017","E02007055",6366,4023,3028,3016,12,11,984,956,28,2343,1292,35,95,462,459
"2021","Babergh 001","E02006227",5540,3684,2959,2933,26,15,710,680,30,1856,931,49,92,381,403
"2021","Babergh 002","E02006228",5109,3482,2698,2694,4,4,780,750,30,1627,953,36,76,291,271
"2021","Babergh 003","E02006229",5259,3518,2821,2803,18,3,694,670,24,1741,901,30,82,345,383
"2021","Babergh 004","E02006230",8948,5917,4856,4830,26,12,1049,996,53,3031,1646,60,161,529,635
"2021","Babergh 005","E02006231",7154,4750,3540,3502,38,7,1203,1144,59,2404,1434,52,93,487,338
"2021","Babergh 006","E02006232",5152,3480,2798,2782,16,3,679,660,19,1672,922,50,73,298,329
"2021","Babergh 007","E02006233",9610,5448,3811,3779,32,13,1624,1558,66,4162,2238,84,241,919,680
"2021","Babergh 008","E02006234",7890,4891,3505,3478,27,4,1382,1342,40,2999,1805,41,147,594,412
"2021","Babergh 009","E02006235",6894,4810,3880,3854,26,4,926,884,42,2084,1120,46,88,337,493
"2021","Babergh 010","E02006236",8762,6048,5033,5019,14,9,1006,978,28,2714,1520,57,100,459,578
"2021","Babergh 011","E02006237",6111,4070,3228,3192,36,8,834,816,18,2041,1082,33,118,387,421
"2021","Ipswich 001","E02006245",6489,3872,2908,2894,14,2,962,930,32,2617,1572,60,102,441,442
"2021","Ipswich 002","E02006246",6091,4095,3121,3101,20,6,968,940,28,1996,1165,39,79,303,410
"2021","Ipswich 003","E02006247",7126,4068,2714,2696,18,6,1348,1290,58,3058,1976,49,152,567,314
"2021","Ipswich 004","E02006248",6596,4050,3107,3083,24,3,940,924,16,2546,1562,40,97,453,394
"2021","Ipswich 005","E02006249",6775,4160,3224,3188,36,10,926,878,48,2615,1568,64,133,478,372
"2021","Ipswich 006","E02006250",8009,4030,2440,2414,26,12,1578,1476,102,3979,2629,151,217,752,230
"2021","Ipswich 007","E02006251",8714,4209,2515,2485,30,9,1685,1594,91,4505,3082,172,228,756,267
"2021","Ipswich 008","E02006252",7633,4530,3164,3144,20,4,1362,1322,40,3103,1915,89,148,604,347
"2021","Ipswich 009","E02006253",6154,4043,3313,3297,16,11,719,684,35,2111,1223,50,68,316,454
"2021","Ipswich 010","E02006254",7290,3794,2442,2426,16,10,1342,1254,88,3496,2332,87,143,627,307
"2021","Ipswich 011","E02006255",6385,3760,2572,2534,38,10,1178,1112,66,2625,1658,90,149,440,288
"2021","Ipswich 012","E02006256",7608,3955,2483,2459,24,0,1472,1394,78,3653,2472,86,176,613,306
"2021","Ipswich 013","E02006257",5458,3213,2357,2347,10,8,848,818,30,2245,1290,48,108,398,401
"2021","Ipswich 014","E02006258",7422,4071,2875,2856,19,2,1194,1164,30,3351,2176,76,161,580,358
"2021","Ipswich 015","E02006259",5656,3174,2306,2294,12,4,864,840,24,2482,1500,44,132,463,343
"2021","Ipswich 016","E02006260",6803,3938,2740,2726,14,12,1186,1142,44,2865,1782,61,152,492,378
"2021","Mid Suffolk 001","E02006261",6676,4457,3594,3574,20,4,859,829,30,2219,1213,57,105,404,440
"2021","Mid Suffolk 002","E02006262",7593,5195,4237,4207,30,9,949,910,39,2398,1309,58,111,452,468
"2021","Mid Suffolk 003","E02006263",6450,4449,3598,3560,38,11,840,802,38,2001,1131,59,94,332,385
"2021","Mid Suffolk 004","E02006264",7313,5100,4041,4033,8,3,1056,1018,38,2213,1238,60,108,395,412
"2021","Mid Suffolk 005","E02006265",6243,4280,3374,3364,10,6,900,876,24,1963,1067,46,87,324,439
"2021","Mid Suffolk 006","E02006266",8004,5486,4476,4444,32,11,999,962,37,2518,1387,52,135,442,502
"2021","Mid Suffolk 007","E02006267",7080,4882,4052,4032,20,2,828,794,34,2198,1285,48,93,368,404
"2021","Mid Suffolk 008","E02006268",5085,2955,2187,2169,18,1,767,736,31,2130,1169,26,96,416,423
"2021","Mid Suffolk 009","E02006269",6277,4272,3246,3228,18,2,1024,980,44,2005,1165,46,99,352,343
"2021","Mid Suffolk 010","E02006270",10289,6610,4500,4464,36,18,2092,2036,56,3679,2215,61,202,745,456
"2021","Mid Suffolk 011","E02006271",7674,5206,3717,3683,34,9,1480,1430,50,2468,1350,42,129,503,444
"2021","Mid Suffolk 012","E02006272",6440,4264,3374,3352,22,0,890,862,28,2176,1163,47,105,400,461
"2021","St Albans 001","E02004924",5782,3974,3491,3481,10,9,474,454,20,1808,1132,48,79,282,267
"2021","St Albans 002","E02004925",5766,3806,3279,3267,12,7,520,496,24,1960,1240,32,95,344,249
"2021","St Albans 003","E02004926",6193,4290,3680,3676,4,4,606,586,20,1903,1054,57,91,299,402
"2021","St Albans 004","E02004927",5217,3500,2924,2910,14,12,564,552,12,1717,1026,38,72,284,297
"2021","St Albans 005","E02004928",5366,3851,3367,3348,19,4,480,470,10,1515,901,42,55,243,274
"2021","St Albans 006","E02004929",5041,3321,2766,2759,7,7,548,534,14,1720,986,36,66,296,336
"2021","St Albans 007","E02004930",5464,3469,2782,2776,6,12,675,642,33,1995,1281,65,72,304,273
"2021","St Albans 008","E02004931",5369,3416,2957,2951,6,3,456,446,10,1953,1199,50,75,323,306
"2021","St Albans 009","E02004932",5851,3508,2808,2796,12,4,696,665,31,2343,1516,61,119,373,274
"2021","St Albans 010","E02004933",5280,3852,3358,3342,16,2,492,482,10,1428,977,32,56,155,208
"2021","St Albans 011","E02004934",6135,3898,2800,2758,42,4,1094,1046,48,2237,1526,89,109,295,218
"2021","St Albans 012","E02004935",7400,4520,2757,2728,29,9,1754,1678,76,2880,1925,71,156,488,240
"2021","St Albans 013","E02004936",4911,3266,2722,2700,22,4,540,526,14,1645,1113,32,63,248,189
"2021","St Albans 014","E02004937",5765,3976,3323,3311,12,5,648,604,44,1789,1035,50,72,263,369
"2021","St Albans 016","E02004939",5159,3016,2472,2462,10,10,534,512,22,2143,1286,76,96,337,348
"2021","St Albans 017","E02004940",5831,3483,2621,2600,21,6,856,828,28,2348,1559,69,83,360,277
"2021","St Albans 018","E02004941",7815,4452,3460,3446,14,8,984,940,44,3363,2193,94,147,563,366
"2021","St Albans 019","E02004942",5125,3172,2574,2562,12,4,594,568,26,1953,1166,30,83,349,325
"2021","St Albans 020","E02004943",6669,4381,3779,3765,14,5,597,581,16,2288,1373,57,87,338,433
"2021","St Albans 021","E02007090",4805,3004,2423,2413,10,11,570,560,10,1801,1201,57,73,249,221
"2021","Welwyn Hatfield 001","E02004980",5082,3568,3083,3065,18,11,474,452,22,1514,955,39,56,178,286
"2021","Welwyn Hatfield 002","E02004981",6489,4120,3260,3242,18,4,856,826,30,2369,1448,81,102,397,341
"2021","Welwyn Hatfield 003","E02004982",4685,3024,2462,2456,6,8,554,540,14,1661,1009,29,83,252,288
"2021","Welwyn Hatfield 004","E02004983",4837,2853,2092,2089,3,5,756,734,22,1984,1182,31,92,360,319
"2021","Welwyn Hatfield 005","E02004984",5139,3052,2276,2266,10,4,772,748,24,2087,1272,44,97,393,281
"2021","Welwyn Hatfield 006","E02004985",5714,3470,2909,2889,20,3,558,534,24,2244,1263,61,91,389,440
"2021","Welwyn Hatfield 007","E02004986",6811,3568,2321,2305,16,11,1236,1186,50,3243,2231,84,168,490,270
"2021","Welwyn Hatfield 008","E02004987",5945,3635,2703,2685,18,4,928,902,26,2310,1453,73,122,387,275
"2021","Welwyn Hatfield 009","E02004988",6028,3511,2570,2552,18,7,934,914,20,2517,1625,73,114,409,296
"2021","Welwyn Hatfield 010","E02004989",8758,4100,3001,2987,14,11,1088,1034,54,4658,3515,193,155,493,302
"2021","Welwyn Hatfield 011","E02004990",5901,3220,2451,2427,24,5,764,732,32,2681,1691,174,123,416,277
"2021","Welwyn Hatfield 012","E02004991",6504,3018,2080,2076,4,6,932,894,38,3486,2550,179,104,429,224
"2021","Welwyn Hatfield 013","E02004992",6451,2851,2049,2034,15,12,790,764,26,3600,2670,202,127,349,252
"2021","Welwyn Hatfield 015","E02004994",4972,3252,2798,2778,20,12,442,424,18,1720,1115,46,45,227,287
"2021","Welwyn Hatfield 016","E02004995",4714,3059,2672,2664,8,9,378,366,12,1655,1014,71,54,211,305
"2021","Welwyn Hatfield 017","E02007092",4404,2404,1874,1866,8,4,526,510,16,2000,1213,85,79,337,286
"2021","East Hertfordshire 001","E02004878",7340,5000,3878,3864,14,10,1112,1066,46,2340,1407,45,100,381,407
"2021","East Hertfordshire 003","E02004880",8476,5826,4763,4747,16,9,1054,1018,36,2650,1706,71,110,417,346
"2021","East Hertfordshire 004","E02004881",5530,3412,2590,2580,10,2,820,780,40,2118,1319,59,87,311,342
"2021","East Hertfordshire 005","E02004882",6549,3989,3078,3068,10,13,898,846,52,2560,1706,85,107,346,316
"2021","East Hertfordshire 006","E02004883",4991,3315,2624,2608,16,9,682,660,22,1676,1008,46,60,283,279
"2021","East Hertfordshire 007","E02004884",8468,4923,3480,3464,16,2,1441,1383,58,3545,2258,79,144,631,433
"2021","East Hertfordshire 008","E02004885",6803,4506,3791,3777,14,3,712,684,28,2297,1487,64,84,366,296
"2021","East Hertfordshire 009","E02004886",5215,3534,2790,2776,14,6,738,700,38,1681,1013,52,72,268,276
"2021","East Hertfordshire 010","E02004887",6221,4167,3428,3413,15,5,734,710,24,2054,1257,45,99,323,330
"2021","East Hertfordshire 011","E02004888",7086,4606,3747,3725,22,9,850,824,26,2480,1463,42,89,445,441
"2021","East Hertfordshire 012","E02004889",8774,5310,3908,3878,30,8,1394,1348,46,3464,2094,67,162,618,523
"2021","East Hertfordshire 013","E02004890",6959,4394,3112,3094,18,2,1280,1230,50,2565,1592,41,100,476,356
"2021","East Hertfordshire 014","E02004891",6293,4118,3154,3132,22,14,950,922,28,2175,1292,44,92,397,350
"2021","East Hertfordshire 015","E02004892",4631,2717,1916,1900,16,3,798,780,18,1914,1277,24,81,308,224
"2021","East Hertfordshire 016","E02004893",4643,2958,2186,2172,14,8,764,736,28,1685,1153,26,64,271,171
"2021","East Hertfordshire 017","E02004894",7847,4664,3166,3138,28,4,1494,1436,58,3183,1906,78,160,610,429
"2021","East Hertfordshire 018","E02004895",7166,4506,3600,3586,14,8,898,864,34,2660,1651,56,113,463,377
"2021","East Hertfordshire 019","E02007093",6671,4552,3709,3683,26,3,840,818,22,2119,1293,38,105,325,358
"2021","Stevenage 001","E02004944",6190,3504,2476,2460,16,6,1022,976,46,2686,1824,101,127,420,214
"2021","Stevenage 002","E02004945",9619,5880,4415,4383,32,11,1454,1394,60,3739,2461,112,167,560,439
"2021","Stevenage 003","E02004946",5017,2740,2023,2013,10,5,712,696,16,2277,1414,69,114,437,243
"2021","Stevenage 005","E02004948",4920,2842,2072,2064,8,0,770,740,30,2078,1230,40,139,367,302
"2021","Stevenage 006","E02004949",6990,3740,2663,2647,16,5,1072,1020,52,3250,1974,88,144,595,449
"2021","Stevenage 007","E02004950",5303,3122,2319,2313,6,5,798,782,16,2181,1316,43,118,389,315
"2021","Stevenage 008","E02004951",6361,3290,2305,2295,10,13,972,924,48,3071,2054,99,148,436,334
"2021","Stevenage 009","E02004952",5456,3228,2416,2402,14,12,800,778,22,2228,1425,50,98,377,278
"2021","Stevenage 010","E02004953",5017,2889,2155,2143,12,10,724,696,28,2128,1357,36,119,340,276
"2021","Stevenage 011","E02004954",5597,3186,2329,2313,16,11,846,826,20,2411,1539,68,124,410,270
"2021","Stevenage 012","E02004955",4781,2934,2270,2246,24,4,660,642,18,1847,1123,39,84,321,280
"2021","Stevenage 013","E02007091",5327,3572,2714,2700,14,8,850,836,14,1755,1107,31,70,317,230
"2021","East Suffolk 016","E02006287",5436,3726,2958,2920,38,4,764,718,46,1710,866,56,68,288,432
"2021","East Suffolk 017","E02006288",8174,5402,4324,4284,40,4,1074,1042,32,2772,1531,83,147,494,517
"2021","East Suffolk 018","E02006289",8058,5148,3992,3950,42,2,1154,1118,36,2910,1524,75,135,586,590
"2021","East Suffolk 019","E02006290",6843,4146,3078,3040,38,10,1058,1012,46,2697,1303,83,136,548,627
"2021","East Suffolk 020","E02006291",6495,4184,3296,3268,28,2,886,862,24,2311,1251,37,112,461,450
"2021","East Suffolk 021","E02006292",5676,3996,3292,3280,12,6,698,668,30,1680,949,49,67,274,341
"2021","East Suffolk 023","E02006293",8300,5710,4625,4587,38,2,1083,1050,33,2590,1464,58,140,514,414
"2021","East Suffolk 022","E02006294",6642,3901,3073,3041,32,4,824,786,38,2741,1298,65,138,567,673
"2021","East Suffolk 024","E02006295",7650,4952,4059,4039,20,11,882,842,40,2698,1464,54,152,473,555
"2021","East Suffolk 025","E02006296",10582,7070,5814,5792,22,8,1248,1214,34,3512,2135,70,169,601,537
"2021","East Suffolk 026","E02006297",6775,4712,4015,3997,18,5,692,674,18,2063,1225,50,78,295,415
"2021","East Suffolk 027","E02006298",7629,5129,3923,3912,11,6,1200,1170,30,2500,1412,34,120,521,413
"2021","East Suffolk 028","E02006299",7204,4938,4240,4224,16,0,698,676,22,2266,1085,45,79,410,647
"2021","East Suffolk 029","E02006300",6485,3452,2408,2394,14,8,1036,1002,34,3033,1698,53,182,713,387
"2021","East Suffolk 030","E02006301",5193,2816,2072,2050,22,8,736,688,48,2377,1211,72,139,559,396
"2021","East Suffolk 001","E02006302",5755,3948,3201,3175,26,5,742,700,42,1807,943,42,72,330,420
"2021","East Suffolk 002","E02006303",6187,3372,2274,2260,14,10,1088,1036,52,2815,1666,36,132,569,412
"2021","East Suffolk 003","E02006304",6858,4585,3496,3481,15,1,1088,1054,34,2273,1138,58,79,426,572
"2021","East Suffolk 004","E02006305",7491,3656,2105,2069,36,7,1544,1490,54,3835,2369,70,244,849,303
"2021","East Suffolk 005","E02006306",6003,3589,2592,2575,17,3,994,962,32,2414,1314,47,115,470,468
"2021","East Suffolk 007","E02006307",6283,4299,3483,3473,10,7,809,783,26,1984,1066,37,63,312,506
"2021","East Suffolk 006","E02006308",6091,2740,1738,1708,30,4,998,942,56,3351,1932,57,207,780,375
"2021","East Suffolk 009","E02006309",5461,3117,2349,2337,12,4,764,730,34,2344,1224,39,104,476,501
"2021","East Suffolk 008","E02006310",6510,4219,3086,3070,16,6,1127,1083,44,2291,1314,41,106,433,397
"2021","East Suffolk 010","E02006311",6844,3984,3040,3024,16,2,942,898,44,2860,1484,49,134,622,571
"2021","East Suffolk 011","E02006312",7204,4836,3884,3876,8,4,948,920,28,2368,1286,56,85,439,502
"2021","East Suffolk 012","E02006313",8434,5292,4119,4087,32,7,1166,1112,54,3142,1605,75,129,609,724
"2021","East Suffolk 013","E02006314",6054,3801,2920,2900,20,6,875,860,15,2253,1214,46,90,422,481
"2021","East Suffolk 014","E02006315",5010,3188,2522,2500,22,8,658,633,25,1822,889,42,83,361,447
"2021","East Suffolk 015","E02006316",5966,3738,2860,2834,26,4,874,850,24,2228,1078,50,109,423,568
"2021","West Suffolk 002","E02006238",8051,4872,3624,3600,24,4,1244,1180,64,3179,1665,120,191,648,555
"2021","West Suffolk 001","E02006239",6029,4082,3328,3292,36,4,750,740,10,1947,1032,88,147,443,237
"2021","West Suffolk 003","E02006240",7656,5162,3930,3904,26,14,1218,1162,56,2494,1477,100,152,438,327
"2021","West Suffolk 004","E02006241",7185,4218,3230,3209,21,6,982,954,28,2967,1743,83,144,573,424
"2021","West Suffolk 007","E02006242",8327,5738,4153,4105,48,21,1564,1492,72,2589,1605,84,122,475,303
"2021","West Suffolk 008","E02006243",7705,4380,3025,3001,24,7,1348,1304,44,3325,2008,93,133,734,357
"2021","West Suffolk 005","E02006273",5765,3840,3072,3060,12,6,762,734,28,1925,1049,35,90,326,425
"2021","West Suffolk 006","E02006274",4990,3290,2613,2597,16,1,676,658,18,1700,940,43,99,332,286
"2021","West Suffolk 009","E02006275",5596,3120,2170,2156,14,2,948,896,52,2476,1522,56,99,468,331
"2021","West Suffolk 016","E02006276",6655,4516,3572,3546,26,4,940,918,22,2139,1128,53,228,337,393
"2021","West Suffolk 012","E02006277",6113,3947,3072,3048,24,4,871,846,25,2166,1315,41,81,470,259
"2021","West Suffolk 011","E02006278",7212,3691,2611,2567,44,9,1071,1008,63,3521,2124,95,181,699,422
"2021","West Suffolk 014","E02006279",7229,4484,3538,3528,10,10,936,890,46,2745,1501,47,121,530,546
"2021","West Suffolk 010","E02006280",7892,5408,4474,4454,20,12,922,892,30,2484,1357,64,112,411,540
"2021","West Suffolk 013","E02006281",7025,4138,3315,3295,20,5,818,768,50,2887,1559,77,115,526,610
"2021","West Suffolk 017","E02006282",5568,3656,3049,3028,21,6,601,580,21,1912,893,40,86,487,406
"2021","West Suffolk 018","E02006283",5764,4049,3185,3171,14,1,863,830,33,1715,971,40,84,295,325
"2021","West Suffolk 019","E02006284",6168,3840,2786,2766,20,8,1046,1024,22,2328,1315,58,140,450,365
"2021","West Suffolk 021","E02006285",5935,3760,2752,2746,6,0,1008,972,36,2175,1323,48,111,446,247
"2021","West Suffolk 020","E02006286",8796,5268,3773,3759,14,9,1486,1454,32,3528,2044,145,192,684,463
"2021","West Suffolk 015","E02006826",8108,4368,3042,3018,24,8,1318,1238,80,3740,2325,128,155,686,446
"2021","City of London 001","E02000001",7821,3632,2157,1983,174,5,1470,1256,214,4189,3155,223,139,435,237
"2021","Barking and Dagenham 001","E02000002",5938,2806,2220,2220,0,7,579,564,15,3132,2060,167,133,464,308
"2021","Barking and Dagenham 002","E02000003",8825,4398,3600,3586,14,12,786,748,38,4427,2798,438,185,577,429
"2021","Barking and Dagenham 003","E02000004",5144,2776,2221,2217,4,15,540,518,22,2368,1574,104,102,298,290
"2021","Barking and Dagenham 004","E02000005",7986,4213,3377,3368,9,10,826,792,34,3773,2544,258,169,477,325
"2021","Barking and Dagenham 006","E02000007",7374,3302,2543,2535,8,11,748,722,26,4072,2836,202,226,515,293
"2021","Barking and Dagenham 007","E02000008",9843,4834,3665,3619,46,19,1150,1116,34,5009,3287,277,268,755,422
"2021","Barking and Dagenham 008","E02000009",9355,4456,3436,3422,14,23,997,974,23,4899,3398,334,237,586,344
"2021","Barking and Dagenham 009","E02000010",7074,3376,2581,2577,4,17,778,748,30,3698,2452,232,153,525,336
"2021","Barking and Dagenham 010","E02000011",5315,2717,2197,2187,10,10,510,492,18,2598,1725,212,102,320,239
"2021","Barking and Dagenham 011","E02000012",8838,4334,3839,3827,12,11,484,446,38,4504,3097,409,128,352,518
"2021","Barking and Dagenham 012","E02000013",6966,3304,2566,2561,5,11,727,708,19,3662,2388,225,169,539,341
"2021","Barking and Dagenham 013","E02000014",7387,3509,2638,2634,4,18,853,814,39,3878,2526,272,199,538,343
"2021","Barking and Dagenham 014","E02000015",6022,2664,1952,1944,8,18,694,662,32,3358,2237,174,192,531,224
"2021","Barking and Dagenham 015","E02000016",7574,3890,3055,3025,30,15,820,704,116,3684,2540,350,189,474,131
"2021","Barking and Dagenham 016","E02000017",7097,3390,2891,2882,9,14,485,469,16,3707,2421,389,118,502,277
"2021","Barking and Dagenham 017","E02000018",6995,3360,2590,2588,2,14,756,718,38,3635,2458,232,184,458,303
"2021","Barking and Dagenham 018","E02000019",6960,3470,2679,2667,12,17,774,756,18,3490,2425,181,184,446,254
"2021","Barking and Dagenham 019","E02000020",10260,5193,4145,4121,24,19,1029,987,42,5067,3439,431,239,599,359
"2021","Barking and Dagenham 020","E02000021",6269,3011,2301,2295,6,15,695,678,17,3258,2110,205,177,441,325
"2021","Barking and Dagenham 021","E02000022",5387,2513,1894,1885,9,9,610,558,52,2874,2081,167,180,347,99
"2021","Barking and Dagenham 022","E02000023",5546,2573,1966,1956,10,10,597,571,26,2973,2134,184,145,360,150
"2021","Barking and Dagenham 023","E02006799",8716,4496,3629,3619,10,13,854,826,28,4220,2891,291,188,533,317
"2021","Barnet 001","E02000024",8819,5211,4146,4118,28,5,1060,1032,28,3608,2291,155,144,545,473
"2021","Barnet 002","E02000025",6986,3692,2829,2809,20,5,858,828,30,3294,2150,83,155,542,364
"2021","Barnet 003","E02000026",5184,3052,2582,2580,2,10,460,432,28,2132,1352,104,65,308,303
"2021","Barnet 004","E02000027",7627,3955,3241,3227,14,11,703,668,35,3672,2449,137,183,510,393
"2021","Barnet 005","E02000028",5290,3023,2476,2464,12,5,542,528,14,2267,1510,77,93,320,267
"2021","Barnet 006","E02000029",7434,4251,3411,3389,22,9,831,814,17,3183,2171,115,152,465,280
"2021","Barnet 007","E02000030",7617,4569,4046,4030,16,19,504,472,32,3048,1926,168,115,419,420
"2021","Barnet 008","E02000031",6647,3989,3365,3351,14,11,613,575,38,2658,1705,115,89,397,352
"2021","Barnet 009","E02000032",6414,3868,3469,3441,28,13,386,364,22,2546,1702,112,77,275,380
"2021","Barnet 010","E02000033",7099,3737,3025,3009,16,9,703,663,40,3362,2305,113,146,467,331
"2021","Barnet 011","E02000034",7237,4009,3297,3281,16,11,701,677,24,3228,2122,177,135,463,331
"2021","Barnet 012","E02000035",6787,3702,2966,2954,12,10,726,686,40,3085,1917,234,127,485,322
"2021","Barnet 013","E02000036",8595,4714,4206,4200,6,12,496,476,20,3881,2470,215,234,498,464
"2021","Barnet 014","E02000037",8211,4960,4496,4494,2,18,446,424,22,3251,2210,163,96,358,424
"2021","Barnet 015","E02000038",8389,4570,3726,3702,24,12,832,774,58,3819,2608,174,181,521,335
"2021","Barnet 016","E02000039",5651,3362,2944,2934,10,14,404,384,20,2289,1483,142,93,307,264
"2021","Barnet 017","E02000040",7007,3899,3236,3214,22,5,658,628,30,3108,2037,147,132,453,339
"2021","Barnet 018","E02000041",7407,3936,3438,3432,6,8,490,466,24,3471,2239,273,157,439,363
"2021","Barnet 019","E02000042",9200,4799,3812,3783,29,11,976,926,50,4401,2944,245,137,654,421
"2021","Barnet 020","E02000043",5816,3688,3236,3210,26,8,444,410,34,2128,1409,134,84,252,249
"2021","Barnet 021","E02000044",6875,3334,2772,2762,10,14,548,514,34,3541,2363,281,173,428,296
"2021","Barnet 022","E02000045",8241,3997,3058,3042,16,22,917,862,55,4244,2926,164,188,671,295
"2021","Barnet 023","E02000046",5698,3198,2397,2359,38,9,792,726,66,2500,1710,139,88,346,217
"2021","Barnet 024","E02000047",9520,4366,3673,3653,20,15,678,650,28,5154,3385,529,214,621,405
"2021","Barnet 025","E02000048",8086,4681,4042,4016,26,20,619,582,37,3405,2168,179,151,505,402
"2021","Barnet 026","E02000049",8020,3519,2787,2780,7,10,722,690,32,4501,3121,317,234,566,263
"2021","Barnet 027","E02000050",8339,4214,3391,3367,24,43,780,716,64,4125,2902,178,153,528,364
"2021","Barnet 028","E02000051",7449,4162,3453,3437,16,13,696,660,36,3287,2082,171,87,482,465
"2021","Barnet 029","E02000052",7972,4284,3155,3093,62,11,1118,1026,92,3688,2504,156,149,567,312
"2021","Barnet 031","E02000054",6185,3061,2424,2420,4,10,627,572,55,3124,2068,221,131,483,221
"2021","Barnet 032","E02000055",9388,4464,3682,3672,10,14,768,716,52,4924,3443,375,155,562,389
"2021","Barnet 033","E02000056",7124,4382,3912,3892,20,12,458,426,32,2742,1720,173,80,353,416
"2021","Barnet 034","E02000057",5887,3068,2685,2679,6,7,376,354,22,2819,1911,248,87,308,265
"2021","Barnet 035","E02000058",7959,4384,3790,3768,22,10,584,500,84,3575,2254,197,125,561,438
"2021","Barnet 036","E02000059",9617,4882,3863,3826,37,17,1002,936,66,4735,3218,401,199,547,370
"2021","Barnet 037","E02000060",7852,4199,3793,3787,6,4,402,362,40,3653,2457,285,140,396,375
"2021","Barnet 038","E02000061",6770,3536,2835,2813,22,5,696,640,56,3234,2168,259,113,420,274
"2021","Barnet 039","E02000062",5445,2361,1848,1838,10,10,503,454,49,3084,2093,241,179,375,196
"2021","Barnet 040","E02000063",6012,2844,2261,2249,12,17,566,522,44,3168,2174,222,153,398,221
"2021","Barnet 041","E02000064",5252,2369,1833,1815,18,6,530,486,44,2883,1996,161,130,374,222
"2021","Barnet 042","E02006953",6910,3710,2614,2562,52,14,1082,1034,48,3200,2362,236,140,352,110
"2021","Barnet 043","E02006954",8015,4053,3240,3228,12,11,802,750,52,3962,2772,416,131,376,267
"2021","Bexley 001","E02000065",5890,2656,2022,2022,0,10,624,578,46,3234,2146,250,191,479,168
"2021","Bexley 002","E02000066",7208,3048,2251,2243,8,17,780,736,44,4160,2744,239,257,625,295
"2021","Bexley 003","E02000067",7901,3906,2739,2721,18,19,1148,1060,88,3995,2645,203,215,599,333
"2021","Bexley 004","E02000068",6020,2818,2042,2018,24,16,760,716,44,3202,2124,149,173,463,293
"2021","Bexley 005","E02000069",5649,3109,2309,2301,8,4,796,762,34,2540,1610,108,114,380,328
"2021","Bexley 006","E02000070",6553,3890,3217,3207,10,13,660,634,26,2663,1623,103,128,373,436
"2021","Bexley 007","E02000071",5979,3288,2546,2530,16,14,728,710,18,2691,1781,93,99,387,331
"2021","Bexley 008","E02000072",9484,4685,3390,3381,9,23,1272,1230,42,4799,3221,240,267,689,382
"2021","Bexley 009","E02000073",8707,5479,4633,4627,6,9,837,798,39,3228,2108,105,128,375,512
"2021","Bexley 010","E02000074",6831,3378,2457,2443,14,15,906,874,32,3453,2252,94,189,565,353
"2021","Bexley 011","E02000075",6608,4138,3492,3476,16,2,644,616,28,2470,1512,66,95,333,464
"2021","Bexley 013","E02000077",6497,3846,3114,3104,10,18,714,700,14,2651,1784,100,95,347,325
"2021","Bexley 014","E02000078",6340,4014,3154,3148,6,4,856,814,42,2326,1489,92,90,305,350
"2021","Bexley 015","E02000079",6909,4014,3085,3075,10,5,924,894,30,2895,1766,105,105,455,464
"2021","Bexley 016","E02000080",8087,4710,3825,3811,14,11,874,846,28,3377,2187,133,141,407,509
"2021","Bexley 017","E02000081",6568,3840,3075,3063,12,9,756,732,24,2728,1690,83,101,416,438
"2021","Bexley 018","E02000082",7456,4604,3759,3745,14,9,836,816,20,2852,1870,86,118,349,429
"2021","Bexley 019","E02000083",8862,4994,3544,3536,8,14,1436,1384,52,3868,2539,102,177,620,430
"2021","Bexley 020","E02000084",8932,5668,4612,4600,12,6,1050,1010,40,3264,2110,80,125,436,513
"2021","Bexley 021","E02000085",6380,3840,2946,2926,20,10,884,860,24,2540,1625,68,104,349,394
"2021","Bexley 022","E02000086",5846,3702,2986,2968,18,0,716,698,18,2144,1381,44,96,298,325
"2021","Bexley 023","E02000087",6714,4284,3400,3390,10,12,872,844,28,2430,1492,68,82,347,441
"2021","Bexley 024","E02000088",6268,3982,3181,3154,27,14,787,767,20,2286,1472,54,94,295,371
"2021","Bexley 025","E02000089",6225,4022,3315,3299,16,15,692,666,26,2203,1488,39,80,246,350
"2021","Bexley 026","E02000090",7729,4089,2867,2841,26,7,1215,1146,69,3640,2406,87,153,520,474
"2021","Bexley 027","E02000091",8345,4672,3686,3660,26,6,980,944,36,3673,2187,90,143,587,666
"2021","Bexley 028","E02000092",5241,2654,2021,2009,12,17,616,590,26,2587,1692,42,141,432,280
"2021","Bexley 029","E02006785",5398,3016,2455,2445,10,5,556,530,26,2382,1471,129,105,319,358
"2021","Brent 001","E02000093",9730,5120,4454,4446,8,16,650,622,28,4610,3017,557,150,418,468
"2021","Brent 002","E02000094",8397,4253,3598,3586,12,18,637,612,25,4144,2840,412,172,370,350
"2021","Brent 003","E02000095",8594,4522,4095,4087,8,17,410,384,26,4072,2592,572,117,376,415
"2021","Brent 004","E02000096",6228,3679,3444,3432,12,6,229,220,9,2549,1561,263,57,251,417
"2021","Brent 005","E02000097",7755,4050,3578,3566,12,10,462,440,22,3705,2390,385,100,451,379
"2021","Brent 006","E02000098",7032,3468,3066,3052,14,8,394,374,20,3564,2391,318,122,368,365
"2021","Brent 007","E02000099",7537,3842,3322,3314,8,8,512,490,22,3695,2384,492,154,389,276
"2021","Brent 008","E02000100",6795,3543,3175,3169,6,16,352,320,32,3252,2084,381,87,293,407
"2021","Brent 009","E02000101",7742,3526,3002,2990,12,32,492,468,24,4216,2851,350,206,472,337
"2021","Brent 010","E02000102",6217,2893,2414,2404,10,12,467,453,14,3324,2281,263,142,363,275
"2021","Brent 011","E02000103",7703,3471,2896,2882,14,4,571,531,40,4232,2929,349,209,437,308
"2021","Brent 012","E02000104",6154,2894,2500,2498,2,6,388,364,24,3260,2202,321,111,351,275
"2021","Brent 013","E02000105",7810,3935,3436,3418,18,15,484,446,38,3875,2454,461,180,435,345
"2021","Brent 014","E02000106",8245,3539,2878,2864,14,8,653,595,58,4706,3038,550,200,588,330
"2021","Brent 015","E02000107",9050,3865,2821,2796,25,8,1036,952,84,5185,3565,484,217,585,334
"2021","Brent 016","E02000108",5827,2934,2574,2568,6,2,358,344,14,2893,1867,411,88,274,253
"2021","Brent 018","E02000110",6758,3148,2406,2362,44,2,740,666,74,3610,2612,203,129,381,285
"2021","Brent 019","E02000111",8907,4472,4069,4053,16,8,395,381,14,4435,2827,768,108,350,382
"2021","Brent 020","E02000112",9613,4712,4065,4053,12,11,636,588,48,4901,3002,997,139,340,423
"2021","Brent 021","E02000113",7428,2524,2122,2120,2,16,386,360,26,4904,3451,296,217,574,366
"2021","Brent 022","E02000114",7598,3148,2200,2170,30,8,940,882,58,4450,3263,290,176,441,280
"2021","Brent 023","E02000115",7174,3154,2016,1978,38,14,1124,1038,86,4020,2931,201,145,462,281
"2021","Brent 024","E02000116",6640,2740,2116,2100,16,10,614,566,48,3900,2686,299,176,475,264
"2021","Brent 025","E02000117",9636,3450,2798,2788,10,18,634,602,32,6186,4290,359,385,767,385
"2021","Brent 026","E02000118",9252,4568,4011,4005,6,10,547,512,35,4684,2943,840,116,352,433
"2021","Brent 027","E02000119",7983,2932,2230,2218,12,10,692,652,40,5051,3446,401,241,652,311
"2021","Brent 028","E02000120",7609,3350,2029,1987,42,15,1306,1210,96,4259,3187,195,173,492,212
"2021","Brent 029","E02000121",9841,4935,4309,4291,18,6,620,582,38,4906,3152,852,142,318,442
"2021","Brent 030","E02000122",6675,3072,2361,2333,28,17,694,648,46,3603,2439,255,162,455,292
"2021","Brent 031","E02000123",10775,3851,2803,2772,31,12,1036,946,90,6924,4823,434,347,889,431
"2021","Brent 032","E02000124",8100,3924,2711,2667,44,17,1196,1094,102,4176,3043,178,170,546,239
"2021","Brent 033","E02000125",8066,3732,2758,2734,24,6,968,896,72,4334,3160,196,170,475,333
"2021","Brent 034","E02000126",6528,2380,1689,1631,58,13,678,618,60,4148,3001,214,257,481,195
"2021","Brent 035","E02006955",5314,2900,2055,2041,14,9,836,762,74,2414,1773,288,80,191,82
"2021","Brent 036","E02006956",6444,3204,2670,2656,14,6,528,488,40,3240,2096,452,127,288,277
"2021","Bromley 001","E02000127",7192,3562,2551,2524,27,20,991,947,44,3630,2360,111,216,595,348
"2021","Bromley 002","E02000128",6017,3800,2951,2933,18,5,844,816,28,2217,1390,67,100,340,320
"2021","Bromley 004","E02000130",6816,3820,2735,2671,64,9,1076,990,86,2996,2130,85,140,399,242
"2021","Bromley 005","E02000131",8633,4412,2292,2202,90,6,2114,1862,252,4221,3213,107,186,528,187
"2021","Bromley 006","E02000132",8185,4429,2905,2810,95,12,1512,1426,86,3756,2470,111,145,655,375
"2021","Bromley 007","E02000133",8593,5749,4797,4771,26,11,941,900,41,2844,1725,86,110,419,504
"2021","Bromley 008","E02000134",9362,5234,3655,3603,52,11,1568,1472,96,4128,2788,139,197,651,353
"2021","Bromley 009","E02000135",7817,3163,1983,1937,46,10,1170,1070,100,4654,3391,118,230,675,240
"2021","Bromley 010","E02000136",4519,2644,2170,2152,18,10,464,450,14,1875,1152,57,77,245,344
"2021","Bromley 011","E02000137",6695,4153,3124,3092,32,6,1023,967,56,2542,1588,65,130,446,313
"2021","Bromley 012","E02000138",7228,4322,3226,3176,50,14,1082,1010,72,2906,1595,98,137,541,535
"2021","Bromley 013","E02000139",6085,3687,2646,2602,44,11,1030,960,70,2398,1636,66,113,357,226
"2021","Bromley 014","E02000140",6568,3236,2392,2386,6,2,842,818,24,3332,2317,92,154,488,281
"2021","Bromley 015","E02000141",5792,3141,2140,2098,42,4,997,946,51,2651,1840,85,108,399,219
"2021","Bromley 016","E02000142",6869,4276,3363,3333,30,5,908,858,50,2593,1700,97,112,352,332
"2021","Bromley 018","E02000144",8069,4907,3662,3628,34,12,1233,1161,72,3162,2136,149,124,415,338
"2021","Bromley 019","E02000145",6680,3313,2361,2357,4,15,937,866,71,3367,2220,96,174,506,371
"2021","Bromley 020","E02000146",7570,4500,3306,3262,44,10,1184,1120,64,3070,1938,94,136,540,362
"2021","Bromley 021","E02000147",6563,4294,3769,3733,36,3,522,497,25,2269,1486,70,66,276,371
"2021","Bromley 022","E02000148",5404,3494,2996,2978,18,4,494,476,18,1910,1149,60,69,283,349
"2021","Bromley 023","E02000149",6502,3726,2782,2750,32,14,930,884,46,2776,1839,77,110,415,335
"2021","Bromley 024","E02000150",6649,4108,3455,3441,14,15,638,616,22,2541,1661,61,100,354,365
"2021","Bromley 025","E02000151",6005,4230,3678,3660,18,4,548,534,14,1775,1058,58,47,262,350
"2021","Bromley 026","E02000152",6121,3228,2495,2475,20,9,724,702,22,2893,1900,62,122,465,344
"2021","Bromley 027","E02000153",6380,4241,3678,3664,14,9,554,540,14,2139,1432,45,81,262,319
"2021","Bromley 028","E02000154",6980,4322,3490,3470,20,12,820,790,30,2658,1667,89,115,384,403
"2021","Bromley 029","E02000155",5971,3532,2836,2818,18,2,694,656,38,2439,1403,77,87,410,462
"2021","Bromley 030","E02000156",10021,6327,5450,5416,34,13,864,838,26,3694,2224,106,140,521,703
"2021","Bromley 031","E02000157",6743,4484,3920,3906,14,4,560,542,18,2259,1415,46,67,283,448
"2021","Bromley 032","E02000158",6123,3703,3105,3095,10,10,588,570,18,2420,1534,56,99,323,408
"2021","Bromley 033","E02000159",5905,3713,3088,3080,8,13,612,588,24,2192,1370,71,72,292,387
"2021","Bromley 034","E02000160",6462,4155,3509,3491,18,10,636,614,22,2307,1526,44,71,312,354
"2021","Bromley 035","E02000161",6866,4561,3939,3932,7,10,612,594,18,2305,1442,62,71,326,404
"2021","Bromley 036","E02000162",5714,3332,2754,2750,4,0,578,556,22,2382,1350,77,99,405,451
"2021","Bromley 037","E02000163",6299,4096,3493,3471,22,11,592,580,12,2203,1303,81,83,347,389
"2021","Bromley 039","E02000165",5781,3667,2816,2800,16,14,837,807,30,2114,1374,58,101,338,243
"2021","Bromley 040","E02006782",6461,3592,2890,2861,29,17,685,650,35,2869,1871,114,140,408,336
"2021","Bromley 041","E02006787",6147,3814,3067,3039,28,21,726,698,28,2333,1527,82,75,355,294
"2021","Bromley 042","E02006789",5662,3609,2932,2926,6,6,671,644,27,2053,1244,45,71,284,409
"2021","Camden 001","E02000166",6494,3016,2221,2165,56,7,788,718,70,3478,2462,119,130,482,285
"2021","Camden 002","E02000167",5989,3548,2726,2662,64,3,819,746,73,2441,1628,137,87,344,245
"2021","Camden 003","E02000168",6546,3138,2049,2003,46,7,1082,1004,78,3408,2615,104,111,399,179
"2021","Camden 004","E02000169",5747,3497,2818,2772,46,3,676,634,42,2250,1469,125,97,344,215
"2021","Camden 005","E02000170",6546,3364,2402,2376,26,8,954,884,70,3182,2347,115,109,391,220
"2021","Camden 006","E02000171",6180,3000,2035,1985,50,3,962,876,86,3180,2312,115,109,429,215
"2021","Camden 007","E02000172",7752,3028,2019,1979,40,15,994,934,60,4724,3569,135,182,521,317
"2021","Camden 008","E02000173",6122,3257,2412,2370,42,6,839,792,47,2865,2053,156,99,366,191
"2021","Camden 009","E02000174",6736,2767,1684,1628,56,13,1070,980,90,3969,3076,132,108,453,200
"2021","Camden 010","E02000175",7714,3541,2196,2156,40,17,1328,1238,90,4173,3291,148,125,427,182
"2021","Camden 011","E02000176",4913,2656,1878,1824,54,6,772,720,52,2257,1598,102,69,347,141
"2021","Camden 012","E02000177",7009,2672,1718,1680,38,6,948,852,96,4337,3203,164,176,511,283
"2021","Camden 013","E02000178",7551,3164,1838,1788,50,8,1318,1194,124,4387,3304,189,188,484,222
"2021","Camden 014","E02000179",4690,2222,1652,1620,32,2,568,512,56,2468,1774,98,107,306,183
"2021","Camden 015","E02000180",6698,2699,1629,1561,68,4,1066,954,112,3999,3155,138,119,400,187
"2021","Camden 016","E02000181",6832,3580,2294,2218,76,10,1276,1174,102,3252,2517,128,82,378,147
"2021","Camden 017","E02000182",5758,2766,2160,2120,40,8,598,550,48,2992,2112,202,113,340,225
"2021","Camden 018","E02000183",6423,2966,2084,2052,32,12,870,798,72,3457,2432,137,134,536,218
"2021","Camden 019","E02000184",7052,2384,1600,1528,72,2,782,696,86,4668,3733,157,143,425,210
"2021","Camden 020","E02000185",7262,2697,1882,1850,32,20,795,724,71,4565,3219,192,231,619,304
"2021","Camden 021","E02000186",5269,2033,1280,1217,63,7,746,682,64,3236,2512,141,94,326,163
"2021","Camden 022","E02000187",7442,2588,1846,1814,32,12,730,660,70,4854,3748,195,198,454,259
"2021","Camden 023","E02000188",5581,1922,1392,1358,34,10,520,460,60,3659,2819,175,136,304,225
"2021","Camden 026","E02000191",3484,1204,734,654,80,2,468,400,68,2280,1821,95,62,196,106
"2021","Camden 027","E02000192",5647,2123,1402,1333,69,3,718,586,132,3524,2674,167,118,380,185
"2021","Camden 028","E02000193",5055,1692,1047,929,118,5,640,542,98,3363,2610,179,87,328,159
"2021","Camden 029","E02007115",8049,2592,1724,1662,62,14,854,724,130,5457,4134,263,179,589,292
"2021","Croydon 001","E02000194",7326,3691,2228,2150,78,17,1446,1328,118,3635,2594,127,165,517,232
"2021","Croydon 002","E02000195",7703,4108,3355,3325,30,7,746,706,40,3595,2401,252,144,429,369
"2021","Croydon 003","E02000196",6393,2934,2346,2326,20,12,576,544,32,3459,2336,257,126,402,338
"2021","Croydon 004","E02000197",7295,3422,2687,2659,28,11,724,678,46,3873,2589,264,193,485,342
"2021","Croydon 005","E02000198",6968,2861,2090,2070,20,18,753,704,49,4107,2840,207,213,606,241
"2021","Croydon 006","E02000199",6735,3075,2241,2211,30,12,822,770,52,3660,2513,204,174,540,229
"2021","Croydon 007","E02000200",7223,3432,2285,2251,34,13,1134,1072,62,3791,2642,169,187,558,235
"2021","Croydon 008","E02000201",6769,2798,1879,1857,22,13,906,810,96,3971,2799,163,184,579,246
"2021","Croydon 009","E02000202",7059,3234,2756,2704,52,10,468,428,40,3825,2606,269,161,456,333
"2021","Croydon 010","E02000203",6179,2576,1948,1934,14,34,594,552,42,3603,2458,196,234,463,252
"2021","Croydon 011","E02000204",7558,3326,2838,2822,16,10,478,438,40,4232,2812,336,225,487,372
"2021","Croydon 013","E02000206",8207,3401,2240,2212,28,11,1150,1088,62,4806,3347,260,243,682,274
"2021","Croydon 014","E02000207",7198,2954,2050,2034,16,10,894,856,38,4244,3069,159,202,576,238
"2021","Croydon 015","E02000208",8011,3280,2574,2560,14,14,692,646,46,4731,3277,295,291,604,264
"2021","Croydon 016","E02000209",6998,3292,2836,2831,5,6,450,430,20,3706,2602,266,161,411,266
"2021","Croydon 017","E02000210",6932,3484,2533,2501,32,15,936,874,62,3448,2439,152,152,458,247
"2021","Croydon 018","E02000211",6822,3934,3175,3163,12,7,752,738,14,2888,1781,89,126,472,420
"2021","Croydon 019","E02000212",7132,3221,2606,2594,12,12,603,578,25,3911,2701,305,176,433,296
"2021","Croydon 020","E02000213",9789,4258,2922,2896,26,14,1322,1232,90,5531,3964,327,272,681,287
"2021","Croydon 021","E02000214",5085,2992,2478,2469,9,10,504,476,28,2093,1445,84,68,243,253
"2021","Croydon 022","E02000215",9507,4668,3078,3020,58,10,1580,1456,124,4839,3323,236,236,719,325
"2021","Croydon 023","E02000216",5666,3314,2697,2683,14,5,612,576,36,2352,1480,130,87,353,302
"2021","Croydon 024","E02000217",9313,4408,2978,2924,54,8,1422,1332,90,4905,3480,236,262,620,307
"2021","Croydon 025","E02000218",5125,2532,2132,2108,24,10,390,378,12,2593,1799,97,122,302,273
"2021","Croydon 026","E02000219",6424,3924,3383,3357,26,7,534,506,28,2500,1578,90,82,291,459
"2021","Croydon 028","E02000221",8164,3772,2963,2951,12,19,790,756,34,4392,3043,207,190,611,341
"2021","Croydon 029","E02000222",6658,3818,2610,2576,34,8,1200,1116,84,2840,1973,116,136,391,224
"2021","Croydon 030","E02000223",6017,2350,1739,1735,4,19,592,562,30,3667,2625,110,204,427,301
"2021","Croydon 031","E02000224",6346,3510,2578,2552,26,10,922,882,40,2836,2002,95,148,385,206
"2021","Croydon 032","E02000225",5825,2884,2231,2215,16,13,640,618,22,2941,1998,103,130,395,315
"2021","Croydon 033","E02000226",6147,3893,3435,3413,22,11,447,426,21,2254,1421,83,77,304,369
"2021","Croydon 034","E02000227",9378,5002,3814,3796,18,14,1174,1140,34,4376,2765,116,216,751,528
"2021","Croydon 035","E02000228",6304,4244,3789,3773,16,9,446,426,20,2060,1258,80,81,250,391
"2021","Croydon 036","E02000229",4656,2054,1550,1546,4,6,498,488,10,2602,1839,68,100,348,247
"2021","Croydon 037","E02000230",8305,4795,3895,3859,36,13,887,834,53,3510,2328,149,141,457,435
"2021","Croydon 038","E02000231",6322,4010,3535,3511,24,9,466,444,22,2312,1567,125,68,223,329
"2021","Croydon 039","E02000232",5051,3047,2600,2594,6,5,442,430,12,2004,1234,66,70,252,382
"2021","Croydon 040","E02000233",4873,2946,2252,2234,18,10,684,652,32,1927,1314,65,87,266,195
"2021","Croydon 041","E02000234",7314,4273,3390,3358,32,15,868,832,36,3041,2002,97,129,458,355
"2021","Croydon 042","E02000235",5518,3528,2897,2875,22,11,620,596,24,1990,1292,48,93,318,239
"2021","Croydon 043","E02000236",7042,4666,3821,3795,26,5,840,808,32,2376,1572,66,70,363,305
"2021","Croydon 044","E02000237",6110,3894,3208,3184,24,10,676,646,30,2216,1315,62,68,346,425
"2021","Croydon 045","E02006788",5924,2680,1916,1896,20,8,756,726,30,3244,2349,94,149,425,227
"2021","Croydon 046","E02006987",6218,3065,1651,1605,46,4,1410,1272,138,3153,2340,163,176,383,91
"2021","Croydon 047","E02006988",5535,2650,1709,1685,24,11,930,856,74,2885,2003,135,156,417,174
"2021","Ealing 001","E02000238",8610,4342,3551,3547,4,11,780,734,46,4268,2781,507,162,483,335
"2021","Ealing 002","E02000239",7455,4029,3454,3446,8,11,564,542,22,3426,2189,373,110,382,372
"2021","Ealing 003","E02000240",8713,4187,3490,3484,6,18,679,648,31,4526,3022,344,186,608,366
"2021","Ealing 004","E02000241",5910,3056,2538,2520,18,14,504,464,40,2854,1933,232,97,343,249
"2021","Ealing 005","E02000242",5641,2978,2550,2547,3,8,420,384,36,2663,1764,259,113,288,239
"2021","Ealing 006","E02000243",7050,3393,2825,2813,12,12,556,538,18,3657,2407,231,158,498,363
"2021","Ealing 007","E02000244",6380,3274,2672,2666,6,12,590,546,44,3106,2071,303,118,375,239
"2021","Ealing 008","E02000245",6930,3169,2653,2649,4,12,504,478,26,3761,2583,244,202,482,250
"2021","Ealing 009","E02000246",7184,3389,2879,2875,4,21,489,464,25,3795,2626,224,153,479,313
"2021","Ealing 010","E02000247",8463,4142,3462,3442,20,8,672,644,28,4321,2943,260,207,564,347
"2021","Ealing 011","E02000248",6142,3090,2470,2454,16,10,610,570,40,3052,1958,303,143,407,241
"2021","Ealing 012","E02000249",6629,3181,2652,2648,4,11,518,490,28,3448,2196,323,137,436,356
"2021","Ealing 013","E02000250",5143,3063,2558,2538,20,9,496,476,20,2080,1356,86,55,329,254
"2021","Ealing 014","E02000251",6635,3440,3109,3105,4,11,320,308,12,3195,2005,335,100,403,352
"2021","Ealing 015","E02000252",8507,3476,2457,2441,16,21,998,910,88,5031,3684,310,203,557,277
"2021","Ealing 016","E02000253",7975,3546,2893,2877,16,13,640,608,32,4429,2993,200,177,669,390
"2021","Ealing 017","E02000254",7403,3842,3618,3612,6,9,215,201,14,3561,2217,472,111,334,427
"2021","Ealing 018","E02000255",7745,4037,3185,3155,30,2,850,784,66,3708,2606,188,152,470,292
"2021","Ealing 019","E02000256",7721,4243,3024,2998,26,20,1199,1110,89,3478,2365,200,149,464,300
"2021","Ealing 021","E02000258",5430,2708,2121,2103,18,3,584,546,38,2722,1933,157,107,334,191
"2021","Ealing 022","E02000259",5158,2840,2259,2245,14,19,562,532,30,2318,1580,115,123,291,209
"2021","Ealing 023","E02000260",7654,3792,3569,3557,12,5,218,194,24,3862,2182,713,123,368,476
"2021","Ealing 024","E02000261",10356,4498,3149,3089,60,9,1340,1236,104,5858,4311,360,193,637,357
"2021","Ealing 025","E02000262",7503,3595,2434,2396,38,31,1130,1054,76,3908,2747,210,135,589,227
"2021","Ealing 026","E02000263",10834,5167,4826,4821,5,11,330,306,24,5667,3263,1202,156,419,627
"2021","Ealing 027","E02000264",7163,3492,2557,2511,46,9,926,860,66,3671,2741,180,117,387,246
"2021","Ealing 028","E02000265",8959,4332,3090,3048,42,12,1230,1108,122,4627,3259,171,212,657,328
"2021","Ealing 029","E02000266",10077,4569,3904,3888,16,16,649,614,35,5508,3679,514,228,602,485
"2021","Ealing 030","E02000267",6406,3407,2429,2395,34,13,965,900,65,2999,2131,170,109,362,227
"2021","Ealing 031","E02000268",7695,3959,2924,2880,44,18,1017,936,81,3736,2664,161,144,466,301
"2021","Ealing 032","E02000269",6546,3886,3004,2944,60,10,872,788,84,2660,1931,107,79,311,232
"2021","Ealing 033","E02000270",7766,3740,2422,2364,58,6,1312,1166,146,4026,2950,196,159,490,231
"2021","Ealing 034","E02000271",5629,3460,2671,2607,64,15,774,716,58,2169,1514,94,62,313,186
"2021","Ealing 035","E02000272",5304,3086,2541,2503,38,11,534,496,38,2218,1511,96,63,272,276
"2021","Ealing 038","E02000275",6470,3293,3080,3079,1,7,206,192,14,3177,1903,559,101,277,337
"2021","Ealing 039","E02000276",5418,3009,2207,2155,52,7,795,736,59,2409,1734,84,73,320,198
"2021","Ealing 040","E02006791",6322,3448,2316,2254,62,10,1122,1036,86,2874,2122,127,98,355,172
"2021","Ealing 041","E02006968",6818,3661,2900,2864,36,10,751,688,63,3157,2187,220,123,346,281
"2021","Ealing 042","E02006969",5313,2849,1862,1834,28,8,979,900,79,2464,1716,169,75,335,169
"2021","Ealing 043","E02006970",5640,2935,2713,2705,8,7,215,193,22,2705,1651,517,99,218,220
"2021","Ealing 044","E02006971",6496,3247,3028,3026,2,2,217,200,17,3249,1977,560,91,262,359
"2021","Enfield 001","E02000277",5676,2580,2094,2086,8,10,476,460,16,3096,2119,153,156,385,283
"2021","Enfield 002","E02000278",7073,2962,2443,2434,9,12,507,481,26,4111,2810,175,211,574,341
"2021","Enfield 003","E02000279",9062,3917,2855,2843,12,14,1048,996,52,5145,3587,209,320,728,301
"2021","Enfield 004","E02000280",6689,3658,2876,2860,16,6,776,742,34,3031,1972,62,137,476,384
"2021","Enfield 005","E02000281",7295,3444,2686,2666,20,16,742,712,30,3851,2658,182,166,571,274
"2021","Enfield 006","E02000282",7096,2843,2357,2357,0,16,470,444,26,4253,2930,172,241,634,276
"2021","Enfield 007","E02000283",6467,2906,2473,2473,0,15,418,396,22,3561,2486,141,180,478,276
"2021","Enfield 008","E02000284",6891,3760,2883,2857,26,13,864,804,60,3131,2025,115,137,533,321
"2021","Enfield 009","E02000285",5374,3266,2800,2786,14,12,454,434,20,2108,1374,72,67,293,302
"2021","Enfield 010","E02000286",7023,3942,3101,3085,16,11,830,778,52,3081,1856,96,119,548,462
"2021","Enfield 011","E02000287",5938,3540,3107,3101,6,9,424,400,24,2398,1456,131,90,333,388
"2021","Enfield 012","E02000288",9477,4148,3545,3539,6,17,586,564,22,5329,3680,321,317,599,412
"2021","Enfield 013","E02000289",5470,3344,2951,2939,12,13,380,368,12,2126,1365,107,79,265,310
"2021","Enfield 014","E02000290",4843,1973,1561,1555,6,13,399,379,20,2870,1995,116,173,401,185
"2021","Enfield 015","E02000291",7862,3886,2877,2845,32,17,992,944,48,3976,2633,168,221,594,360
"2021","Enfield 016","E02000292",7597,3774,3102,3082,20,18,654,636,18,3823,2547,155,184,539,398
"2021","Enfield 017","E02000293",5204,3274,2845,2835,10,11,418,404,14,1930,1227,77,71,242,313
"2021","Enfield 018","E02000294",7131,3161,2709,2709,0,15,437,418,19,3970,2631,235,221,525,358
"2021","Enfield 019","E02000295",6812,3754,3177,3163,14,11,566,536,30,3058,1955,145,128,448,382
"2021","Enfield 020","E02000296",8094,4236,3404,3374,30,22,810,770,40,3858,2487,216,171,538,446
"2021","Enfield 021","E02000297",7666,4502,3906,3884,22,6,590,566,24,3164,1978,135,115,455,481
"2021","Enfield 022","E02000298",6583,3970,3400,3378,22,8,562,522,40,2613,1662,193,81,346,331
"2021","Enfield 023","E02000299",7088,3018,2421,2419,2,17,580,552,28,4070,2707,242,223,565,333
"2021","Enfield 024","E02000300",6676,2902,2405,2393,12,11,486,470,16,3774,2513,282,181,512,286
"2021","Enfield 025","E02000301",7732,3028,2446,2434,12,16,566,544,22,4704,3150,247,281,706,320
"2021","Enfield 026","E02000302",6981,3547,2928,2920,8,19,600,582,18,3434,2182,246,184,425,397
"2021","Enfield 027","E02000303",6457,2615,2123,2115,8,17,475,444,31,3842,2576,246,220,512,288
"2021","Enfield 028","E02000304",6452,3975,3441,3422,19,56,478,450,28,2477,1599,131,83,322,342
"2021","Enfield 029","E02000305",7152,4039,3077,3055,22,17,945,883,62,3113,2039,173,135,517,249
"2021","Enfield 030","E02000306",6821,2608,2046,2042,4,28,534,500,34,4213,2829,212,263,643,266
"2021","Enfield 031","E02000307",7812,3828,3289,3284,5,27,512,480,32,3984,2706,212,227,478,361
"2021","Enfield 032","E02000308",7032,3356,2550,2524,26,14,792,752,40,3676,2551,213,145,474,293
"2021","Enfield 033","E02000309",8748,3646,2978,2976,2,20,648,618,30,5102,3367,385,275,669,406
"2021","Enfield 035","E02000311",8501,4084,3307,3293,14,11,766,672,94,4417,2925,309,234,539,410
"2021","Enfield 036","E02000312",9277,4717,3475,3439,36,12,1230,1144,86,4560,3143,242,199,582,394
"2021","Enfield 037","E02006793",7251,2898,2377,2375,2,15,506,484,22,4353,2947,304,204,606,292
"2021","Greenwich 001","E02000313",4857,1847,1375,1373,2,6,466,452,14,3010,1913,174,246,502,175
"2021","Greenwich 002","E02000314",9257,4225,3205,3187,18,14,1006,962,44,5032,3344,359,409,671,249
"2021","Greenwich 003","E02000315",7243,3038,2284,2268,16,10,744,702,42,4205,2807,309,250,557,282
"2021","Greenwich 005","E02000317",5717,2428,1735,1715,20,5,688,622,66,3289,2285,207,178,422,197
"2021","Greenwich 006","E02000318",8706,3920,3238,3210,28,14,668,608,60,4786,2888,788,257,519,334
"2021","Greenwich 007","E02000319",8268,3854,2725,2681,44,17,1112,1042,70,4414,2921,345,236,600,312
"2021","Greenwich 008","E02000320",5389,2670,1960,1944,16,6,704,654,50,2719,1855,186,122,348,208
"2021","Greenwich 009","E02000321",5930,2422,1692,1675,17,13,717,677,40,3508,2321,263,192,462,270
"2021","Greenwich 011","E02000323",9876,4326,3026,2988,38,20,1280,1190,90,5550,3779,416,295,762,298
"2021","Greenwich 012","E02000324",6052,2780,1961,1931,30,17,802,728,74,3272,2280,184,145,424,239
"2021","Greenwich 014","E02000326",6268,3048,2163,2111,52,3,882,802,80,3220,2311,112,142,435,220
"2021","Greenwich 015","E02000327",5028,2173,1537,1521,16,9,627,570,57,2855,1988,157,181,391,138
"2021","Greenwich 016","E02000328",5313,2968,2057,2021,36,17,894,832,62,2345,1597,90,113,327,218
"2021","Greenwich 017","E02000329",5023,2519,1963,1937,26,11,545,509,36,2504,1615,133,119,356,281
"2021","Greenwich 019","E02000331",6420,3138,2245,2219,26,7,886,816,70,3282,2289,170,142,423,258
"2021","Greenwich 020","E02000332",5885,3264,2439,2391,48,11,814,746,68,2621,1712,140,125,376,268
"2021","Greenwich 021","E02000333",5055,2965,2118,2038,80,7,840,786,54,2090,1361,92,101,339,197
"2021","Greenwich 022","E02000334",5312,2748,2158,2130,28,4,586,560,26,2564,1713,124,111,377,239
"2021","Greenwich 023","E02000335",5284,3244,2547,2501,46,11,686,650,36,2040,1270,69,96,313,292
"2021","Greenwich 025","E02000337",6646,3362,2480,2458,22,14,868,834,34,3284,2155,121,179,482,347
"2021","Greenwich 027","E02000339",5078,2908,2283,2257,26,7,618,588,30,2170,1390,51,91,329,309
"2021","Greenwich 028","E02000340",5608,3136,2348,2332,16,6,782,724,58,2472,1528,93,104,392,355
"2021","Greenwich 029","E02000341",6005,2842,2165,2153,12,5,672,642,30,3163,2170,136,143,451,263
"2021","Greenwich 030","E02000342",4512,2389,1740,1728,12,3,646,622,24,2123,1494,60,74,292,203
"2021","Greenwich 031","E02000343",5609,2880,2268,2258,10,12,600,566,34,2729,1810,108,97,365,349
"2021","Greenwich 032","E02000344",5098,3060,2423,2405,18,9,628,610,18,2038,1362,61,90,267,258
"2021","Greenwich 033","E02006786",5845,2777,2076,2058,18,18,683,630,53,3068,2057,156,171,440,244
"2021","Greenwich 034","E02006927",9822,5422,3951,3903,48,15,1456,1292,164,4400,3045,148,180,603,424
"2021","Greenwich 035","E02006928",9315,4483,2449,2391,58,11,2023,1859,164,4832,3792,178,248,482,132
"2021","Greenwich 037","E02006930",8107,4358,2696,2616,80,4,1658,1466,192,3749,2891,118,130,405,205
"2021","Greenwich 038","E02006931",7700,4107,2662,2583,79,7,1438,1324,114,3593,2616,142,141,468,226
"2021","Greenwich 039","E02006991",5632,3212,1666,1572,94,4,1542,1366,176,2420,1914,87,108,248,63
"2021","Greenwich 040","E02006992",6768,3674,2169,2111,58,1,1504,1366,138,3094,2350,99,112,379,154
"2021","Greenwich 041","E02006993",6658,3446,1906,1850,56,10,1530,1384,146,3212,2570,131,126,300,85
"2021","Greenwich 042","E02006994",6052,2683,1734,1713,21,13,936,854,82,3369,2379,183,213,445,149
"2021","Hackney 001","E02000345",5361,2838,2459,2443,16,7,372,338,34,2523,1748,187,146,289,153
"2021","Hackney 002","E02000346",7398,3020,1787,1751,36,15,1218,1130,88,4378,3236,160,268,508,206
"2021","Hackney 003","E02000347",5406,2690,2184,2166,18,6,500,462,38,2716,2013,142,101,300,160
"2021","Hackney 004","E02000348",5398,2456,2078,2064,14,6,372,342,30,2942,2072,165,156,363,186
"2021","Hackney 006","E02000350",8128,3636,2447,2403,44,7,1182,1098,84,4492,3615,250,124,349,154
"2021","Hackney 007","E02000351",7901,3328,1805,1761,44,23,1500,1364,136,4573,3677,156,178,410,152
"2021","Hackney 008","E02000352",5213,2310,1506,1476,30,0,804,742,62,2903,2146,84,104,402,167
"2021","Hackney 009","E02000353",6485,3034,1866,1796,70,2,1166,1062,104,3451,2723,157,100,303,168
"2021","Hackney 010","E02000354",7983,2924,1732,1668,64,14,1178,1096,82,5059,3961,204,183,491,220
"2021","Hackney 011","E02000355",6700,2834,1802,1731,71,9,1023,922,101,3866,3014,180,132,337,203
"2021","Hackney 012","E02000356",5903,2910,1641,1587,54,13,1256,1128,128,2993,2354,88,106,295,150
"2021","Hackney 013","E02000357",5383,1675,1143,1131,12,7,525,489,36,3708,2664,148,203,478,215
"2021","Hackney 014","E02000358",9383,3638,2136,2064,72,10,1492,1324,168,5745,4478,164,230,598,275
"2021","Hackney 015","E02000359",5372,2192,1443,1409,34,19,730,654,76,3180,2511,97,117,279,176
"2021","Hackney 016","E02000360",9214,3402,2023,1971,52,41,1338,1206,132,5812,4426,211,258,647,270
"2021","Hackney 017","E02000361",6867,2511,1233,1188,45,5,1273,1158,115,4356,3443,180,208,377,148
"2021","Hackney 018","E02000362",5610,2134,1176,1150,26,8,950,866,84,3476,2706,95,151,352,172
"2021","Hackney 019","E02000363",8632,2937,1906,1876,30,8,1023,925,98,5695,4373,210,277,572,263
"2021","Hackney 020","E02000364",7775,3138,1725,1641,84,9,1404,1250,154,4637,3538,102,183,552,262
"2021","Hackney 022","E02000366",6757,2508,1584,1538,46,12,912,844,68,4249,3197,139,203,457,253
"2021","Hackney 023","E02000367",8751,3498,1731,1665,66,15,1752,1582,170,5253,4281,138,186,456,192
"2021","Hackney 024","E02000368",8163,2906,1790,1754,36,20,1096,988,108,5257,4002,182,242,561,270
"2021","Hackney 025","E02000369",11214,4572,2369,2275,94,27,2176,1940,236,6642,5188,218,291,652,293
"2021","Hackney 026","E02000370",7422,2777,1527,1479,48,19,1231,1136,95,4645,3710,139,164,453,179
"2021","Hackney 028","E02006918",6336,2529,1617,1591,26,7,905,825,80,3807,2884,139,209,381,194
"2021","Hackney 029","E02006921",5551,2412,1897,1873,24,7,508,464,44,3139,2285,181,178,347,148
"2021","Hackney 030","E02007108",5236,2238,977,929,48,1,1260,1104,156,2998,2532,71,74,225,96
"2021","Hackney 031","E02007109",6475,2762,1548,1482,66,2,1212,1120,92,3713,2877,117,156,356,207
"2021","Hackney 032","E02007110",6020,2170,1209,1159,50,7,954,852,102,3850,3131,118,157,339,105
"2021","Hackney 033","E02007111",5112,1947,792,722,70,4,1151,1019,132,3165,2719,92,85,221,48
"2021","Hammersmith and Fulham 001","E02000372",7574,2688,1929,1909,20,9,750,688,62,4886,3650,233,184,543,276
"2021","Hammersmith and Fulham 002","E02000373",5461,1852,1412,1406,6,16,424,384,40,3609,2672,188,156,405,188
"2021","Hammersmith and Fulham 003","E02000374",5412,2170,1567,1531,36,9,594,568,26,3242,2468,120,113,326,215
"2021","Hammersmith and Fulham 004","E02000375",6266,2338,1479,1447,32,7,852,778,74,3928,3019,149,143,456,161
"2021","Hammersmith and Fulham 005","E02000376",5828,2299,1306,1262,44,1,992,910,82,3529,2753,134,147,348,147
"2021","Hammersmith and Fulham 006","E02000377",6363,2567,1643,1598,45,6,918,850,68,3796,2885,135,142,446,188
"2021","Hammersmith and Fulham 007","E02000378",5567,2403,1394,1339,55,5,1004,930,74,3164,2426,121,115,386,116
"2021","Hammersmith and Fulham 008","E02000379",5848,2938,2218,2184,34,6,714,656,58,2910,2111,115,107,377,200
"2021","Hammersmith and Fulham 009","E02000380",4564,2279,1608,1564,44,2,669,617,52,2285,1692,88,77,295,133
"2021","Hammersmith and Fulham 010","E02000381",6268,3068,2101,2067,34,7,960,908,52,3200,2422,131,117,374,156
"2021","Hammersmith and Fulham 011","E02000382",4993,2382,1680,1622,58,4,698,634,64,2611,1872,140,103,335,161
"2021","Hammersmith and Fulham 012","E02000383",7399,2934,1900,1838,62,2,1032,944,88,4465,3408,210,125,479,243
"2021","Hammersmith and Fulham 013","E02000384",6929,2658,1655,1616,39,1,1002,914,88,4271,3278,169,164,452,208
"2021","Hammersmith and Fulham 014","E02000385",5079,1952,1027,971,56,3,922,842,80,3127,2599,85,79,271,93
"2021","Hammersmith and Fulham 015","E02000386",6423,2216,1363,1332,31,13,840,764,76,4207,3204,156,163,464,220
"2021","Hammersmith and Fulham 016","E02000387",5093,1776,1206,1179,27,4,566,524,42,3317,2612,119,92,340,154
"2021","Hammersmith and Fulham 017","E02000388",7554,3144,1914,1856,58,6,1224,1154,70,4410,3465,166,134,431,214
"2021","Hammersmith and Fulham 018","E02000389",7301,3542,2590,2532,58,10,942,850,92,3759,2880,152,70,395,262
"2021","Hammersmith and Fulham 019","E02000390",5291,2281,1481,1454,27,4,796,752,44,3010,2397,89,88,290,146
"2021","Hammersmith and Fulham 020","E02000391",6219,2967,2202,2178,24,8,757,704,53,3252,2406,113,106,409,218
"2021","Hammersmith and Fulham 021","E02000392",7674,3410,2297,2261,36,13,1100,1040,60,4264,3377,140,144,416,187
"2021","Hammersmith and Fulham 022","E02000393",4988,2563,1708,1683,25,19,836,800,36,2425,1946,70,57,226,126
"2021","Hammersmith and Fulham 023","E02000394",7662,3342,2161,2129,32,3,1178,1112,66,4320,3244,185,165,537,189
"2021","Hammersmith and Fulham 024","E02000395",4877,2455,1774,1740,34,7,674,634,40,2422,1799,103,51,268,201
"2021","Hammersmith and Fulham 025","E02000396",5467,2623,1965,1923,42,9,649,604,45,2844,2156,105,89,341,153
"2021","Haringey 001","E02000397",6539,2920,1927,1909,18,10,983,899,84,3619,2542,196,157,486,238
"2021","Haringey 002","E02000398",5900,2010,1520,1514,6,10,480,448,32,3890,2646,200,207,603,234
"2021","Haringey 004","E02000400",6345,2872,2148,2104,44,12,712,680,32,3473,2477,146,136,463,251
"2021","Haringey 005","E02000401",5606,2140,1641,1625,16,17,482,452,30,3466,2497,169,147,440,213
"2021","Haringey 006","E02000402",5190,1944,1482,1478,4,14,448,418,30,3246,2256,161,198,417,214
"2021","Haringey 007","E02000403",6203,2902,1902,1876,26,20,980,898,82,3301,2353,202,109,416,221
"2021","Haringey 008","E02000404",5894,2416,1756,1742,14,10,650,582,68,3478,2441,224,138,440,235
"2021","Haringey 009","E02000405",4984,3028,2439,2419,20,5,584,534,50,1956,1396,59,64,247,190
"2021","Haringey 010","E02000406",5741,2166,1454,1430,24,12,700,624,76,3575,2577,182,143,456,217
"2021","Haringey 011","E02000407",6127,2344,1550,1536,14,14,780,720,60,3783,2601,271,185,507,219
"2021","Haringey 012","E02000408",6392,2456,1732,1722,10,20,704,654,50,3936,2627,278,205,558,268
"2021","Haringey 013","E02000409",4991,1950,1379,1373,6,9,562,526,36,3041,2114,172,176,395,184
"2021","Haringey 014","E02000410",5018,2925,2168,2136,32,10,747,682,65,2093,1505,69,87,287,145
"2021","Haringey 015","E02000411",8493,3474,2309,2277,32,21,1144,1016,128,5019,3560,354,249,616,240
"2021","Haringey 016","E02000412",6228,2212,1439,1409,30,9,764,700,64,4016,2864,166,234,535,217
"2021","Haringey 017","E02000413",5961,3384,2630,2586,44,14,740,692,48,2577,1847,98,99,318,215
"2021","Haringey 018","E02000414",5840,2440,1669,1623,46,11,760,696,64,3400,2369,255,164,402,210
"2021","Haringey 019","E02000415",6062,2652,1802,1758,44,8,842,776,66,3410,2472,238,131,356,213
"2021","Haringey 020","E02000416",7085,3346,1897,1855,42,11,1438,1348,90,3739,2774,113,146,498,208
"2021","Haringey 021","E02000417",5361,3072,2222,2174,48,10,840,798,42,2289,1602,67,85,333,202
"2021","Haringey 022","E02000418",4443,2719,2079,2031,48,3,637,600,37,1724,1179,55,50,266,174
"2021","Haringey 023","E02000419",7402,3336,2065,2011,54,15,1256,1142,114,4066,3068,177,145,427,249
"2021","Haringey 024","E02000420",6743,2681,1666,1628,38,16,999,880,119,4062,2820,270,185,538,249
"2021","Haringey 025","E02000421",6817,2190,1451,1436,15,9,730,666,64,4627,3308,407,184,504,224
"2021","Haringey 026","E02000422",5961,2391,1648,1630,18,15,728,666,62,3570,2559,173,173,483,182
"2021","Haringey 027","E02000423",5914,2300,1445,1396,49,7,848,750,98,3614,2771,187,121,343,192
"2021","Haringey 028","E02000424",5590,2897,1834,1775,59,7,1056,976,80,2693,1950,72,165,348,158
"2021","Haringey 029","E02000425",5116,2502,2106,2084,22,18,378,352,26,2614,1842,218,122,273,159
"2021","Haringey 030","E02000426",5286,2966,2230,2204,26,2,734,672,62,2320,1607,89,78,327,219
"2021","Haringey 031","E02000427",5769,2516,1530,1482,48,16,970,856,114,3253,2526,143,105,300,179
"2021","Haringey 032","E02000428",6800,2302,1601,1583,18,15,686,618,68,4498,3469,213,184,444,188
"2021","Haringey 033","E02000429",5624,3236,2231,2181,50,3,1002,926,76,2388,1655,82,99,331,221
"2021","Haringey 034","E02000430",5816,3053,1759,1729,30,4,1290,1186,104,2763,2086,71,84,392,130
"2021","Haringey 035","E02000431",5083,2810,1695,1651,44,5,1110,1018,92,2273,1728,72,74,258,141
"2021","Haringey 036","E02000432",5304,2436,1351,1297,54,11,1074,950,124,2868,2225,75,81,347,140
"2021","Haringey 037","E02006794",6199,2226,1649,1627,22,7,570,524,46,3973,2791,237,180,551,214
"2021","Harrow 001","E02000433",7066,4055,3639,3627,12,9,407,387,20,3011,1752,217,97,400,545
"2021","Harrow 002","E02000434",8034,4584,4075,4071,4,11,498,480,18,3450,2232,291,107,389,431
"2021","Harrow 003","E02000435",6503,3616,3289,3285,4,7,320,298,22,2887,1845,223,113,307,399
"2021","Harrow 004","E02000436",4812,3134,2932,2920,12,4,198,184,14,1678,1026,109,44,171,328
"2021","Harrow 005","E02000437",6929,3732,3323,3319,4,11,398,388,10,3197,1914,260,154,430,439
"2021","Harrow 006","E02000438",6601,3712,3259,3251,8,7,446,420,26,2889,1823,157,100,388,421
"2021","Harrow 007","E02000439",7350,3820,3326,3322,4,10,484,452,32,3530,2267,434,116,389,324
"2021","Harrow 008","E02000440",7694,4668,4339,4335,4,17,312,304,8,3026,1965,274,87,293,407
"2021","Harrow 009","E02000441",5936,3367,2977,2969,8,10,380,366,14,2569,1581,182,106,321,379
"2021","Harrow 010","E02000442",7692,4133,3690,3688,2,10,433,402,31,3559,2225,556,102,355,321
"2021","Harrow 011","E02000443",8322,4218,3611,3603,8,9,598,562,36,4104,2691,352,190,462,409
"2021","Harrow 012","E02000444",6887,3978,3654,3652,2,14,310,304,6,2909,1887,324,97,240,361
"2021","Harrow 013","E02000445",9001,4632,4027,4015,12,15,590,558,32,4369,2869,462,172,469,397
"2021","Harrow 015","E02000447",6482,3912,3531,3527,4,13,368,344,24,2570,1737,189,78,253,313
"2021","Harrow 016","E02000448",5632,3550,3136,3120,16,12,402,386,16,2082,1268,109,92,256,357
"2021","Harrow 017","E02000449",6793,3637,3268,3262,6,10,359,342,17,3156,2034,390,78,288,366
"2021","Harrow 019","E02000451",5445,3413,3131,3124,7,8,274,260,14,2032,1290,158,55,205,324
"2021","Harrow 020","E02000452",7413,4060,3278,3262,16,16,766,730,36,3353,2264,315,136,390,248
"2021","Harrow 021","E02000453",6684,3841,3252,3247,5,13,576,550,26,2843,1934,213,111,321,264
"2021","Harrow 022","E02000454",5732,3810,3584,3580,4,8,218,206,12,1922,1251,118,55,214,284
"2021","Harrow 023","E02000455",9364,5340,4468,4446,22,12,860,804,56,4024,2662,367,150,495,350
"2021","Harrow 024","E02000456",6397,3301,2882,2872,10,10,409,397,12,3096,2117,260,92,274,353
"2021","Harrow 025","E02000457",5767,3398,3027,3016,11,6,365,344,21,2369,1548,161,77,252,331
"2021","Harrow 027","E02000459",7336,3928,3216,3210,6,8,704,684,20,3408,2202,263,183,394,366
"2021","Harrow 028","E02000460",5649,2910,2550,2550,0,12,348,326,22,2739,1888,197,109,300,245
"2021","Harrow 029","E02000461",5224,2933,2428,2408,20,6,499,478,21,2291,1422,202,99,313,255
"2021","Harrow 030","E02000462",5645,3020,2675,2667,8,7,338,312,26,2625,1728,253,98,249,297
"2021","Harrow 031","E02000463",6926,3660,3261,3255,6,11,388,368,20,3266,2230,217,121,377,321
"2021","Harrow 032","E02006795",6606,3941,3573,3563,10,11,357,340,17,2665,1832,215,65,227,326
"2021","Harrow 033","E02006882",11826,6658,6171,6159,12,13,474,448,26,5168,3231,595,129,494,719
"2021","Havering 001","E02000464",5974,3174,2394,2378,16,18,762,734,28,2800,1823,87,132,437,321
"2021","Havering 002","E02000465",7118,3742,2741,2723,18,5,996,960,36,3376,2316,118,126,499,317
"2021","Havering 003","E02000466",6966,3767,2867,2859,8,10,890,864,26,3199,2127,106,110,449,407
"2021","Havering 004","E02000467",8351,3918,2723,2719,4,13,1182,1144,38,4433,3017,115,211,709,381
"2021","Havering 005","E02000468",6740,3759,3004,2999,5,9,746,716,30,2981,1910,99,131,462,379
"2021","Havering 006","E02000469",5518,2826,2119,2110,9,4,703,686,17,2692,1718,143,116,404,311
"2021","Havering 007","E02000470",7985,4836,3521,3499,22,9,1306,1262,44,3149,1945,107,126,493,478
"2021","Havering 008","E02000471",6485,4077,3505,3497,8,10,562,546,16,2408,1504,107,65,259,473
"2021","Havering 009","E02000472",7541,4516,3725,3721,4,11,780,754,26,3025,1920,155,111,389,450
"2021","Havering 010","E02000473",8338,5115,4063,4059,4,10,1042,990,52,3223,2112,85,136,433,457
"2021","Havering 011","E02000474",7157,3908,2998,2984,14,6,904,860,44,3249,2068,158,137,444,442
"2021","Havering 012","E02000475",7777,4682,3775,3771,4,5,902,866,36,3095,2010,133,120,415,417
"2021","Havering 013","E02000476",7456,3870,2757,2742,15,5,1108,1024,84,3586,2340,180,157,524,385
"2021","Havering 014","E02000477",7877,4909,3960,3954,6,5,944,932,12,2968,1903,105,94,372,494
"2021","Havering 015","E02000478",5032,3226,2932,2932,0,6,288,280,8,1806,1106,118,54,181,347
"2021","Havering 016","E02000479",7434,3997,2889,2859,30,6,1102,1046,56,3437,2343,150,148,490,306
"2021","Havering 017","E02000480",10447,5492,4126,4100,26,18,1348,1282,66,4955,3491,280,198,588,398
"2021","Havering 018","E02000481",6596,3970,3237,3225,12,7,726,716,10,2626,1567,73,99,375,512
"2021","Havering 019","E02000482",5391,3542,3095,3091,4,7,440,426,14,1849,1127,45,58,193,426
"2021","Havering 020","E02000483",6613,3684,2846,2834,12,4,834,790,44,2929,1757,71,71,501,529
"2021","Havering 021","E02000484",6991,4220,3449,3442,7,9,762,730,32,2771,1815,90,77,383,406
"2021","Havering 022","E02000485",6886,4200,3250,3236,14,4,946,904,42,2686,1685,76,105,405,415
"2021","Havering 023","E02000486",6113,3676,2876,2868,8,14,786,750,36,2437,1535,78,68,339,417
"2021","Havering 024","E02000487",6506,4466,3930,3918,12,6,530,518,12,2040,1371,39,45,196,389
"2021","Havering 025","E02000488",6312,4076,3329,3317,12,3,744,708,36,2236,1406,54,68,277,431
"2021","Havering 026","E02000489",6868,3910,3131,3123,8,15,764,734,30,2958,1904,109,93,422,430
"2021","Havering 027","E02000490",6782,3740,2939,2933,6,11,790,758,32,3042,1938,114,102,387,501
"2021","Havering 028","E02000491",8206,4218,3166,3150,16,14,1038,1010,28,3988,2699,186,153,525,425
"2021","Havering 029","E02000492",5602,3280,2614,2602,12,8,658,644,14,2322,1470,82,78,269,423
"2021","Havering 030","E02000493",5183,2722,2013,2011,2,17,692,668,24,2461,1621,105,94,347,294
"2021","Hillingdon 001","E02000494",6465,4058,3706,3692,14,10,342,322,20,2407,1378,162,94,378,395
"2021","Hillingdon 002","E02000495",8342,4682,3942,3918,24,8,732,710,22,3660,2203,194,139,626,498
"2021","Hillingdon 003","E02000496",6235,3564,2633,2619,14,9,922,896,26,2671,1707,81,119,427,337
"2021","Hillingdon 004","E02000497",7529,4350,3661,3641,20,7,682,664,18,3179,2054,117,114,471,423
"2021","Hillingdon 005","E02000498",5181,3083,2526,2518,8,7,550,530,20,2098,1268,60,72,385,313
"2021","Hillingdon 006","E02000499",6368,4004,3541,3525,16,9,454,444,10,2364,1499,90,59,291,425
"2021","Hillingdon 007","E02000500",6879,4271,3669,3655,14,12,590,568,22,2608,1679,109,80,310,430
"2021","Hillingdon 008","E02000501",6754,4230,3513,3485,28,9,708,676,32,2524,1655,75,75,357,362
"2021","Hillingdon 009","E02000502",6969,4228,3383,3361,22,7,838,806,32,2741,1709,130,102,402,398
"2021","Hillingdon 010","E02000503",6955,4381,3546,3532,14,6,829,795,34,2574,1698,97,95,343,341
"2021","Hillingdon 011","E02000504",6152,3996,3448,3438,10,8,540,524,16,2156,1333,71,60,285,407
"2021","Hillingdon 013","E02000506",6514,4027,3568,3562,6,5,454,427,27,2487,1581,142,82,256,426
"2021","Hillingdon 014","E02000507",6354,3736,3146,3142,4,10,580,562,18,2618,1775,143,83,309,308
"2021","Hillingdon 015","E02000508",8327,4516,3384,3352,32,12,1120,1058,62,3811,2669,205,149,501,287
"2021","Hillingdon 016","E02000509",6779,3312,2376,2362,14,10,926,870,56,3467,2419,189,169,410,280
"2021","Hillingdon 017","E02000510",7125,4033,3413,3399,14,14,606,576,30,3092,2021,167,114,427,363
"2021","Hillingdon 018","E02000511",7731,4319,3731,3731,0,21,567,539,28,3412,2225,285,119,374,409
"2021","Hillingdon 019","E02000512",6790,3410,2768,2760,8,10,632,608,24,3380,2284,201,134,443,318
"2021","Hillingdon 020","E02000513",7182,3646,3014,3009,5,12,620,582,38,3536,2302,292,184,469,289
"2021","Hillingdon 021","E02000514",8225,4533,4120,4116,4,11,402,387,15,3692,2441,405,123,361,362
"2021","Hillingdon 022","E02000515",10424,5274,3906,3874,32,8,1360,1284,76,5150,3620,263,225,677,365
"2021","Hillingdon 023","E02000516",6691,3507,3037,3031,6,13,457,419,38,3184,2074,317,136,377,280
"2021","Hillingdon 024","E02000517",7809,4079,3440,3429,11,15,624,592,32,3730,2502,306,131,462,329
"2021","Hillingdon 025","E02000518",7366,3508,2775,2771,4,11,722,686,36,3858,2614,179,155,545,365
"2021","Hillingdon 026","E02000519",7315,3634,3208,3208,0,2,424,398,26,3681,2332,374,143,458,374
"2021","Hillingdon 027","E02000520",10693,5419,4562,4554,8,17,840,746,94,5274,3425,623,223,537,466
"2021","Hillingdon 028","E02000521",9960,5298,4394,4387,7,13,891,843,48,4662,3231,347,173,567,344
"2021","Hillingdon 029","E02000522",7288,3903,3072,3058,14,16,815,782,33,3385,2228,190,154,481,332
"2021","Hillingdon 030","E02000523",9013,4768,4135,4105,30,22,611,572,39,4245,2750,504,157,471,363
"2021","Hillingdon 031","E02000524",5858,3017,2364,2348,16,11,642,608,34,2841,1699,338,131,395,278
"2021","Hillingdon 032","E02000525",7686,4022,3360,3352,8,12,650,612,38,3664,2253,457,189,456,309
"2021","Hillingdon 033","E02006796",7450,4338,3515,3507,8,15,808,774,34,3112,2057,178,125,388,364
"2021","Hounslow 001","E02000526",6994,3950,3095,3007,88,15,840,770,70,3044,2190,143,122,368,221
"2021","Hounslow 004","E02000529",7552,3940,3528,3522,6,12,400,376,24,3612,2249,427,204,379,353
"2021","Hounslow 005","E02000530",6031,2788,2499,2495,4,7,282,276,6,3243,2026,388,168,364,297
"2021","Hounslow 006","E02000531",9348,4944,3531,3477,54,9,1404,1296,108,4404,3068,204,180,620,332
"2021","Hounslow 007","E02000532",7284,4118,3174,3114,60,12,932,746,186,3166,2147,129,130,450,310
"2021","Hounslow 008","E02000533",6766,3728,2788,2742,46,2,938,858,80,3038,2071,102,117,502,246
"2021","Hounslow 009","E02000534",6846,3843,3218,3191,27,21,604,568,36,3003,2019,235,114,343,292
"2021","Hounslow 010","E02000535",8104,4214,3817,3809,8,11,386,366,20,3890,2266,558,126,430,510
"2021","Hounslow 011","E02000536",8568,4356,3905,3891,14,13,438,412,26,4212,2652,506,183,411,460
"2021","Hounslow 012","E02000537",8097,4186,3627,3622,5,5,554,534,20,3911,2423,618,135,376,359
"2021","Hounslow 013","E02000538",8156,4182,3681,3673,8,11,490,458,32,3974,2340,685,166,385,398
"2021","Hounslow 014","E02000539",9533,5095,3766,3709,57,14,1315,1244,71,4438,3029,238,201,658,312
"2021","Hounslow 015","E02000540",9487,5050,4019,3988,31,21,1010,938,72,4437,2827,423,173,606,408
"2021","Hounslow 016","E02000541",8422,4034,3549,3542,7,5,480,456,24,4388,2544,717,189,443,495
"2021","Hounslow 017","E02000542",9432,4864,4293,4282,11,16,555,510,45,4568,2841,686,159,474,408
"2021","Hounslow 018","E02000543",10868,5990,5124,5092,32,12,854,774,80,4878,3048,598,236,638,358
"2021","Hounslow 019","E02000544",7012,3981,3420,3406,14,15,546,518,28,3031,1966,238,120,384,323
"2021","Hounslow 020","E02000545",7093,3631,2709,2686,23,10,912,854,58,3462,2266,187,171,548,290
"2021","Hounslow 021","E02000546",8028,4234,3703,3700,3,15,516,484,32,3794,2393,490,139,401,371
"2021","Hounslow 022","E02000547",8640,4460,3732,3722,10,12,716,690,26,4180,2677,318,164,575,446
"2021","Hounslow 023","E02000548",8068,4058,3171,3151,20,11,876,832,44,4010,2647,292,220,522,329
"2021","Hounslow 024","E02000549",9856,5185,4357,4336,21,23,805,768,37,4671,3056,420,194,529,472
"2021","Hounslow 025","E02000550",8225,4348,3482,3460,22,22,844,802,42,3877,2676,253,187,489,272
"2021","Hounslow 026","E02000551",7401,3520,2751,2732,19,19,750,718,32,3881,2533,243,186,631,288
"2021","Hounslow 027","E02000552",6945,3940,3072,3055,17,10,858,818,40,3005,1958,167,160,446,274
"2021","Hounslow 028","E02000553",5506,2973,2398,2388,10,8,567,543,24,2533,1604,149,136,358,286
"2021","Hounslow 029","E02006792",7615,3963,2785,2718,67,4,1174,1070,104,3652,2576,139,139,498,300
"2021","Hounslow 030","E02006972",4274,2126,1551,1521,30,13,562,520,42,2148,1489,121,96,321,121
"2021","Hounslow 031","E02006973",6812,3218,2203,2159,44,1,1014,914,100,3594,2439,143,154,595,263
"2021","Islington 001","E02000554",7581,2828,1691,1643,48,4,1133,1037,96,4753,3651,122,211,540,229
"2021","Islington 002","E02000555",7893,3249,2040,1974,66,3,1206,1084,122,4644,3528,136,202,501,277
"2021","Islington 003","E02000556",9436,3966,2059,1981,78,9,1898,1738,160,5470,4276,173,170,539,312
"2021","Islington 004","E02000557",7382,2882,1639,1595,44,5,1238,1142,96,4500,3422,93,177,566,242
"2021","Islington 005","E02000558",7483,2686,1724,1696,28,10,952,880,72,4797,3597,226,194,538,242
"2021","Islington 006","E02000559",7930,3860,2358,2268,90,12,1490,1408,82,4070,3304,112,121,328,205
"2021","Islington 007","E02000560",6289,2660,1302,1240,62,10,1348,1230,118,3629,2930,91,121,331,156
"2021","Islington 008","E02000561",6086,3084,1891,1843,48,5,1188,1095,93,3002,2306,93,83,348,172
"2021","Islington 009","E02000562",6507,3032,1788,1732,56,12,1232,1134,98,3475,2644,94,135,411,191
"2021","Islington 010","E02000563",7133,2602,1530,1478,52,6,1066,964,102,4531,3515,157,175,475,209
"2021","Islington 011","E02000564",10368,4424,2198,2102,96,24,2202,2028,174,5944,4878,139,189,540,198
"2021","Islington 012","E02000565",6916,2584,1407,1373,34,5,1172,1076,96,4332,3481,109,138,399,205
"2021","Islington 013","E02000566",7235,3548,2126,2036,90,10,1412,1305,107,3687,2918,100,111,380,178
"2021","Islington 014","E02000567",8934,4055,2194,2100,94,14,1847,1700,147,4879,3874,113,131,515,246
"2021","Islington 015","E02000568",8671,3294,1960,1900,60,12,1322,1216,106,5377,4172,145,186,558,316
"2021","Islington 016","E02000569",8220,3506,2082,1992,90,11,1413,1290,123,4714,3570,152,192,545,255
"2021","Islington 017","E02000570",7137,3631,2210,2071,139,1,1420,1306,114,3506,2799,87,108,366,146
"2021","Islington 018","E02000571",7467,3262,1958,1890,68,8,1296,1156,140,4205,3317,83,149,427,229
"2021","Islington 019","E02000572",7143,2430,1596,1564,32,8,826,746,80,4713,3699,122,146,501,245
"2021","Islington 020","E02000573",8806,4083,2308,2178,130,6,1769,1602,167,4723,3774,181,144,405,219
"2021","Islington 021","E02000574",6288,2614,1460,1374,86,4,1150,1002,148,3674,2898,159,102,361,154
"2021","Islington 022","E02000575",8873,3668,2070,1936,134,10,1588,1396,192,5205,4132,127,165,558,223
"2021","Islington 023","E02000576",8592,3263,1993,1915,78,6,1264,1142,122,5329,4217,147,170,533,262
"2021","Kensington and Chelsea 001","E02000577",6317,2045,1558,1540,18,14,473,413,60,4272,3051,163,248,508,302
"2021","Kensington and Chelsea 002","E02000578",4729,1620,1219,1209,10,9,392,370,22,3109,2254,120,124,400,211
"2021","Kensington and Chelsea 003","E02000579",7458,2937,2114,2076,38,8,815,742,73,4521,3261,226,150,597,287
"2021","Kensington and Chelsea 004","E02000580",6943,2368,1557,1523,34,13,798,708,90,4575,3294,162,150,690,279
"2021","Kensington and Chelsea 005","E02000581",6145,2244,1689,1639,50,11,544,498,46,3901,2743,228,129,542,259
"2021","Kensington and Chelsea 006","E02000582",5418,2354,1640,1570,70,8,706,660,46,3064,2194,168,81,463,158
"2021","Kensington and Chelsea 007","E02000583",5525,2724,2102,2074,28,6,616,573,43,2801,1942,177,93,378,211
"2021","Kensington and Chelsea 008","E02000584",5984,3077,2491,2459,32,4,582,544,38,2907,1954,272,83,403,195
"2021","Kensington and Chelsea 009","E02000585",6645,3196,2531,2489,42,11,654,566,88,3449,2306,268,144,468,263
"2021","Kensington and Chelsea 010","E02000586",5494,2710,2201,2159,42,5,504,472,32,2784,1980,197,171,288,148
"2021","Kensington and Chelsea 011","E02000587",5532,2896,2391,2361,30,3,502,446,56,2636,1846,225,61,309,195
"2021","Kensington and Chelsea 012","E02000588",5198,2545,2022,1991,31,3,520,496,24,2653,1791,238,85,332,207
"2021","Kensington and Chelsea 013","E02000589",6165,2559,1849,1805,44,5,705,650,55,3606,2759,217,90,397,143
"2021","Kensington and Chelsea 014","E02000590",5181,2040,1583,1557,26,11,446,410,36,3141,2120,225,91,470,235
"2021","Kensington and Chelsea 015","E02000591",5323,2075,1421,1357,64,11,643,576,67,3248,2373,187,103,417,168
"2021","Kensington and Chelsea 016","E02000592",4782,2316,1740,1704,36,2,574,522,52,2466,1833,177,66,271,119
"2021","Kensington and Chelsea 017","E02000593",6356,2598,1804,1743,61,11,783,721,62,3758,2855,160,136,434,173
"2021","Kensington and Chelsea 018","E02000594",5486,2396,1968,1922,46,8,420,384,36,3090,2196,186,72,416,220
"2021","Kensington and Chelsea 019","E02000595",5186,2422,1908,1886,22,0,514,474,40,2764,1790,206,87,426,255
"2021","Kensington and Chelsea 020","E02000596",5579,2496,1720,1676,44,2,774,720,54,3083,2254,184,90,395,160
"2021","Kensington and Chelsea 021","E02000597",5357,2054,1552,1524,28,8,494,460,34,3303,2196,147,137,546,277
"2021","Kingston upon Thames 001","E02000598",6194,4028,3551,3525,26,9,468,446,22,2166,1383,84,86,337,276
"2021","Kingston upon Thames 002","E02000599",5487,3353,3015,3001,14,7,331,308,23,2134,1412,166,59,195,302
"2021","Kingston upon Thames 003","E02000600",6484,3556,2803,2787,16,11,742,682,60,2928,2009,144,111,427,237
"2021","Kingston upon Thames 004","E02000601",9212,5721,4495,4456,39,14,1212,1140,72,3491,2385,157,146,516,287
"2021","Kingston upon Thames 005","E02000602",7612,3852,2775,2731,44,13,1064,998,66,3760,2661,150,164,513,272
"2021","Kingston upon Thames 006","E02000603",6597,3412,2761,2745,16,11,640,604,36,3185,2268,143,122,381,271
"2021","Kingston upon Thames 007","E02000604",7262,4431,3663,3617,46,9,759,705,54,2831,1856,158,107,421,289
"2021","Kingston upon Thames 008","E02000605",6567,4020,3390,3344,46,12,618,590,28,2547,1667,127,77,340,336
"2021","Kingston upon Thames 009","E02000606",8685,4592,2970,2912,58,6,1616,1526,90,4093,3032,142,143,507,269
"2021","Kingston upon Thames 010","E02000607",5156,3058,2360,2330,30,6,692,656,36,2098,1529,57,59,246,207
"2021","Kingston upon Thames 011","E02000608",5745,3230,1820,1790,30,8,1402,1340,62,2515,1767,91,124,377,156
"2021","Kingston upon Thames 012","E02000609",6154,3503,3116,3108,8,14,373,353,20,2651,1767,156,85,289,354
"2021","Kingston upon Thames 013","E02000610",6564,3491,2104,2066,38,1,1386,1320,66,3073,2154,110,106,466,237
"2021","Kingston upon Thames 014","E02000611",5948,3844,3397,3391,6,7,440,418,22,2104,1384,96,65,236,323
"2021","Kingston upon Thames 015","E02000612",6674,4278,3716,3684,32,10,552,526,26,2396,1577,95,69,291,364
"2021","Kingston upon Thames 016","E02000613",6185,3844,2908,2884,24,6,930,884,46,2341,1569,63,95,382,232
"2021","Kingston upon Thames 017","E02000614",7390,4258,3389,3367,22,5,864,818,46,3132,2079,207,126,428,292
"2021","Kingston upon Thames 018","E02000615",6291,3838,3072,3058,14,10,756,728,28,2453,1574,86,83,394,316
"2021","Kingston upon Thames 019","E02000616",4876,2972,2310,2296,14,6,656,638,18,1904,1241,44,68,328,223
"2021","Kingston upon Thames 020","E02000617",7039,4034,3092,3081,11,10,932,896,36,3005,1986,93,136,463,327
"2021","Lambeth 002","E02000619",7502,2758,1723,1613,110,7,1028,874,154,4744,3579,206,186,496,277
"2021","Lambeth 003","E02000620",8382,3111,1714,1553,161,7,1390,1140,250,5271,4095,204,195,533,244
"2021","Lambeth 004","E02000621",10733,4052,2023,1859,164,17,2012,1720,292,6681,5413,304,187,569,208
"2021","Lambeth 005","E02000622",7261,2552,1410,1290,120,10,1132,968,164,4709,3786,146,144,473,160
"2021","Lambeth 006","E02000623",6626,2234,1450,1384,66,18,766,658,108,4392,3274,171,229,503,215
"2021","Lambeth 007","E02000624",8209,3000,1453,1367,86,15,1532,1312,220,5209,4199,188,187,467,168
"2021","Lambeth 008","E02000625",7654,2498,1380,1338,42,8,1110,1018,92,5156,4098,217,201,473,167
"2021","Lambeth 009","E02000626",6745,2144,1304,1258,46,18,822,754,68,4601,3422,240,233,508,198
"2021","Lambeth 010","E02000627",8016,2686,1475,1359,116,5,1206,1060,146,5330,4378,143,172,427,210
"2021","Lambeth 011","E02000628",9178,2898,1567,1524,43,11,1320,1160,160,6280,4869,305,257,583,266
"2021","Lambeth 012","E02000629",8090,3049,1537,1436,101,12,1500,1320,180,5041,4181,181,128,364,187
"2021","Lambeth 013","E02000630",6546,2822,1593,1505,88,9,1220,1108,112,3724,3085,109,94,292,144
"2021","Lambeth 014","E02000631",7878,3581,2222,2156,66,9,1350,1248,102,4297,3468,148,144,355,182
"2021","Lambeth 015","E02000632",8859,2956,1119,1045,74,7,1830,1626,204,5903,5134,134,103,369,163
"2021","Lambeth 016","E02000633",7823,2486,1343,1275,68,11,1132,1018,114,5337,4313,156,206,476,186
"2021","Lambeth 017","E02000634",5840,1912,1000,956,44,6,906,804,102,3928,3194,95,130,351,158
"2021","Lambeth 018","E02000635",8438,3246,1681,1587,94,7,1558,1398,160,5192,4205,184,174,453,176
"2021","Lambeth 019","E02000636",6473,3137,1954,1872,82,3,1180,1100,80,3336,2825,72,83,223,133
"2021","Lambeth 020","E02000637",7398,3076,1458,1360,98,2,1616,1436,180,4322,3602,112,101,346,161
"2021","Lambeth 021","E02000638",8046,2955,1682,1599,83,9,1264,1118,146,5091,4048,175,188,483,197
"2021","Lambeth 022","E02000639",7152,2436,1419,1389,30,11,1006,882,124,4716,3584,209,220,535,168
"2021","Lambeth 023","E02000640",7715,3552,2120,2062,58,8,1424,1340,84,4163,3434,96,101,344,188
"2021","Lambeth 024","E02000641",6729,2242,1411,1365,46,25,806,734,72,4487,3436,163,201,487,200
"2021","Lambeth 025","E02000642",8003,3680,2389,2329,60,5,1286,1184,102,4323,3186,139,202,567,229
"2021","Lambeth 026","E02000643",7837,3344,1936,1876,60,6,1402,1238,164,4493,3489,165,170,474,195
"2021","Lambeth 027","E02000644",6918,3280,2042,2000,42,4,1234,1120,114,3638,2768,146,141,409,174
"2021","Lambeth 028","E02000645",7693,3789,2356,2310,46,4,1429,1308,121,3904,2981,119,167,472,165
"2021","Lambeth 029","E02000646",7847,3766,2431,2393,38,7,1328,1218,110,4081,3093,202,138,434,214
"2021","Lambeth 030","E02000647",6782,3430,2389,2327,62,7,1034,956,78,3352,2442,142,135,369,264
"2021","Lambeth 031","E02000648",6005,2387,1583,1545,38,13,791,746,45,3618,2662,117,180,475,184
"2021","Lambeth 032","E02000649",10210,4682,2565,2483,82,5,2112,1924,188,5528,4112,306,269,601,240
"2021","Lambeth 033","E02000650",6158,2860,1679,1623,56,9,1172,1080,92,3298,2467,117,163,381,170
"2021","Lambeth 034","E02000651",7098,3489,2326,2284,42,8,1155,1088,67,3609,2566,235,154,431,223
"2021","Lambeth 035","E02000652",6123,2690,2039,2017,22,13,638,594,44,3433,2357,325,107,399,245
"2021","Lambeth 036","E02006801",6619,2407,1424,1326,98,2,981,838,143,4212,3305,183,148,379,197
"2021","Lewisham 001","E02000653",10604,4412,2562,2500,62,14,1836,1636,200,6192,4863,313,210,595,211
"2021","Lewisham 002","E02000654",7009,2608,1429,1397,32,11,1168,1038,130,4401,3303,201,244,485,168
"2021","Lewisham 003","E02000655",8124,3265,1814,1762,52,22,1429,1284,145,4859,3799,156,225,503,176
"2021","Lewisham 005","E02000657",7865,3166,1771,1697,74,9,1386,1260,126,4699,3759,147,191,387,215
"2021","Lewisham 006","E02000658",7275,3167,1890,1835,55,5,1272,1154,118,4108,3149,213,150,412,184
"2021","Lewisham 007","E02000659",6621,3334,2034,1970,64,12,1288,1192,96,3287,2503,92,143,377,172
"2021","Lewisham 008","E02000660",6754,3386,1794,1738,56,10,1582,1442,140,3368,2674,100,120,339,135
"2021","Lewisham 009","E02000661",5388,2753,1754,1720,34,2,997,930,67,2635,1803,104,103,448,177
"2021","Lewisham 010","E02000662",6597,2924,1769,1727,42,5,1150,1088,62,3673,2821,122,148,444,138
"2021","Lewisham 011","E02000663",5634,2689,1724,1667,57,11,954,872,82,2945,2219,91,104,363,168
"2021","Lewisham 013","E02000665",6570,3530,2369,2329,40,9,1152,1072,80,3040,2182,105,125,373,255
"2021","Lewisham 014","E02000666",5693,2858,1876,1838,38,10,972,902,70,2835,2176,93,109,296,161
"2021","Lewisham 015","E02000667",5331,2864,1978,1952,26,8,878,818,60,2467,1838,72,90,282,185
"2021","Lewisham 016","E02000668",5293,2980,2243,2205,38,3,734,652,82,2313,1591,80,86,319,237
"2021","Lewisham 017","E02000669",6318,3240,1942,1888,54,12,1286,1154,132,3078,2249,132,151,392,154
"2021","Lewisham 018","E02000670",5379,2078,1330,1296,34,6,742,704,38,3301,2256,207,145,473,220
"2021","Lewisham 019","E02000671",6991,3601,2272,2196,76,10,1319,1232,87,3390,2511,106,141,443,189
"2021","Lewisham 020","E02000672",8066,3746,2390,2348,42,14,1342,1204,138,4320,3204,201,200,506,209
"2021","Lewisham 021","E02000673",6626,3622,2251,2183,68,9,1362,1226,136,3004,2275,74,116,381,158
"2021","Lewisham 022","E02000674",6621,3226,2436,2392,44,34,756,698,58,3395,2416,193,132,404,250
"2021","Lewisham 023","E02000675",6760,3578,2616,2596,20,20,942,880,62,3182,2237,111,134,410,290
"2021","Lewisham 024","E02000676",6203,3323,2154,2110,44,15,1154,1074,80,2880,2110,86,109,377,198
"2021","Lewisham 025","E02000677",5769,2748,2128,2096,32,12,608,528,80,3021,2118,150,120,356,277
"2021","Lewisham 026","E02000678",5331,2271,1688,1669,19,9,574,548,26,3060,2112,162,158,433,195
"2021","Lewisham 027","E02000679",6383,3057,2018,1978,40,6,1033,964,69,3326,2413,141,134,388,250
"2021","Lewisham 028","E02000680",5462,2592,1719,1705,14,13,860,796,64,2870,2091,92,137,366,184
"2021","Lewisham 029","E02000681",6664,2937,2161,2137,24,21,755,704,51,3727,2557,159,198,523,290
"2021","Lewisham 030","E02000682",6809,2853,2225,2213,12,17,611,581,30,3956,2849,170,195,438,304
"2021","Lewisham 031","E02000683",5405,2400,1698,1680,18,8,694,620,74,3005,2049,111,120,451,274
"2021","Lewisham 033","E02000685",6392,2930,1950,1912,38,22,958,876,82,3462,2458,98,170,489,247
"2021","Lewisham 034","E02000686",5732,2132,1480,1468,12,8,644,602,42,3600,2481,230,184,491,214
"2021","Lewisham 035","E02000687",6511,3228,2100,2064,36,8,1120,1040,80,3283,2312,129,129,463,250
"2021","Lewisham 037","E02006783",5894,2554,1833,1823,10,5,716,688,28,3340,2373,118,142,441,266
"2021","Lewisham 038","E02006784",6347,2743,2076,2061,15,9,658,610,48,3604,2345,222,179,525,333
"2021","Lewisham 039","E02006798",7283,2754,1549,1517,32,21,1184,1068,116,4529,3506,191,193,470,169
"2021","Lewisham 040","E02007008",4660,2270,1149,1105,44,3,1118,1020,98,2390,1923,64,89,265,49
"2021","Lewisham 041","E02007009",7397,3114,1928,1858,70,12,1174,1050,124,4283,3179,211,175,523,195
"2021","Merton 001","E02000689",7024,4412,3373,3331,42,13,1026,972,54,2612,1965,92,94,303,158
"2021","Merton 002","E02000690",4477,2882,2538,2512,26,2,342,324,18,1595,944,91,74,245,241
"2021","Merton 003","E02000691",5914,3490,2529,2495,34,1,960,918,42,2424,1783,99,75,288,179
"2021","Merton 004","E02000692",6406,3763,2772,2727,45,11,980,928,52,2643,1698,132,83,419,311
"2021","Merton 005","E02000693",8281,4523,2629,2570,59,8,1886,1752,134,3758,2902,183,110,363,200
"2021","Merton 006","E02000694",7327,4330,2951,2907,44,9,1370,1284,86,2997,2247,108,101,348,193
"2021","Merton 007","E02000695",7115,3470,2760,2730,30,16,694,644,50,3645,2530,309,112,383,311
"2021","Merton 008","E02000696",7071,3364,2363,2335,28,9,992,932,60,3707,2737,237,157,398,178
"2021","Merton 009","E02000697",7156,4399,2948,2885,63,4,1447,1348,99,2757,2040,111,93,336,177
"2021","Merton 010","E02000698",6399,4061,3482,3454,28,10,569,534,35,2338,1502,118,71,358,289
"2021","Merton 011","E02000699",6442,4167,3186,3157,29,9,972,910,62,2275,1584,70,83,326,212
"2021","Merton 012","E02000700",6862,3251,2236,2208,28,10,1005,966,39,3611,2551,178,145,511,226
"2021","Merton 013","E02000701",7216,3543,2824,2812,12,11,708,688,20,3673,2412,314,140,479,328
"2021","Merton 014","E02000702",7112,3348,2527,2511,16,15,806,758,48,3764,2625,211,179,504,245
"2021","Merton 015","E02000703",6380,3903,3294,3250,44,9,600,568,32,2477,1640,114,72,327,324
"2021","Merton 016","E02000704",6941,3876,2741,2695,46,9,1126,1062,64,3065,2133,136,116,427,253
"2021","Merton 017","E02000705",7440,3724,2955,2941,14,15,754,710,44,3716,2505,320,161,410,320
"2021","Merton 018","E02000706",7652,3553,2709,2688,21,21,823,758,65,4099,2812,293,172,527,295
"2021","Merton 019","E02000707",6477,2729,2161,2151,10,27,541,515,26,3748,2645,250,162,415,276
"2021","Merton 020","E02000708",7051,4230,3565,3539,26,11,654,600,54,2821,1957,127,97,342,298
"2021","Merton 021","E02000709",6403,3905,3332,3294,38,4,569,548,21,2498,1603,143,71,318,363
"2021","Merton 022","E02000710",7176,3700,2903,2883,20,13,784,746,38,3476,2260,212,145,485,374
"2021","Merton 023","E02000711",7500,3996,3046,3026,20,8,942,876,66,3504,2367,248,136,444,309
"2021","Merton 024","E02000712",7627,3950,3140,3124,16,20,790,754,36,3677,2456,227,129,492,373
"2021","Merton 025","E02000713",6248,3776,3045,3017,28,13,718,690,28,2472,1639,101,83,309,340
"2021","Newham 001","E02000714",6069,2813,2089,2069,20,3,721,662,59,3256,2245,273,133,358,247
"2021","Newham 002","E02000715",5279,2462,2189,2183,6,3,270,254,16,2817,1937,252,156,261,211
"2021","Newham 003","E02000716",5530,2660,2235,2217,18,11,414,376,38,2870,1960,309,117,285,199
"2021","Newham 004","E02000717",6202,3034,2621,2619,2,7,406,354,52,3168,2053,423,128,291,273
"2021","Newham 005","E02000718",5413,2505,2223,2217,6,5,277,266,11,2908,2095,225,113,258,217
"2021","Newham 006","E02000719",6528,2775,1960,1924,36,10,805,739,66,3753,2692,293,162,395,211
"2021","Newham 007","E02000720",5844,2798,2385,2355,30,17,396,362,34,3046,1996,415,116,295,224
"2021","Newham 008","E02000721",7246,3371,2921,2914,7,28,422,408,14,3875,2575,563,136,355,246
"2021","Newham 009","E02000722",6647,2832,1924,1898,26,10,898,792,106,3815,2800,288,143,385,199
"2021","Newham 010","E02000723",8762,4197,3772,3759,13,9,416,394,22,4565,2957,717,158,329,404
"2021","Newham 011","E02000724",7490,3737,3152,3135,17,11,574,568,6,3753,2551,484,144,284,290
"2021","Newham 012","E02000725",8249,3332,2180,2128,52,6,1146,1018,128,4917,3774,259,166,489,229
"2021","Newham 014","E02000727",6485,3228,2868,2860,8,8,352,332,20,3257,2120,542,103,264,228
"2021","Newham 015","E02000728",6660,3410,2974,2967,7,9,427,394,33,3250,2036,553,88,318,255
"2021","Newham 016","E02000729",5757,2504,1968,1956,12,6,530,490,40,3253,2131,365,117,398,242
"2021","Newham 017","E02000730",7701,3630,3284,3280,4,18,328,302,26,4071,2427,772,176,377,319
"2021","Newham 018","E02000731",7643,3883,3466,3457,9,11,406,376,30,3760,2496,537,115,299,313
"2021","Newham 019","E02000732",6814,3206,2707,2699,8,10,489,441,48,3608,2529,362,156,333,228
"2021","Newham 020","E02000733",8159,3253,2378,2340,38,17,858,780,78,4906,3588,343,177,535,263
"2021","Newham 021","E02000734",5892,2510,1863,1841,22,11,636,596,40,3382,2374,270,137,380,221
"2021","Newham 022","E02000735",6667,3044,2494,2482,12,34,516,466,50,3623,2433,411,155,353,271
"2021","Newham 023","E02000736",6747,3208,2675,2663,12,17,516,484,32,3539,2478,357,142,348,214
"2021","Newham 024","E02000737",7835,3657,3095,3079,16,12,550,512,38,4178,2827,316,245,471,319
"2021","Newham 025","E02000738",7226,3829,3135,3107,28,11,683,602,81,3397,2291,507,107,273,219
"2021","Newham 026","E02000739",6100,2640,2006,1998,8,12,622,574,48,3460,2457,285,128,364,226
"2021","Newham 027","E02000740",5465,2124,1561,1539,22,3,560,526,34,3341,2397,216,154,372,202
"2021","Newham 028","E02000741",6289,3060,2417,2399,18,15,628,586,42,3229,2219,305,144,343,218
"2021","Newham 029","E02000742",6390,3048,2416,2408,8,8,624,592,32,3342,2313,327,113,342,247
"2021","Newham 030","E02000743",8116,3257,2332,2314,18,11,914,826,88,4859,3604,279,226,499,251
"2021","Newham 031","E02000744",7072,3160,2271,2245,26,13,876,802,74,3912,2764,299,189,434,226
"2021","Newham 032","E02000745",6804,2888,2167,2152,15,9,712,674,38,3916,2699,334,180,438,265
"2021","Newham 033","E02000746",7172,3384,2403,2377,26,7,974,898,76,3788,2714,239,144,482,209
"2021","Newham 034","E02000747",10951,4871,3157,3124,33,13,1701,1550,151,6080,4660,293,237,608,282
"2021","Newham 035","E02000748",4795,2332,1764,1754,10,6,562,520,42,2463,1614,193,114,398,144
"2021","Newham 036","E02000749",7465,2895,2065,2048,17,12,818,749,69,4570,3281,284,178,564,263
"2021","Newham 038","E02006995",6831,3178,1562,1500,62,30,1586,1342,244,3653,3242,91,99,182,39
"2021","Newham 039","E02006996",6468,2906,1650,1614,36,20,1236,1096,140,3562,2863,183,120,260,136
"2021","Newham 040","E02006997",6001,2709,1342,1305,37,1,1366,1152,214,3292,2702,133,138,251,68
"2021","Newham 041","E02006998",5454,2441,1713,1708,5,12,716,676,40,3013,2183,167,148,371,144
"2021","Newham 042","E02006999",9349,5136,3086,3024,62,10,2040,1876,164,4213,3414,208,125,388,78
"2021","Redbridge 001","E02000751",9045,5535,4742,4716,26,9,784,742,42,3510,2123,184,123,502,578
"2021","Redbridge 002","E02000752",6781,3520,2719,2713,6,3,798,772,26,3261,2115,197,141,484,324
"2021","Redbridge 003","E02000753",5326,2714,2217,2211,6,13,484,464,20,2612,1702,170,97,379,264
"2021","Redbridge 004","E02000754",5459,3112,2349,2327,22,7,756,732,24,2347,1577,117,92,322,239
"2021","Redbridge 005","E02000755",4400,2362,1838,1832,6,6,518,488,30,2038,1320,88,73,353,204
"2021","Redbridge 006","E02000756",11497,6290,5292,5284,8,8,990,950,40,5207,3376,393,220,700,518
"2021","Redbridge 007","E02000757",9965,5906,4527,4475,52,19,1360,1270,90,4059,2757,164,157,540,441
"2021","Redbridge 008","E02000758",5453,2911,2600,2596,4,19,292,282,10,2542,1646,177,82,308,329
"2021","Redbridge 009","E02000759",10202,5818,4675,4636,39,12,1131,1058,73,4384,2996,222,186,584,396
"2021","Redbridge 010","E02000760",5874,3068,2690,2686,4,10,368,350,18,2806,1832,210,119,323,322
"2021","Redbridge 012","E02000762",5403,3056,2819,2815,4,7,230,212,18,2347,1478,256,64,216,333
"2021","Redbridge 013","E02000763",6335,3510,3123,3119,4,13,374,354,20,2825,1945,214,80,319,267
"2021","Redbridge 014","E02000764",10111,5862,4306,4192,114,18,1538,1422,116,4249,2725,200,160,576,588
"2021","Redbridge 015","E02000765",5845,3168,2932,2930,2,4,232,228,4,2677,1804,262,101,239,271
"2021","Redbridge 017","E02000767",6536,3813,3437,3427,10,11,365,344,21,2723,1776,222,103,322,300
"2021","Redbridge 018","E02000768",4618,2808,2324,2300,24,8,476,442,34,1810,1227,91,62,214,216
"2021","Redbridge 020","E02000770",6377,3332,2984,2984,0,6,342,332,10,3045,2047,291,121,300,286
"2021","Redbridge 022","E02000772",6269,3382,3018,3012,6,0,364,348,16,2887,1973,298,119,286,211
"2021","Redbridge 023","E02000773",8093,4312,3984,3978,6,16,312,300,12,3781,2702,298,140,304,337
"2021","Redbridge 024","E02000774",6124,3217,2801,2801,0,8,408,386,22,2907,1955,312,97,284,259
"2021","Redbridge 026","E02000776",5318,2882,2605,2597,8,5,272,258,14,2436,1635,267,97,243,194
"2021","Redbridge 027","E02000777",4762,2810,2240,2206,34,4,566,536,30,1952,1306,108,72,245,221
"2021","Redbridge 029","E02000779",6288,3396,2927,2921,6,7,462,432,30,2892,1900,336,125,309,222
"2021","Redbridge 031","E02000781",12291,6432,5956,5954,2,32,444,424,20,5859,3977,626,198,482,576
"2021","Redbridge 032","E02000782",8354,4278,3707,3691,16,11,560,526,34,4076,2811,441,163,392,269
"2021","Redbridge 033","E02000783",5444,2476,2196,2194,2,12,268,244,24,2968,1986,348,131,274,229
"2021","Redbridge 034","E02006800",11179,5866,5137,5125,12,15,714,676,38,5313,3514,562,281,513,443
"2021","Redbridge 035","E02006924",10783,5696,5144,5136,8,10,542,520,22,5087,3289,551,204,520,523
"2021","Redbridge 036","E02006925",11704,6334,5877,5875,2,31,426,406,20,5370,3669,505,151,442,603
"2021","Redbridge 037","E02007017",6549,3536,3157,3143,14,11,368,350,18,3013,2021,199,115,350,328
"2021","Redbridge 038","E02007018",5326,2733,2311,2305,6,8,414,398,16,2593,1735,182,119,323,234
"2021","Redbridge 039","E02007019",5204,3011,2650,2648,2,7,354,342,12,2193,1405,256,102,225,205
"2021","Redbridge 040","E02007020",7376,3695,3367,3360,7,8,320,308,12,3681,2448,459,126,317,331
"2021","Richmond upon Thames 001","E02000784",8097,4752,3983,3921,62,6,763,712,51,3345,2136,159,143,555,352
"2021","Richmond upon Thames 002","E02000785",7894,5090,4058,4008,50,20,1012,954,58,2804,1805,104,101,450,344
"2021","Richmond upon Thames 003","E02000786",8908,5364,4070,4008,62,14,1280,1194,86,3544,2274,123,154,664,329
"2021","Richmond upon Thames 004","E02000787",9590,5707,4306,4258,48,8,1393,1317,76,3883,2563,162,174,638,346
"2021","Richmond upon Thames 005","E02000788",6955,4476,3711,3677,34,14,751,706,45,2479,1652,76,82,408,261
"2021","Richmond upon Thames 006","E02000789",5083,3056,2340,2300,40,12,704,676,28,2027,1286,99,81,338,223
"2021","Richmond upon Thames 007","E02000790",5156,3324,2554,2520,34,6,764,716,48,1832,1243,78,56,300,155
"2021","Richmond upon Thames 008","E02000791",5231,3325,2467,2425,42,6,852,812,40,1906,1165,109,93,324,215
"2021","Richmond upon Thames 009","E02000792",5650,3497,2673,2644,29,8,816,782,34,2153,1373,103,88,356,233
"2021","Richmond upon Thames 010","E02000793",6483,3730,2989,2966,23,14,727,686,41,2753,1780,115,110,351,397
"2021","Richmond upon Thames 011","E02000794",5528,3566,2840,2792,48,2,724,680,44,1962,1340,59,63,253,247
"2021","Richmond upon Thames 012","E02000795",5272,3444,3074,3048,26,2,368,342,26,1828,1138,85,73,260,272
"2021","Richmond upon Thames 013","E02000796",8734,4899,4144,4132,12,16,739,712,27,3835,2515,188,143,502,487
"2021","Richmond upon Thames 014","E02000797",6224,3876,2689,2631,58,3,1184,1110,74,2348,1573,77,117,366,215
"2021","Richmond upon Thames 015","E02000798",8658,5322,4165,4131,34,13,1144,1086,58,3336,2209,110,151,530,336
"2021","Richmond upon Thames 016","E02000799",4762,2976,2371,2347,24,1,604,574,30,1786,1189,48,75,276,198
"2021","Richmond upon Thames 017","E02000800",4128,2252,1807,1774,33,7,438,422,16,1876,1159,56,114,358,189
"2021","Richmond upon Thames 018","E02000801",5608,3595,2806,2768,38,2,787,760,27,2013,1315,51,77,345,225
"2021","Richmond upon Thames 019","E02000802",5563,3476,2761,2743,18,3,712,680,32,2087,1352,46,95,342,252
"2021","Richmond upon Thames 020","E02000803",7809,4378,3502,3474,28,8,868,814,54,3431,2148,114,150,623,396
"2021","Richmond upon Thames 021","E02000804",5805,3548,2698,2674,24,4,846,794,52,2257,1441,71,91,385,269
"2021","Richmond upon Thames 022","E02000805",8617,5246,4108,4058,50,8,1130,1078,52,3371,2196,108,170,562,335
"2021","Richmond upon Thames 023","E02000806",8257,5222,4274,4226,48,6,942,890,52,3035,1892,104,115,537,387
"2021","Southwark 001","E02000807",7166,3476,2113,2035,78,5,1358,1242,116,3690,2965,130,122,311,162
"2021","Southwark 002","E02000808",8039,3203,1667,1537,130,7,1529,1319,210,4836,3912,145,147,453,179
"2021","Southwark 004","E02000810",9875,3850,2137,2053,84,15,1698,1528,170,6025,4697,216,261,600,251
"2021","Southwark 006","E02000812",8623,3090,1772,1672,100,12,1306,1166,140,5533,4319,190,199,624,201
"2021","Southwark 007","E02000813",8435,3240,1800,1734,66,12,1428,1324,104,5195,4034,170,198,572,221
"2021","Southwark 008","E02000814",8809,4198,2388,2320,68,12,1798,1638,160,4611,3664,169,176,425,177
"2021","Southwark 009","E02000815",6108,2094,1125,1073,52,9,960,822,138,4014,3320,180,133,287,94
"2021","Southwark 010","E02000816",7954,3159,1908,1842,66,10,1241,1135,106,4795,3686,196,184,500,229
"2021","Southwark 011","E02000817",5509,1880,1166,1142,24,44,670,628,42,3629,2631,119,188,470,221
"2021","Southwark 012","E02000818",8432,3051,1626,1531,95,15,1410,1210,200,5381,4234,195,182,518,252
"2021","Southwark 013","E02000819",6947,2350,1461,1423,38,15,874,810,64,4597,3424,206,206,542,219
"2021","Southwark 014","E02000820",7548,2552,1391,1293,98,15,1146,948,198,4996,3911,174,193,508,210
"2021","Southwark 015","E02000821",7392,2384,1467,1423,44,15,902,814,88,5008,3516,575,193,514,210
"2021","Southwark 016","E02000822",5406,1752,1033,1009,24,19,700,612,88,3654,2766,174,173,385,156
"2021","Southwark 017","E02000823",7302,2335,1315,1245,70,16,1004,850,154,4967,3740,228,201,574,224
"2021","Southwark 018","E02000824",7871,2479,1618,1588,30,34,827,756,71,5392,3994,249,271,611,267
"2021","Southwark 019","E02000825",7999,2734,1727,1697,30,21,986,868,118,5265,3919,294,258,563,231
"2021","Southwark 020","E02000826",8008,2994,1589,1535,54,15,1390,1174,216,5014,3625,315,223,578,273
"2021","Southwark 021","E02000827",9319,3292,1916,1848,68,12,1364,1206,158,6027,4391,362,306,705,263
"2021","Southwark 022","E02000828",7289,2482,1481,1457,24,21,980,898,82,4807,3605,231,232,523,216
"2021","Southwark 023","E02000829",8949,3475,1880,1816,64,9,1586,1430,156,5474,4020,243,278,619,314
"2021","Southwark 024","E02000830",7509,3339,1833,1777,56,1,1505,1350,155,4170,3218,184,178,404,186
"2021","Southwark 025","E02000831",7772,3548,2011,1919,92,15,1522,1400,122,4224,3336,108,153,407,220
"2021","Southwark 026","E02000832",7975,3168,1876,1836,40,19,1273,1184,89,4807,3530,176,220,543,338
"2021","Southwark 027","E02000833",5941,2430,1556,1522,34,2,872,752,120,3511,2558,164,188,436,165
"2021","Southwark 028","E02000834",7801,4097,2305,2224,81,2,1790,1638,152,3704,2918,87,137,375,187
"2021","Southwark 029","E02000835",5936,2997,2017,1948,69,10,970,908,62,2939,2201,125,114,317,182
"2021","Southwark 030","E02000836",6597,3840,2572,2514,58,6,1262,1176,86,2757,2049,89,103,309,207
"2021","Southwark 031","E02000837",6558,4138,3410,3364,46,8,720,676,44,2420,1709,79,80,293,259
"2021","Southwark 032","E02000838",7551,3960,2613,2547,66,5,1342,1256,86,3591,2661,100,194,420,216
"2021","Southwark 033","E02000839",6472,3322,2321,2275,46,17,984,906,78,3150,2164,154,165,424,243
"2021","Southwark 034","E02006802",7200,2749,1488,1375,113,12,1249,1030,219,4451,3562,161,144,404,180
"2021","Southwark 035","E02006941",4896,2482,1156,1088,68,0,1326,1168,158,2414,1998,98,54,208,56
"2021","Southwark 036","E02006942",5855,2363,1108,1052,56,8,1247,1108,139,3492,2871,105,96,313,107
"2021","Sutton 001","E02000840",7058,3644,2700,2690,10,12,932,882,50,3414,2368,131,165,489,261
"2021","Sutton 002","E02000841",7107,3610,2799,2787,12,15,796,760,36,3497,2400,129,164,502,302
"2021","Sutton 003","E02000842",6617,4044,3400,3392,8,8,636,616,20,2573,1701,102,87,320,363
"2021","Sutton 004","E02000843",7361,4448,3162,3113,49,14,1272,1218,54,2913,2018,84,113,429,269
"2021","Sutton 005","E02000844",6750,3690,2850,2828,22,12,828,794,34,3060,2090,89,132,404,345
"2021","Sutton 006","E02000845",7297,4538,3546,3524,22,12,980,948,32,2759,1808,93,115,393,350
"2021","Sutton 007","E02000846",5974,3710,3040,3030,10,10,660,622,38,2264,1482,82,73,295,332
"2021","Sutton 008","E02000847",7550,4712,3885,3865,20,13,814,782,32,2838,1778,104,90,374,492
"2021","Sutton 009","E02000848",6385,3944,3274,3262,12,6,664,642,22,2441,1615,80,76,319,351
"2021","Sutton 010","E02000849",6403,3697,2867,2845,22,10,820,774,46,2706,1789,97,123,399,298
"2021","Sutton 011","E02000850",8655,5145,4210,4188,22,20,915,874,41,3510,2363,104,136,452,455
"2021","Sutton 012","E02000851",9042,4931,3475,3451,24,14,1442,1368,74,4111,2650,202,175,700,384
"2021","Sutton 013","E02000852",6390,3850,3016,2992,24,8,826,786,40,2540,1652,87,107,407,287
"2021","Sutton 014","E02000853",6306,3739,2934,2924,10,15,790,768,22,2567,1615,95,124,446,287
"2021","Sutton 015","E02000854",5999,3788,2949,2927,22,5,834,798,36,2211,1442,58,74,347,290
"2021","Sutton 016","E02000855",6623,4138,3550,3536,14,2,586,539,47,2485,1557,77,85,328,438
"2021","Sutton 017","E02000856",7374,4418,3584,3556,28,10,824,772,52,2956,1938,108,135,433,342
"2021","Sutton 018","E02000857",7033,3973,2819,2799,20,16,1138,1080,58,3060,1876,135,171,557,321
"2021","Sutton 019","E02000858",6498,3066,2365,2353,12,11,690,652,38,3432,2398,98,171,487,278
"2021","Sutton 020","E02000859",6691,3850,3170,3144,26,14,666,620,46,2841,1710,103,117,435,476
"2021","Sutton 021","E02000860",6883,3674,2540,2518,22,12,1122,1062,60,3209,1966,128,182,613,320
"2021","Sutton 022","E02000861",6192,4272,3851,3837,14,5,416,404,12,1920,1256,81,74,207,302
"2021","Sutton 024","E02000863",5430,3436,2963,2949,14,13,460,441,19,1994,1312,77,80,238,287
"2021","Sutton 025","E02006836",6824,4549,3950,3938,12,15,584,550,34,2275,1456,116,62,294,347
"2021","Tower Hamlets 001","E02000864",9182,4045,2308,2241,67,11,1726,1534,192,5137,4024,194,175,444,300
"2021","Tower Hamlets 002","E02000865",6165,2384,1573,1551,22,3,808,742,66,3781,2952,196,128,311,194
"2021","Tower Hamlets 003","E02000866",8779,3741,2383,2298,85,10,1348,1196,152,5038,3882,235,165,489,267
"2021","Tower Hamlets 004","E02000867",9644,4334,2218,2130,88,6,2110,1860,250,5310,4397,167,148,383,215
"2021","Tower Hamlets 005","E02000868",5866,2520,1460,1426,34,2,1058,964,94,3346,2697,152,86,241,170
"2021","Tower Hamlets 006","E02000869",4860,1950,1250,1196,54,0,700,598,102,2910,2251,128,100,274,157
"2021","Tower Hamlets 007","E02000870",5124,2120,1399,1351,48,5,716,652,64,3004,2362,118,83,247,194
"2021","Tower Hamlets 008","E02000871",8958,3888,2749,2711,38,11,1128,1014,114,5070,3995,273,182,370,250
"2021","Tower Hamlets 009","E02000872",6666,2680,1644,1602,42,0,1036,941,95,3986,3307,155,96,254,174
"2021","Tower Hamlets 010","E02000873",6306,2802,1942,1896,46,12,848,774,74,3504,2780,176,108,273,167
"2021","Tower Hamlets 011","E02000874",5559,2400,1719,1687,32,3,678,622,56,3159,2360,273,105,244,177
"2021","Tower Hamlets 012","E02000875",10682,4656,3208,3168,40,28,1420,1298,122,6026,4839,300,208,451,228
"2021","Tower Hamlets 013","E02000876",5709,2268,1460,1426,34,2,806,708,98,3441,2752,225,100,230,134
"2021","Tower Hamlets 014","E02000877",10891,4790,3266,3212,54,14,1510,1370,140,6101,4942,309,181,402,267
"2021","Tower Hamlets 015","E02000878",8133,3132,2037,1991,46,1,1094,958,136,5001,3994,254,124,330,299
"2021","Tower Hamlets 016","E02000879",6631,2791,2043,2022,21,4,744,664,80,3840,2845,217,139,356,283
"2021","Tower Hamlets 017","E02000880",4956,1998,1482,1464,18,2,514,452,62,2958,2310,171,102,193,182
"2021","Tower Hamlets 018","E02000881",8327,3507,2445,2407,38,14,1048,970,78,4820,3756,234,243,382,205
"2021","Tower Hamlets 019","E02000882",8742,3655,2659,2613,46,0,996,898,98,5087,3871,320,192,347,357
"2021","Tower Hamlets 020","E02000883",6959,2980,2276,2212,64,8,696,640,56,3979,3041,243,137,319,239
"2021","Tower Hamlets 021","E02000884",10173,3962,2484,2420,64,4,1474,1350,124,6211,5144,347,155,311,254
"2021","Tower Hamlets 022","E02000885",5200,2110,1636,1608,28,4,470,400,70,3090,2208,226,131,275,250
"2021","Tower Hamlets 023","E02000886",7897,3704,2228,2136,92,2,1474,1144,330,4193,3402,205,141,296,149
"2021","Tower Hamlets 024","E02000887",8250,3581,2679,2642,37,6,896,814,82,4669,3636,234,190,388,221
"2021","Tower Hamlets 025","E02000888",6839,3218,2162,2100,62,8,1048,948,100,3621,2791,251,107,293,179
"2021","Tower Hamlets 026","E02000889",7147,3552,2164,2104,60,4,1384,1294,90,3595,2895,151,99,287,163
"2021","Tower Hamlets 027","E02000890",5171,2782,1620,1546,74,2,1160,1088,72,2389,1794,158,79,236,122
"2021","Tower Hamlets 030","E02000893",5977,2823,1983,1946,37,2,838,764,74,3154,2328,163,108,365,190
"2021","Tower Hamlets 031","E02000894",9017,4650,3140,3074,66,4,1506,1358,148,4367,3410,294,134,348,181
"2021","Tower Hamlets 032","E02006853",9113,4089,2691,2641,50,17,1381,1271,110,5024,4152,291,133,316,132
"2021","Tower Hamlets 033","E02006854",6199,3042,1920,1856,64,2,1120,1038,82,3157,2563,194,97,245,58
"2021","Tower Hamlets 034","E02007112",5236,2506,1298,1236,62,0,1208,1120,88,2730,2386,146,57,110,31
"2021","Tower Hamlets 035","E02007113",6103,2916,1942,1890,52,8,966,886,80,3187,2622,175,107,204,79
"2021","Tower Hamlets 036","E02007114",6344,2723,1717,1673,44,5,1001,858,143,3621,3023,157,95,248,98
"2021","Waltham Forest 001","E02000895",6807,3556,2879,2871,8,9,668,650,18,3251,2080,118,135,455,463
"2021","Waltham Forest 002","E02000896",7561,4290,3369,3333,36,7,914,864,50,3271,2144,104,146,458,419
"2021","Waltham Forest 003","E02000897",6790,3454,2639,2625,14,11,804,744,60,3336,2227,105,144,492,368
"2021","Waltham Forest 004","E02000898",6458,3378,2652,2640,12,14,712,686,26,3080,1981,110,156,487,346
"2021","Waltham Forest 005","E02000899",7072,3850,3107,3095,12,19,724,686,38,3222,2059,202,134,457,370
"2021","Waltham Forest 006","E02000900",7020,3460,2782,2769,13,13,665,636,29,3560,2379,228,136,487,330
"2021","Waltham Forest 007","E02000901",8337,4914,3803,3739,64,17,1094,1044,50,3423,2466,127,134,410,286
"2021","Waltham Forest 008","E02000902",7583,4024,3102,3070,32,16,906,840,66,3559,2535,181,145,448,250
"2021","Waltham Forest 009","E02000903",7970,3841,2761,2717,44,14,1066,1008,58,4129,2993,214,162,477,283
"2021","Waltham Forest 010","E02000904",6646,3459,2522,2481,41,7,930,872,58,3187,2246,177,140,406,218
"2021","Waltham Forest 011","E02000905",8003,4392,3196,3154,42,8,1188,1116,72,3611,2494,267,177,402,271
"2021","Waltham Forest 012","E02000906",7599,3858,2436,2352,84,8,1414,1308,106,3741,2697,205,153,419,267
"2021","Waltham Forest 013","E02000907",7961,3617,2464,2430,34,12,1141,1074,67,4344,3068,236,235,536,269
"2021","Waltham Forest 014","E02000908",10130,5216,3035,2952,83,15,2166,1990,176,4914,3541,285,219,625,244
"2021","Waltham Forest 015","E02000909",7222,4088,2768,2686,82,14,1306,1222,84,3134,2236,141,135,394,228
"2021","Waltham Forest 016","E02000910",9221,4852,3152,3066,86,16,1684,1530,154,4369,3004,331,166,566,302
"2021","Waltham Forest 017","E02000911",10321,5204,3353,3279,74,17,1834,1662,172,5117,3578,484,220,537,298
"2021","Waltham Forest 018","E02000912",7697,3812,2768,2732,36,10,1034,958,76,3885,2752,317,126,428,262
"2021","Waltham Forest 019","E02000913",7524,3874,3012,2980,32,12,850,784,66,3650,2565,328,129,331,297
"2021","Waltham Forest 020","E02000914",8972,4066,3095,3065,30,17,954,880,74,4906,3410,465,221,518,292
"2021","Waltham Forest 021","E02000915",6594,3378,2191,2151,40,3,1184,1120,64,3216,2294,182,142,403,195
"2021","Waltham Forest 022","E02000916",8479,4116,2712,2666,46,8,1396,1270,126,4363,3061,417,167,488,230
"2021","Waltham Forest 023","E02000917",7676,4180,2680,2636,44,14,1486,1354,132,3496,2480,269,136,421,190
"2021","Waltham Forest 024","E02000918",7484,3540,2485,2439,46,9,1046,954,92,3944,2663,391,154,535,201
"2021","Waltham Forest 025","E02000919",7607,3788,2586,2518,68,14,1188,1080,108,3819,2701,308,131,433,246
"2021","Waltham Forest 026","E02000920",8349,3581,2469,2435,34,18,1094,984,110,4768,3407,346,200,529,286
"2021","Waltham Forest 027","E02000921",9090,3676,2455,2411,44,13,1208,1112,96,5414,3815,441,213,665,280
"2021","Waltham Forest 028","E02000922",8289,4013,2847,2804,43,2,1164,1076,88,4276,2996,351,170,516,243
"2021","Wandsworth 001","E02000923",6393,2978,1933,1873,60,5,1040,972,68,3415,2415,198,104,431,267
"2021","Wandsworth 003","E02000925",6448,2512,1652,1628,24,8,852,792,60,3936,3008,121,129,409,269
"2021","Wandsworth 004","E02000926",9994,4581,2527,2431,96,6,2048,1882,166,5413,4303,162,161,576,211
"2021","Wandsworth 005","E02000927",6126,2614,1524,1478,46,8,1082,1022,60,3512,2775,92,103,351,191
"2021","Wandsworth 006","E02000928",6936,3836,2740,2696,44,4,1092,1032,60,3100,2332,84,80,360,244
"2021","Wandsworth 007","E02000929",6560,2289,1442,1418,24,13,834,768,66,4271,3134,136,196,561,244
"2021","Wandsworth 008","E02000930",8497,3659,1990,1926,64,3,1666,1558,108,4838,4103,119,92,365,159
"2021","Wandsworth 009","E02000931",7103,3794,2544,2484,60,0,1250,1180,70,3309,2820,90,66,225,108
"2021","Wandsworth 010","E02000932",11136,5885,3316,3257,59,19,2550,2414,136,5251,4273,142,107,504,225
"2021","Wandsworth 011","E02000933",7533,4170,2946,2886,60,4,1220,1158,62,3363,2453,143,79,421,267
"2021","Wandsworth 012","E02000934",7890,3748,1927,1877,50,11,1810,1696,114,4142,3411,90,119,389,133
"2021","Wandsworth 013","E02000935",4606,1799,1396,1385,11,3,400,362,38,2807,1954,122,123,409,199
"2021","Wandsworth 014","E02000936",8108,3919,2401,2347,54,4,1514,1442,72,4189,3245,173,118,444,209
"2021","Wandsworth 015","E02000937",6385,3692,2615,2593,22,3,1074,1032,42,2693,2138,74,69,265,147
"2021","Wandsworth 016","E02000938",8469,4081,3033,2999,34,11,1037,973,64,4388,3064,205,155,624,340
"2021","Wandsworth 017","E02000939",5861,3510,2794,2742,52,4,712,662,50,2351,1804,73,60,235,179
"2021","Wandsworth 018","E02000940",7890,3780,2083,2027,56,7,1690,1580,110,4110,3241,143,140,381,205
"2021","Wandsworth 019","E02000941",8197,4604,3120,3076,44,8,1476,1406,70,3593,2767,88,133,405,200
"2021","Wandsworth 020","E02000942",7875,4545,3492,3443,49,11,1042,972,70,3330,2537,108,111,348,226
"2021","Wandsworth 021","E02000943",7494,3661,2224,2151,73,11,1426,1336,90,3833,3182,77,93,297,184
"2021","Wandsworth 022","E02000944",5814,2649,1844,1771,73,7,798,738,60,3165,2304,145,161,374,181
"2021","Wandsworth 023","E02000945",5970,2374,1824,1798,26,4,546,494,52,3596,2522,229,181,424,240
"2021","Wandsworth 024","E02000946",6372,3086,1902,1876,26,6,1178,1122,56,3286,2603,119,98,304,162
"2021","Wandsworth 025","E02000947",7518,4620,3078,3012,66,4,1538,1466,72,2898,2200,110,84,313,191
"2021","Wandsworth 026","E02000948",8617,4022,2305,2203,102,9,1708,1610,98,4595,3868,98,112,332,185
"2021","Wandsworth 027","E02000949",8350,4532,2989,2937,52,13,1530,1448,82,3818,3086,91,88,347,206
"2021","Wandsworth 028","E02000950",6200,3112,2246,2224,22,2,864,822,42,3088,2241,139,91,385,232
"2021","Wandsworth 029","E02000951",5516,2482,1476,1432,44,2,1004,950,54,3034,2453,101,71,264,145
"2021","Wandsworth 030","E02000952",5239,2384,1488,1466,22,8,888,830,58,2855,2281,78,85,245,166
"2021","Wandsworth 031","E02000953",5896,3120,1986,1956,30,4,1130,1062,68,2776,2164,120,64,298,130
"2021","Wandsworth 032","E02000954",5135,2241,1615,1593,22,2,624,576,48,2894,2287,123,43,238,203
"2021","Wandsworth 033","E02000955",5734,2322,1633,1605,28,5,684,652,32,3412,2687,116,94,283,232
"2021","Wandsworth 034","E02000956",6359,2380,1382,1348,34,0,998,900,98,3979,3202,175,109,316,177
"2021","Wandsworth 035","E02000957",9095,3924,2449,2405,44,5,1470,1372,98,5171,3970,389,123,411,278
"2021","Wandsworth 036","E02000958",6443,3222,2496,2460,36,4,722,678,44,3221,2325,156,101,372,267
"2021","Wandsworth 037","E02000959",6293,2846,1921,1894,27,7,918,846,72,3447,2562,191,141,356,197
"2021","Wandsworth 038","E02007083",6745,3324,1742,1672,70,12,1570,1350,220,3421,2774,164,86,325,72
"2021","Wandsworth 039","E02007084",8280,3008,1745,1695,50,3,1260,1164,96,5272,4046,214,198,563,251
"2021","Westminster 001","E02000960",5215,2646,2100,2068,32,4,542,514,28,2569,1726,185,76,333,249
"2021","Westminster 002","E02000961",8021,3750,2852,2820,32,10,888,814,74,4271,3082,239,149,551,250
"2021","Westminster 003","E02000962",6725,2938,2312,2280,32,8,618,568,50,3787,2609,294,108,475,301
"2021","Westminster 004","E02000963",8640,3218,2352,2323,29,18,848,784,64,5422,3898,290,257,628,349
"2021","Westminster 005","E02000964",10291,3623,2409,2360,49,14,1200,1114,86,6668,5006,314,281,740,327
"2021","Westminster 006","E02000965",6776,3102,2058,2004,54,4,1040,982,58,3674,2854,153,111,417,139
"2021","Westminster 007","E02000966",7954,3940,2853,2763,90,15,1072,984,88,4014,2970,248,106,465,225
"2021","Westminster 008","E02000967",5314,2295,1705,1640,65,6,584,548,36,3019,2303,219,64,246,187
"2021","Westminster 009","E02000968",11964,3920,3000,2973,27,60,860,792,68,8044,5853,392,343,852,604
"2021","Westminster 010","E02000969",7578,2668,1924,1912,12,40,704,626,78,4910,3601,202,200,641,266
"2021","Westminster 011","E02000970",6119,2710,1908,1870,38,6,796,706,90,3409,2369,377,101,346,216
"2021","Westminster 012","E02000971",6554,2730,1850,1790,60,4,876,780,96,3824,3007,194,109,342,172
"2021","Westminster 013","E02000972",6978,2422,1376,1280,96,12,1034,894,140,4556,3559,193,125,462,217
"2021","Westminster 014","E02000973",8724,3610,2421,2361,60,2,1187,1101,86,5114,3832,282,203,592,205
"2021","Westminster 015","E02000974",7339,2844,2090,2030,60,10,744,676,68,4495,3182,509,157,435,212
"2021","Westminster 016","E02000975",6505,2805,1792,1726,66,7,1006,872,134,3700,2962,193,115,314,116
"2021","Westminster 017","E02000976",7275,2859,1902,1866,36,0,957,832,125,4416,3290,274,137,486,229
"2021","Westminster 018","E02000977",5356,1986,1211,1119,92,1,774,610,164,3370,2469,265,97,380,159
"2021","Westminster 019","E02000978",5301,2548,2134,2094,40,8,406,376,30,2753,1680,430,69,344,230
"2021","Westminster 020","E02000979",6608,2780,2043,1967,76,7,730,676,54,3828,2831,237,116,446,198
"2021","Westminster 021","E02000980",7623,2928,1948,1890,58,14,966,900,66,4695,3436,281,154,566,258
"2021","Westminster 022","E02000981",7412,2998,1833,1769,64,7,1158,1052,106,4414,3391,208,233,411,171
"2021","Westminster 023","E02000982",6563,2344,1768,1734,34,4,572,524,48,4219,2981,233,147,576,282
"2021","Westminster 024","E02000983",6559,2572,1764,1716,48,6,802,728,74,3987,2869,192,140,475,311
"2021","Medway 001","E02003314",5570,3473,2603,2578,25,8,862,840,22,2097,1126,47,114,391,419
"2021","Medway 002","E02003315",4706,3106,2475,2465,10,1,630,608,22,1600,1014,41,63,247,235
"2021","Medway 003","E02003316",9550,6166,4477,4455,22,21,1668,1628,40,3384,2101,74,156,517,536
"2021","Medway 004","E02003317",5557,3506,2627,2619,8,9,870,832,38,2051,1222,52,112,345,320
"2021","Medway 005","E02003318",4931,3233,2667,2650,17,8,558,528,30,1698,1044,46,56,232,320
"2021","Medway 006","E02003319",6277,3446,2392,2368,24,8,1046,1012,34,2831,1800,88,171,499,273
"2021","Medway 007","E02003320",6929,3832,2657,2621,36,3,1172,1082,90,3097,1962,113,208,581,233
"2021","Medway 008","E02003321",5030,2793,2018,2008,10,5,770,736,34,2237,1462,46,95,345,289
"2021","Medway 009","E02003322",5834,2706,1668,1652,16,6,1032,980,52,3128,2152,123,181,462,210
"2021","Medway 010","E02003323",5600,3120,2183,2163,20,11,926,890,36,2480,1634,65,119,426,236
"2021","Medway 011","E02003324",7661,4545,3055,3043,12,5,1485,1424,61,3116,2053,74,145,511,333
"2021","Medway 012","E02003325",5584,2598,1676,1670,6,10,912,868,44,2986,1985,104,189,509,199
"2021","Medway 013","E02003326",6033,3272,2329,2321,8,3,940,908,32,2761,1734,90,151,474,312
"2021","Medway 014","E02003327",6142,3215,2061,2021,40,4,1150,1076,74,2927,1748,62,184,639,294
"2021","Medway 015","E02003328",7573,3531,2249,2220,29,8,1274,1188,86,4042,2607,189,255,677,314
"2021","Medway 016","E02003329",5275,2786,1977,1951,26,5,804,774,30,2489,1577,119,146,415,232
"2021","Medway 017","E02003330",5304,3017,2070,2038,32,6,941,904,37,2287,1464,65,102,417,239
"2021","Medway 018","E02003331",7173,3920,2853,2835,18,7,1060,1024,36,3253,1913,68,160,593,519
"2021","Medway 019","E02003332",4890,2940,2289,2273,16,11,640,622,18,1950,1245,54,89,316,246
"2021","Medway 020","E02003333",5084,2459,1534,1514,20,6,919,880,39,2625,1677,105,170,456,217
"2021","Medway 021","E02003334",4758,2589,1933,1917,16,5,651,622,29,2169,1437,77,111,320,224
"2021","Medway 022","E02003335",5254,2722,1810,1802,8,14,898,880,18,2532,1734,69,175,359,195
"2021","Medway 023","E02003336",5226,3396,2663,2657,6,3,730,710,20,1830,1000,37,64,279,450
"2021","Medway 024","E02003337",5286,3204,2404,2388,16,6,794,760,34,2082,1263,44,112,376,287
"2021","Medway 025","E02003338",5873,3326,2302,2290,12,6,1018,970,48,2547,1470,45,119,502,411
"2021","Medway 026","E02003339",5114,3164,2531,2513,18,7,626,598,28,1950,1191,57,82,298,322
"2021","Medway 027","E02003340",6303,3603,2691,2678,13,6,906,880,26,2700,1642,69,144,450,395
"2021","Medway 028","E02003341",5339,3521,2684,2664,20,6,831,808,23,1818,1083,35,91,321,288
"2021","Medway 029","E02003342",5170,3315,2565,2551,14,4,746,718,28,1855,1050,35,96,288,386
"2021","Medway 030","E02003343",5051,3484,3009,3003,6,5,470,446,24,1567,941,34,47,195,350
"2021","Medway 031","E02003344",5409,3111,2280,2276,4,1,830,798,32,2298,1405,37,124,445,287
"2021","Medway 032","E02003345",4917,3284,2479,2463,16,5,800,772,28,1633,996,34,81,297,225
"2021","Medway 033","E02003346",5714,3530,2798,2782,16,4,728,710,18,2184,1244,59,93,384,404
"2021","Medway 034","E02003347",4826,3144,2174,2156,18,6,964,942,22,1682,1095,41,95,296,155
"2021","Medway 035","E02003348",6674,4636,3943,3923,20,8,685,670,15,2038,1227,44,67,272,428
"2021","Medway 036","E02003349",5975,3792,2824,2814,10,8,960,926,34,2183,1205,37,125,406,410
"2021","Medway 037","E02003350",5166,3231,2456,2446,10,9,766,738,28,1935,1186,40,94,287,328
"2021","Medway 038","E02003351",6294,4014,2930,2904,26,4,1080,1036,44,2280,1367,38,109,405,361
"2021","Bracknell Forest 001","E02003352",4850,3225,2780,2761,19,3,442,414,28,1625,871,51,53,312,338
"2021","Bracknell Forest 002","E02003353",9538,6582,4835,4801,34,13,1734,1676,58,2956,1811,81,145,564,355
"2021","Bracknell Forest 003","E02003354",8271,5501,4294,4271,23,5,1202,1162,40,2770,1773,75,104,495,323
"2021","Bracknell Forest 004","E02003355",5448,3094,2128,2122,6,2,964,936,28,2354,1537,57,109,409,242
"2021","Bracknell Forest 005","E02003356",5608,3698,2974,2962,12,4,720,696,24,1910,1098,73,78,370,291
"2021","Bracknell Forest 006","E02003357",8036,4612,3268,3244,24,8,1336,1274,62,3424,2118,142,159,615,390
"2021","Bracknell Forest 007","E02003358",9419,5396,3824,3785,39,14,1558,1478,80,4023,2738,118,197,619,351
"2021","Bracknell Forest 008","E02003359",5185,3241,2143,2130,13,6,1092,1052,40,1944,1174,58,112,423,177
"2021","Bracknell Forest 009","E02003360",8900,5627,4244,4216,28,6,1377,1330,47,3273,2113,80,160,571,349
"2021","Bracknell Forest 010","E02003361",5991,3566,2652,2622,30,4,910,866,44,2425,1490,79,101,468,287
"2021","Bracknell Forest 011","E02003362",5293,3156,2399,2389,10,5,752,716,36,2137,1302,51,96,422,266
"2021","Bracknell Forest 012","E02003363",5071,3262,2646,2628,18,4,612,594,18,1809,989,44,88,352,336
"2021","Bracknell Forest 013","E02003364",5519,3554,2804,2790,14,6,744,714,30,1965,1250,53,83,350,229
"2021","Bracknell Forest 014","E02003365",5562,3722,2937,2929,8,5,780,738,42,1840,1124,31,80,326,279
"2021","Bracknell Forest 015","E02003366",5278,3409,2793,2785,8,4,612,588,24,1869,1144,74,73,310,268
"2021","West Berkshire 001","E02003367",5044,3466,2887,2867,20,3,576,554,22,1578,953,47,80,259,239
"2021","West Berkshire 002","E02003368",4757,3068,2357,2345,12,3,708,698,10,1689,998,39,73,293,286
"2021","West Berkshire 003","E02003369",5061,3514,2970,2956,14,0,544,520,24,1547,901,36,78,260,272
"2021","West Berkshire 004","E02003370",5476,3693,3106,3090,16,2,585,554,31,1783,1107,41,64,281,290
"2021","West Berkshire 005","E02003371",4865,3254,2660,2650,10,6,588,556,32,1611,969,37,52,233,320
"2021","West Berkshire 006","E02003372",6332,4124,3368,3360,8,4,752,728,24,2208,1333,66,93,369,347
"2021","West Berkshire 007","E02003373",6349,4510,3792,3778,14,8,710,696,14,1839,1185,46,72,274,262
"2021","West Berkshire 008","E02003374",4790,3010,2256,2242,14,8,746,726,20,1780,1145,47,71,333,184
"2021","West Berkshire 009","E02003375",5030,3114,2300,2288,12,8,806,782,24,1916,1110,47,86,421,252
"2021","West Berkshire 010","E02003376",4772,2938,2234,2210,24,2,702,682,20,1834,970,51,90,396,327
"2021","West Berkshire 011","E02003377",7781,5266,4328,4292,36,4,934,906,28,2515,1398,52,124,506,435
"2021","West Berkshire 012","E02003378",6552,3921,3097,3082,15,4,820,784,36,2631,1442,70,127,502,490
"2021","West Berkshire 013","E02003379",5520,3363,2420,2400,20,11,932,902,30,2157,1397,52,95,367,246
"2021","West Berkshire 014","E02003380",6706,4329,3234,3224,10,4,1091,1053,38,2377,1502,29,105,419,322
"2021","West Berkshire 015","E02003381",4735,3218,2674,2658,16,14,530,512,18,1517,906,34,58,285,234
"2021","West Berkshire 016","E02003382",6000,3544,2596,2590,6,0,948,910,38,2456,1407,65,122,475,387
"2021","West Berkshire 017","E02003383",5443,3619,2858,2848,10,8,753,732,21,1824,1124,29,73,320,278
"2021","West Berkshire 018","E02003384",5327,3696,3101,3091,10,7,588,564,24,1631,941,56,63,246,325
"2021","West Berkshire 019","E02003385",9170,5401,3561,3515,46,9,1831,1773,58,3769,2336,117,190,727,399
"2021","West Berkshire 020","E02003386",6658,4044,3072,3058,14,8,964,936,28,2614,1564,50,116,523,361
"2021","West Berkshire 021","E02003387",7501,5128,4278,4270,8,6,844,816,28,2373,1395,58,100,382,438
"2021","West Berkshire 022","E02003388",4863,3190,2638,2626,12,8,544,524,20,1673,956,24,94,323,276
"2021","Reading 001","E02003389",6499,4156,3496,3476,20,14,646,634,12,2343,1384,60,71,406,422
"2021","Reading 002","E02003390",6100,4354,3828,3812,16,10,516,482,34,1746,1115,43,40,215,333
"2021","Reading 003","E02003391",6603,4225,3426,3400,26,7,792,762,30,2378,1396,79,86,395,422
"2021","Reading 004","E02003392",6983,3973,2492,2472,20,7,1474,1404,70,3010,2065,68,150,455,272
"2021","Reading 005","E02003393",6556,4164,3223,3203,20,9,932,894,38,2392,1520,51,103,315,403
"2021","Reading 006","E02003394",6547,3556,2571,2535,36,15,970,922,48,2991,2009,114,132,449,287
"2021","Reading 007","E02003395",9031,4678,3223,3199,24,13,1442,1374,68,4353,3029,408,172,488,256
"2021","Reading 008","E02003396",7875,4252,2927,2901,26,11,1314,1242,72,3623,2514,188,145,467,309
"2021","Reading 009","E02003397",6368,3571,2710,2686,24,7,854,824,30,2797,1737,73,124,442,421
"2021","Reading 010","E02003398",9356,4361,3022,3011,11,7,1332,1238,94,4995,3650,434,180,485,246
"2021","Reading 012","E02003400",7527,2857,2047,2029,18,4,806,732,74,4670,4001,169,85,230,185
"2021","Reading 013","E02003401",7129,3880,2768,2750,18,10,1102,1058,44,3249,2192,154,142,482,279
"2021","Reading 014","E02003402",8531,4182,2739,2701,38,7,1436,1356,80,4349,3266,325,128,401,229
"2021","Reading 015","E02003403",7452,4058,3106,3082,24,10,942,900,42,3394,2181,142,119,515,437
"2021","Reading 016","E02003404",4929,2381,1846,1841,5,7,528,512,16,2548,1732,137,97,317,265
"2021","Reading 017","E02003405",10148,5281,3723,3695,28,13,1545,1488,57,4867,3416,316,212,595,328
"2021","Reading 018","E02003406",6535,3465,2647,2641,6,9,809,763,46,3070,2064,146,109,407,344
"2021","Reading 019","E02006939",5969,3072,1882,1854,28,2,1188,1108,80,2897,2157,206,98,340,96
"2021","Reading 020","E02006940",6363,3316,1960,1936,24,2,1354,1280,74,3047,2334,186,99,316,112
"2021","Slough 001","E02003407",7826,4170,3332,3322,10,18,820,788,32,3656,2444,166,166,537,343
"2021","Slough 002","E02003408",8401,4556,3897,3895,2,11,648,632,16,3845,2399,393,181,517,355
"2021","Slough 003","E02003409",8069,4376,3476,3454,22,20,880,846,34,3693,2411,188,185,571,338
"2021","Slough 004","E02003410",9073,4690,4145,4135,10,19,526,514,12,4383,2799,499,202,457,426
"2021","Slough 005","E02003411",9251,4743,4236,4228,8,2,505,473,32,4508,2862,542,180,487,437
"2021","Slough 006","E02003412",7868,4511,3754,3750,4,12,745,722,23,3357,2169,203,152,468,365
"2021","Slough 008","E02003414",10069,5761,4689,4677,12,15,1057,1027,30,4308,2843,283,236,602,344
"2021","Slough 009","E02003415",9797,5056,4124,4110,14,16,916,878,38,4741,2941,669,211,566,354
"2021","Slough 010","E02003416",7357,4427,3825,3807,18,12,590,568,22,2930,1890,192,119,420,309
"2021","Slough 011","E02003417",9748,5594,4692,4672,20,12,890,845,45,4154,2598,434,168,589,365
"2021","Slough 012","E02003418",7793,4191,3665,3661,4,11,515,481,34,3602,2331,289,164,470,348
"2021","Slough 013","E02003419",6807,3658,3104,3096,8,8,546,522,24,3149,1996,196,157,506,294
"2021","Slough 014","E02003420",4917,2675,2067,2057,10,12,596,572,24,2242,1360,193,113,392,184
"2021","Slough 015","E02007068",5271,2894,2433,2427,6,5,456,428,28,2377,1550,289,126,261,151
"2021","Slough 016","E02007069",6118,3198,2798,2796,2,4,396,370,26,2920,1806,450,108,324,232
"2021","Windsor and Maidenhead 001","E02003421",4571,2948,2508,2500,8,6,434,412,22,1623,949,100,44,252,278
"2021","Windsor and Maidenhead 002","E02003422",9601,6394,5340,5302,38,10,1044,1008,36,3207,1838,111,142,567,549
"2021","Windsor and Maidenhead 003","E02003423",5086,3027,2463,2448,15,2,562,540,22,2059,1339,89,75,300,256
"2021","Windsor and Maidenhead 004","E02003424",7583,5002,4047,4023,24,7,948,900,48,2581,1535,136,95,410,405
"2021","Windsor and Maidenhead 005","E02003425",10430,6022,4368,4308,60,14,1640,1544,96,4408,2763,229,203,723,490
"2021","Windsor and Maidenhead 006","E02003426",7768,5164,4312,4294,18,2,850,808,42,2604,1623,96,91,408,386
"2021","Windsor and Maidenhead 007","E02003427",6361,3708,2884,2866,18,4,820,780,40,2653,1687,149,121,390,306
"2021","Windsor and Maidenhead 008","E02003428",7233,4596,3842,3822,20,10,744,720,24,2637,1584,72,120,453,408
"2021","Windsor and Maidenhead 009","E02003429",6120,3970,3381,3359,22,5,584,548,36,2150,1288,77,85,362,338
"2021","Windsor and Maidenhead 010","E02003430",4663,2714,1976,1938,38,2,736,700,36,1949,1161,92,106,366,224
"2021","Windsor and Maidenhead 011","E02003431",5672,3390,2721,2691,30,3,666,626,40,2282,1366,112,114,381,309
"2021","Windsor and Maidenhead 012","E02003432",5632,3317,2352,2311,41,7,958,918,40,2315,1340,89,112,497,277
"2021","Windsor and Maidenhead 013","E02003433",5207,3196,2577,2559,18,9,610,576,34,2011,1127,76,82,369,357
"2021","Windsor and Maidenhead 014","E02003434",7181,4010,3109,3089,20,13,888,828,60,3171,1963,86,130,549,443
"2021","Windsor and Maidenhead 015","E02003435",5770,3796,3116,3090,26,0,680,652,28,1974,1225,93,66,332,258
"2021","Windsor and Maidenhead 016","E02003436",7436,4754,3965,3937,28,21,768,732,36,2682,1563,110,109,440,460
"2021","Windsor and Maidenhead 017","E02003437",5828,3656,3091,3077,14,3,562,538,24,2172,1263,91,118,395,305
"2021","Windsor and Maidenhead 018","E02003438",8639,5514,4725,4702,23,19,770,736,34,3125,1790,136,125,567,507
"2021","Wokingham 001","E02003439",4470,3042,2603,2593,10,5,434,424,10,1428,774,56,53,242,303
"2021","Wokingham 002","E02003440",7322,4974,4056,4034,22,6,912,864,48,2348,1342,55,100,409,442
"2021","Wokingham 003","E02003441",6192,4095,3524,3510,14,7,564,538,26,2097,1226,70,73,330,398
"2021","Wokingham 004","E02003442",6619,4546,3613,3596,17,7,926,908,18,2073,1343,55,90,337,248
"2021","Wokingham 005","E02003443",5420,3190,2598,2592,6,10,582,570,12,2230,1265,76,78,385,426
"2021","Wokingham 006","E02003444",7407,4664,4155,4139,16,9,500,472,28,2743,1794,144,81,297,427
"2021","Wokingham 007","E02003445",6950,4602,3862,3844,18,10,730,702,28,2348,1371,68,85,393,431
"2021","Wokingham 008","E02003446",6656,4549,4032,4017,15,5,512,484,28,2107,1381,71,55,250,350
"2021","Wokingham 009","E02003447",8207,5484,4474,4452,22,18,992,942,50,2723,1752,89,101,469,312
"2021","Wokingham 010","E02003448",6332,4380,3600,3584,16,10,770,746,24,1952,1213,51,89,329,270
"2021","Wokingham 011","E02003449",5963,3837,2978,2971,7,7,852,816,36,2126,1365,74,78,399,210
"2021","Wokingham 012","E02003450",10164,6718,5259,5223,36,15,1444,1378,66,3446,2328,142,119,478,379
"2021","Wokingham 013","E02003451",7881,4558,3220,3206,14,4,1334,1258,76,3323,1860,78,165,629,591
"2021","Wokingham 014","E02003452",7274,5020,4018,4002,16,18,984,950,34,2254,1449,63,92,356,294
"2021","Wokingham 015","E02003453",5571,4006,3493,3479,14,5,508,494,14,1565,1005,41,56,218,245
"2021","Wokingham 016","E02003454",6836,4574,3659,3645,14,11,904,876,28,2262,1373,67,94,380,348
"2021","Wokingham 017","E02003455",8187,5768,4330,4292,38,10,1428,1360,68,2419,1504,87,130,404,294
"2021","Wokingham 018","E02003456",6170,4146,3087,3069,18,13,1046,1012,34,2024,1212,72,121,404,215
"2021","Wokingham 019","E02003457",7991,5740,5012,4996,16,10,718,698,20,2251,1420,51,67,363,350
"2021","Wokingham 020","E02003458",6601,4553,3905,3891,14,6,642,620,22,2048,1173,70,83,343,379
"2021","Milton Keynes 001","E02003459",7350,4874,3876,3854,22,4,994,972,22,2476,1364,57,110,485,460
"2021","Milton Keynes 002","E02003460",9351,6370,4934,4900,34,14,1422,1354,68,2981,1728,63,186,519,485
"2021","Milton Keynes 003","E02003461",5918,3821,3058,3044,14,10,753,732,21,2097,1204,42,83,378,390
"2021","Milton Keynes 004","E02003462",6511,4122,3029,3003,26,13,1080,1038,42,2389,1414,43,146,449,337
"2021","Milton Keynes 005","E02003463",5576,3369,2576,2554,22,7,786,744,42,2207,1316,64,114,422,291
"2021","Milton Keynes 006","E02003464",5466,2818,2057,2047,10,3,758,738,20,2648,1700,102,146,424,276
"2021","Milton Keynes 007","E02003465",5207,3235,2599,2587,12,8,628,608,20,1972,1063,70,78,372,389
"2021","Milton Keynes 008","E02003466",6132,3472,2404,2372,32,6,1062,1020,42,2660,1791,113,136,396,224
"2021","Milton Keynes 009","E02003467",5145,2631,1927,1919,8,9,695,662,33,2514,1520,131,129,464,270
"2021","Milton Keynes 010","E02003468",6966,4154,3005,2975,30,5,1144,1096,48,2812,1608,75,135,533,461
"2021","Milton Keynes 011","E02003469",4724,3004,2304,2282,22,4,696,662,34,1720,1014,56,70,331,249
"2021","Milton Keynes 012","E02003470",4480,2080,1514,1502,12,10,556,534,22,2400,1564,91,145,394,206
"2021","Milton Keynes 013","E02003471",5362,2806,2149,2138,11,10,647,620,27,2556,1630,135,97,425,269
"2021","Milton Keynes 014","E02003472",8293,3782,2463,2449,14,5,1314,1222,92,4511,3202,322,240,579,168
"2021","Milton Keynes 015","E02003473",4527,2895,2337,2321,16,2,556,532,24,1632,1025,49,76,294,188
"2021","Milton Keynes 016","E02003474",7006,4092,3136,3108,28,14,942,904,38,2914,1915,139,143,454,263
"2021","Milton Keynes 018","E02003476",6498,2961,2056,2035,21,9,896,876,20,3537,2291,211,191,571,273
"2021","Milton Keynes 020","E02003478",5364,3334,2708,2700,8,6,620,582,38,2030,1226,80,106,389,229
"2021","Milton Keynes 021","E02003479",5908,2966,2177,2164,13,9,780,734,46,2942,1897,195,162,461,227
"2021","Milton Keynes 022","E02003480",6495,3846,2774,2764,10,4,1068,1040,28,2649,1758,78,143,485,185
"2021","Milton Keynes 023","E02003481",6324,2876,1986,1972,14,4,886,828,58,3448,2275,139,205,539,290
"2021","Milton Keynes 024","E02003482",6903,4579,3448,3422,26,20,1111,1064,47,2324,1402,63,121,425,313
"2021","Milton Keynes 025","E02003483",8548,5380,4366,4336,30,8,1006,974,32,3168,2203,113,175,471,206
"2021","Milton Keynes 026","E02003484",5694,3349,2680,2660,20,2,667,628,39,2345,1506,74,111,416,238
"2021","Milton Keynes 027","E02003485",6512,3754,2921,2905,16,14,819,783,36,2758,1747,74,136,397,404
"2021","Milton Keynes 028","E02003486",7736,4976,3958,3942,16,4,1014,976,38,2760,1857,76,143,479,205
"2021","Milton Keynes 029","E02003487",5943,3515,2825,2809,16,6,684,652,32,2428,1460,63,127,385,393
"2021","Milton Keynes 030","E02003488",6724,3756,2765,2751,14,11,980,944,36,2968,1831,126,148,420,443
"2021","Milton Keynes 031","E02003489",6080,3798,2878,2864,14,2,918,876,42,2282,1347,70,102,383,380
"2021","Milton Keynes 032","E02003490",8006,4409,2977,2963,14,13,1419,1368,51,3597,2410,125,241,539,282
"2021","Milton Keynes 033","E02007012",5925,3720,2872,2856,16,8,840,810,30,2205,1524,113,104,328,136
"2021","Milton Keynes 034","E02007013",7049,4524,3262,3246,16,12,1250,1192,58,2525,1790,151,162,344,78
"2021","Milton Keynes 035","E02007014",5379,3202,2379,2375,4,3,820,792,28,2177,1463,80,123,372,139
"2021","Milton Keynes 036","E02007015",7151,4613,3303,3286,17,14,1296,1254,42,2538,1808,88,116,360,166
"2021","Milton Keynes 037","E02007016",6514,4352,3450,3432,18,3,899,864,35,2162,1374,85,86,352,265
"2021","Brighton and Hove 001","E02003491",6223,3758,2828,2778,50,4,926,872,54,2465,1566,50,101,406,342
"2021","Brighton and Hove 002","E02003492",4898,2003,1398,1364,34,7,598,564,34,2895,2243,56,81,285,230
"2021","Brighton and Hove 003","E02003493",6498,4041,3236,3170,66,8,797,720,77,2457,1501,57,95,407,397
"2021","Brighton and Hove 004","E02003494",5342,3385,2658,2603,55,9,718,648,70,1957,1277,42,68,340,230
"2021","Brighton and Hove 005","E02003495",5746,3410,2462,2424,38,4,944,898,46,2336,1421,54,96,429,336
"2021","Brighton and Hove 006","E02003496",6152,3478,2675,2645,30,7,796,754,42,2674,1665,68,107,450,384
"2021","Brighton and Hove 007","E02003497",5998,4008,3369,3306,63,12,627,572,55,1990,1289,74,70,275,282
"2021","Brighton and Hove 008","E02003498",6761,2608,1656,1598,58,4,948,894,54,4153,3181,70,150,494,258
"2021","Brighton and Hove 009","E02003499",6445,2625,1729,1689,40,6,890,838,52,3820,3048,63,107,345,257
"2021","Brighton and Hove 010","E02003500",6383,3750,2659,2545,114,15,1076,998,78,2633,2012,47,93,325,156
"2021","Brighton and Hove 011","E02003501",6879,4120,2900,2768,132,16,1204,1078,126,2759,1915,62,105,442,235
"2021","Brighton and Hove 012","E02003502",6212,3458,2466,2394,72,8,984,904,80,2754,1789,50,129,470,316
"2021","Brighton and Hove 013","E02003503",7218,4105,3104,3037,67,9,992,950,42,3113,2015,55,128,512,403
"2021","Brighton and Hove 014","E02003504",7231,3767,2208,2092,116,10,1549,1389,160,3464,2688,59,123,415,179
"2021","Brighton and Hove 015","E02003505",8029,2914,1458,1360,98,2,1454,1280,174,5115,4476,63,110,350,116
"2021","Brighton and Hove 016","E02003506",5582,3307,2102,2006,96,1,1204,1082,122,2275,1605,42,91,392,145
"2021","Brighton and Hove 017","E02003507",7906,4758,3597,3469,128,5,1156,1034,122,3148,1974,66,123,460,525
"2021","Brighton and Hove 018","E02003508",7447,3128,1786,1676,110,6,1336,1168,168,4319,3697,58,100,314,150
"2021","Brighton and Hove 019","E02003509",7635,3700,1886,1784,102,2,1812,1618,194,3935,2728,82,192,667,266
"2021","Brighton and Hove 020","E02003510",7268,3793,2275,2162,113,6,1512,1358,154,3475,2430,85,129,549,282
"2021","Brighton and Hove 021","E02003511",6799,3958,2781,2667,114,3,1174,1062,112,2841,1879,57,132,491,282
"2021","Brighton and Hove 022","E02003512",7523,3012,1567,1447,120,7,1438,1264,174,4511,3821,39,97,411,143
"2021","Brighton and Hove 023","E02003513",5123,2842,2128,2050,78,6,708,630,78,2281,1496,49,93,382,261
"2021","Brighton and Hove 024","E02003514",7634,3666,1539,1417,122,5,2122,1880,242,3968,3172,72,117,479,128
"2021","Brighton and Hove 025","E02003515",7201,3006,1976,1910,66,6,1024,964,60,4195,2986,88,153,597,371
"2021","Brighton and Hove 026","E02003516",7428,3330,1460,1310,150,6,1864,1656,208,4098,3023,100,144,621,210
"2021","Brighton and Hove 027","E02003517",9547,3614,1749,1529,220,3,1862,1604,258,5933,4875,108,153,630,167
"2021","Brighton and Hove 028","E02003518",6484,3148,1785,1680,105,3,1360,1154,206,3336,2163,89,142,620,322
"2021","Brighton and Hove 029","E02003519",7566,3258,1320,1192,128,4,1934,1658,276,4308,3363,106,119,586,134
"2021","Brighton and Hove 030","E02003520",7849,3018,1442,1288,154,6,1570,1264,306,4831,3674,186,143,571,257
"2021","Brighton and Hove 031","E02003521",6947,3001,1577,1377,200,4,1420,1108,312,3946,2851,86,133,577,299
"2021","Brighton and Hove 032","E02003522",6552,3040,1938,1752,186,4,1098,886,212,3512,2434,92,141,593,252
"2021","Brighton and Hove 033","E02003523",8671,5392,4166,3950,216,6,1220,1060,160,3279,1819,87,129,625,619
"2021","Portsmouth 001","E02003524",6246,3255,2232,2204,28,8,1015,985,30,2991,1943,67,140,507,334
"2021","Portsmouth 002","E02003525",5000,2529,1720,1712,8,6,803,788,15,2471,1634,92,120,378,247
"2021","Portsmouth 003","E02003526",5621,3690,3061,3047,14,9,620,606,14,1931,1068,34,75,274,480
"2021","Portsmouth 004","E02003527",5146,3178,2254,2230,24,8,916,872,44,1968,1119,54,90,423,282
"2021","Portsmouth 006","E02003529",6605,4040,3074,3058,16,4,962,924,38,2565,1607,64,107,426,361
"2021","Portsmouth 007","E02003530",6264,3806,2877,2843,34,17,912,870,42,2458,1485,56,122,463,332
"2021","Portsmouth 008","E02003531",6464,3992,3020,3000,20,2,970,922,48,2472,1490,49,98,460,375
"2021","Portsmouth 009","E02003532",6304,3514,2451,2423,28,11,1052,1000,52,2790,1786,90,135,507,272
"2021","Portsmouth 010","E02003533",4567,2410,1522,1504,18,4,884,856,28,2157,1303,61,111,428,254
"2021","Portsmouth 011","E02003534",7068,4150,2880,2858,22,1,1269,1223,46,2918,1965,70,139,460,284
"2021","Portsmouth 012","E02003535",7454,4084,2614,2590,24,8,1462,1372,90,3370,2268,77,145,589,291
"2021","Portsmouth 013","E02003536",5974,2364,1580,1552,28,10,774,738,36,3610,2300,115,181,681,333
"2021","Portsmouth 014","E02003537",8269,4956,3518,3496,22,14,1424,1348,76,3313,2087,57,166,564,439
"2021","Portsmouth 015","E02003538",8144,4076,2510,2480,30,4,1562,1492,70,4068,2759,112,202,683,312
"2021","Portsmouth 017","E02003540",7585,4430,3260,3228,32,2,1168,1122,46,3155,1888,72,129,585,481
"2021","Portsmouth 018","E02003541",8541,2720,1784,1770,14,10,926,860,66,5821,4465,115,177,681,383
"2021","Portsmouth 019","E02003542",7407,3438,2180,2152,28,4,1254,1170,84,3969,3010,78,114,474,293
"2021","Portsmouth 020","E02003543",7650,2820,1700,1660,40,11,1109,1050,59,4830,3962,76,131,461,200
"2021","Portsmouth 021","E02003544",5128,2860,1782,1726,56,6,1072,1000,72,2268,1472,43,110,439,204
"2021","Portsmouth 022","E02003545",5879,2736,1576,1538,38,4,1156,1078,78,3143,2190,59,132,523,239
"2021","Portsmouth 023","E02003546",6685,3842,2727,2687,40,13,1102,1034,68,2843,1673,91,136,587,356
"2021","Portsmouth 024","E02003547",7100,3398,2301,2261,40,9,1088,1002,86,3702,2389,114,146,602,451
"2021","Portsmouth 025","E02003548",5205,2643,1766,1740,26,5,872,824,48,2562,1833,77,95,385,172
"2021","Portsmouth 026","E02006821",5312,3528,2845,2833,12,5,678,652,26,1784,1092,44,70,266,312
"2021","Portsmouth 027","E02006975",4500,1678,956,944,12,2,720,660,60,2822,2105,64,117,364,172
"2021","Portsmouth 028","E02006976",4073,1526,1040,1032,8,4,482,452,30,2547,1669,82,132,472,192
"2021","Southampton 001","E02003549",5602,3174,2537,2515,22,7,630,588,42,2428,1663,113,79,299,274
"2021","Southampton 002","E02003550",6355,3802,2842,2822,20,10,950,912,38,2553,1607,66,107,442,331
"2021","Southampton 003","E02003551",4098,2079,1416,1410,6,10,653,618,35,2019,1233,66,86,407,227
"2021","Southampton 004","E02003552",5027,2707,1987,1981,6,6,714,686,28,2320,1372,47,90,464,347
"2021","Southampton 005","E02003553",5709,2226,1654,1648,6,9,563,528,35,3483,2816,108,99,280,180
"2021","Southampton 006","E02003554",4992,2926,2138,2120,18,4,784,748,36,2066,1292,67,76,321,310
"2021","Southampton 007","E02003555",6877,3824,2683,2667,16,7,1134,1104,30,3053,1955,78,144,518,358
"2021","Southampton 008","E02003556",4601,2902,2160,2148,12,7,735,704,31,1699,1021,41,81,296,260
"2021","Southampton 009","E02003557",5930,2539,1933,1911,22,5,601,572,29,3391,2693,92,74,285,247
"2021","Southampton 010","E02003558",5607,2834,1998,1980,18,6,830,784,46,2773,1759,116,145,483,270
"2021","Southampton 011","E02003559",6241,4020,3287,3267,20,7,726,676,50,2221,1434,88,80,302,317
"2021","Southampton 012","E02003560",5623,2884,1883,1870,13,9,992,952,40,2739,1847,41,119,459,273
"2021","Southampton 013","E02003561",6403,2476,1522,1508,14,5,949,898,51,3927,3041,114,115,443,214
"2021","Southampton 014","E02003562",6707,3932,2766,2740,26,8,1158,1086,72,2775,1788,70,133,472,312
"2021","Southampton 015","E02003563",6358,3491,2442,2410,32,4,1045,998,47,2867,1763,85,142,526,351
"2021","Southampton 016","E02003564",6369,3659,2630,2610,20,5,1024,990,34,2710,1674,54,127,484,371
"2021","Southampton 017","E02003565",5899,2004,1119,1105,14,9,876,816,60,3895,3313,125,73,275,109
"2021","Southampton 018","E02003566",5138,2932,2137,2123,14,11,784,742,42,2206,1258,52,117,436,343
"2021","Southampton 019","E02003567",6216,3488,2479,2469,10,19,990,944,46,2728,1821,94,100,433,280
"2021","Southampton 020","E02003568",6834,3494,2200,2160,40,2,1292,1218,74,3340,2531,116,118,422,153
"2021","Southampton 021","E02003569",6503,3341,1992,1952,40,2,1347,1253,94,3162,2114,135,154,565,194
"2021","Southampton 022","E02003570",8315,3539,2479,2465,14,13,1047,977,70,4776,3445,440,187,483,221
"2021","Southampton 023","E02003571",6423,2108,1140,1114,26,0,968,878,90,4315,3577,107,87,358,186
"2021","Southampton 024","E02003572",4910,3093,2376,2356,20,9,708,672,36,1817,1125,50,97,296,249
"2021","Southampton 025","E02003573",6139,3350,2429,2425,4,5,916,852,64,2789,1755,50,112,475,397
"2021","Southampton 026","E02003574",6377,3940,2937,2921,16,9,994,952,42,2437,1397,59,114,468,399
"2021","Southampton 027","E02003575",4922,2460,1622,1608,14,10,828,778,50,2462,1549,46,112,478,277
"2021","Southampton 028","E02003576",6436,3556,2485,2459,26,9,1062,1014,48,2880,1815,81,145,555,284
"2021","Southampton 030","E02003578",5198,3118,2206,2188,18,6,906,860,46,2080,1299,39,102,366,274
"2021","Southampton 031","E02003579",7664,4511,2843,2807,36,6,1662,1574,88,3153,2113,50,158,538,294
"2021","Southampton 032","E02003580",4677,2422,1598,1586,12,10,814,776,38,2255,1418,43,117,455,222
"2021","Southampton 033","E02007074",5218,2352,1419,1409,10,5,928,848,80,2866,2075,126,133,392,140
"2021","Southampton 034","E02007075",4846,2480,1212,1186,26,4,1264,1150,114,2366,1828,79,90,298,71
"2021","Isle of Wight 001","E02003581",6381,3510,2394,2356,38,6,1110,1046,64,2871,1603,74,169,667,358
"2021","Isle of Wight 002","E02003582",7137,4637,3685,3663,22,3,949,909,40,2500,1345,67,91,486,511
"2021","Isle of Wight 003","E02003583",6347,3921,2901,2880,21,4,1016,996,20,2426,1325,54,108,500,439
"2021","Isle of Wight 004","E02003584",5148,2378,1592,1564,28,2,784,748,36,2770,1568,50,157,678,317
"2021","Isle of Wight 005","E02003585",5680,3784,3066,3054,12,6,712,670,42,1896,889,50,65,394,498
"2021","Isle of Wight 006","E02003586",6193,3694,2838,2820,18,6,850,828,22,2499,1356,45,120,507,471
"2021","Isle of Wight 007","E02003587",6833,3852,2682,2662,20,6,1164,1128,36,2981,1748,55,161,634,383
"2021","Isle of Wight 008","E02003588",6688,3964,2747,2719,28,7,1210,1160,50,2724,1589,50,127,580,378
"2021","Isle of Wight 009","E02003589",6001,3147,2026,2009,17,3,1118,1084,34,2854,1688,49,151,617,349
"2021","Isle of Wight 010","E02003590",6451,4218,3562,3546,16,2,654,632,22,2233,965,73,79,477,639
"2021","Isle of Wight 011","E02003591",7639,4705,3530,3500,30,6,1169,1135,34,2934,1663,71,132,536,532
"2021","Isle of Wight 012","E02003592",8418,5156,4183,4155,28,5,968,928,40,3262,1573,69,168,661,791
"2021","Isle of Wight 013","E02003593",4631,3145,2612,2590,22,5,528,512,16,1486,754,43,67,302,320
"2021","Isle of Wight 014","E02003594",7726,4414,3324,3302,22,10,1080,1046,34,3312,1800,61,200,707,544
"2021","Isle of Wight 015","E02003595",7016,4649,3778,3748,30,1,870,852,18,2367,1182,50,94,431,610
"2021","Isle of Wight 016","E02003596",7222,3992,3095,3069,26,7,890,840,50,3230,1605,82,189,735,619
"2021","Isle of Wight 017","E02003597",4930,3266,2675,2659,16,3,588,580,8,1664,849,51,67,323,374
"2021","Isle of Wight 018","E02003598",6243,3572,2794,2750,44,6,772,744,28,2671,1320,81,136,610,524
"2021","Buckinghamshire 001","E02003652",7703,5176,4138,4128,10,6,1032,994,38,2527,1532,58,120,468,349
"2021","Buckinghamshire 002","E02003653",5387,3210,2419,2407,12,5,786,754,32,2177,1294,45,125,388,325
"2021","Buckinghamshire 003","E02003654",4804,3417,2818,2804,14,7,592,578,14,1387,787,36,62,234,268
"2021","Buckinghamshire 004","E02003655",8358,5712,4541,4507,34,13,1158,1116,42,2646,1558,65,133,486,404
"2021","Buckinghamshire 005","E02003656",5458,3584,2772,2758,14,4,808,768,40,1874,1056,40,88,337,353
"2021","Buckinghamshire 006","E02003657",5968,4180,3379,3369,10,7,794,764,30,1788,1028,67,76,317,300
"2021","Buckinghamshire 007","E02003658",7915,5438,4145,4123,22,3,1290,1232,58,2477,1472,59,127,418,401
"2021","Buckinghamshire 009","E02003659",7614,5018,3971,3936,35,13,1034,984,50,2596,1647,83,128,408,330
"2021","Buckinghamshire 008","E02003660",8749,6088,4922,4902,20,12,1154,1118,36,2661,1560,53,143,478,427
"2021","Buckinghamshire 010","E02003661",4504,3084,2494,2488,6,6,584,562,22,1420,855,36,60,234,235
"2021","Buckinghamshire 012","E02003662",5033,2884,2139,2129,10,8,737,716,21,2149,1326,90,119,397,217
"2021","Buckinghamshire 011","E02003663",10071,6558,4751,4717,34,11,1796,1726,70,3513,2416,142,176,555,224
"2021","Buckinghamshire 013","E02003664",6048,3387,2430,2426,4,12,945,894,51,2661,1689,134,117,456,265
"2021","Buckinghamshire 014","E02003665",4681,2849,2115,2104,11,6,728,700,28,1832,1152,49,92,323,216
"2021","Buckinghamshire 015","E02003666",6205,3211,2252,2238,14,6,953,886,67,2994,1874,162,161,508,289
"2021","Buckinghamshire 016","E02003667",7470,4704,3339,3301,38,5,1360,1294,66,2766,1761,86,164,539,216
"2021","Buckinghamshire 018","E02003668",7066,4701,3995,3983,12,12,694,676,18,2365,1396,49,73,336,511
"2021","Buckinghamshire 017","E02003669",5635,3011,2244,2236,8,7,760,720,40,2624,1692,151,116,421,244
"2021","Buckinghamshire 019","E02003670",7325,4508,3468,3448,20,8,1032,990,42,2817,1773,88,132,529,295
"2021","Buckinghamshire 020","E02003671",4693,2657,1934,1920,14,3,720,688,32,2036,1313,64,94,384,181
"2021","Buckinghamshire 021","E02003672",9835,6869,5523,5498,25,6,1340,1308,32,2966,1809,70,131,498,458
"2021","Buckinghamshire 022","E02003673",7589,5310,4406,4390,16,12,892,852,40,2279,1201,54,112,434,478
"2021","Buckinghamshire 023","E02003674",4510,3190,2706,2696,10,4,480,458,22,1320,721,31,55,245,268
"2021","Buckinghamshire 024","E02003675",7137,4622,3779,3739,40,7,836,806,30,2515,1442,45,135,465,428
"2021","Buckinghamshire 029","E02003676",6673,4635,4013,3986,27,6,616,594,22,2038,1211,51,67,342,367
"2021","Buckinghamshire 027","E02003677",8120,4950,3877,3857,20,17,1056,1030,26,3170,2007,138,140,441,444
"2021","Buckinghamshire 028","E02003678",4602,3010,2451,2441,10,9,550,520,30,1592,996,60,64,226,246
"2021","Buckinghamshire 030","E02003679",5501,3162,2239,2217,22,7,916,884,32,2339,1372,41,117,490,319
"2021","Buckinghamshire 031","E02003680",7986,5283,4486,4470,16,7,790,760,30,2703,1522,51,108,471,551
"2021","Buckinghamshire 032","E02003681",8200,5458,4708,4690,18,6,744,716,28,2742,1619,64,104,407,548
"2021","Buckinghamshire 034","E02003682",6032,4010,3397,3379,18,7,606,582,24,2022,1223,57,76,325,341
"2021","Buckinghamshire 035","E02003683",5582,3768,3298,3288,10,2,468,458,10,1814,1149,53,67,261,284
"2021","Buckinghamshire 047","E02003685",6407,4367,3779,3756,23,8,580,562,18,2040,1180,50,82,325,403
"2021","Buckinghamshire 050","E02003686",6012,3918,3376,3360,16,6,536,518,18,2094,1225,79,58,315,417
"2021","Buckinghamshire 054","E02003687",4530,2956,2587,2575,12,5,364,354,10,1574,966,42,48,242,276
"2021","Buckinghamshire 053","E02003688",9571,6129,5186,5172,14,9,934,888,46,3442,2008,115,127,567,625
"2021","Buckinghamshire 058","E02003689",7353,4804,4301,4285,16,3,500,470,30,2549,1563,174,95,271,446
"2021","Buckinghamshire 059","E02003690",6167,3574,2804,2796,8,14,756,728,28,2593,1456,101,105,424,507
"2021","Buckinghamshire 063","E02003691",5742,3672,3138,3124,14,8,526,518,8,2070,1178,90,84,351,367
"2021","Buckinghamshire 064","E02003692",7234,4427,3813,3795,18,11,603,581,22,2807,1665,128,111,426,477
"2021","Buckinghamshire 065","E02003693",6003,4017,3336,3318,18,2,679,657,22,1986,1148,104,74,297,363
"2021","Buckinghamshire 066","E02003694",6722,4051,3220,3206,14,9,822,780,42,2671,1612,68,112,498,381
"2021","Buckinghamshire 067","E02003695",8798,5362,4429,4413,16,13,920,892,28,3436,2137,177,123,517,482
"2021","Buckinghamshire 026","E02003696",7111,4487,3622,3602,20,7,858,838,20,2624,1392,50,110,443,629
"2021","Buckinghamshire 025","E02003697",5195,3682,3074,3066,8,4,604,586,18,1513,914,37,59,243,260
"2021","Buckinghamshire 033","E02003698",6924,4941,4240,4220,20,8,693,676,17,1983,1211,42,56,285,389
"2021","Buckinghamshire 037","E02003699",4732,3076,2399,2391,8,4,673,662,11,1656,974,35,60,307,280
"2021","Buckinghamshire 038","E02003701",9265,5626,4589,4571,18,7,1030,990,40,3639,2282,139,151,543,524
"2021","Buckinghamshire 040","E02003702",6570,4552,3712,3690,22,12,828,806,22,2018,1209,66,84,346,313
"2021","Buckinghamshire 041","E02003703",7058,4252,3204,3186,18,6,1042,1012,30,2806,1913,138,128,385,242
"2021","Buckinghamshire 045","E02003704",4691,3247,2710,2700,10,4,533,520,13,1444,865,55,56,226,242
"2021","Buckinghamshire 042","E02003705",5531,3083,2352,2343,9,13,718,644,74,2448,1595,162,124,346,221
"2021","Buckinghamshire 043","E02003706",5331,3067,2341,2329,12,12,714,688,26,2264,1489,76,100,363,236
"2021","Buckinghamshire 044","E02003707",5295,3018,2309,2289,20,9,700,666,34,2277,1545,141,93,310,188
"2021","Buckinghamshire 046","E02003708",7508,3714,2978,2970,8,8,728,690,38,3794,2509,362,177,435,311
"2021","Buckinghamshire 048","E02003709",4392,2392,1763,1753,10,9,620,600,20,2000,1291,69,102,326,212
"2021","Buckinghamshire 049","E02003710",9347,5451,4327,4295,32,9,1115,1058,57,3896,2709,271,157,401,358
"2021","Buckinghamshire 051","E02003711",7641,4373,2925,2898,27,6,1442,1374,68,3268,2125,110,157,617,259
"2021","Buckinghamshire 052","E02003712",6439,3775,3003,2999,4,5,767,742,25,2664,1554,86,116,468,440
"2021","Buckinghamshire 055","E02003713",4781,3181,2652,2648,4,2,527,518,9,1600,937,40,42,231,350
"2021","Buckinghamshire 056","E02003714",5427,3258,2412,2390,22,10,836,806,30,2169,1343,56,101,399,270
"2021","Buckinghamshire 057","E02003715",5313,3790,3379,3371,8,3,408,398,10,1523,911,37,55,237,283
"2021","Buckinghamshire 060","E02003716",4904,3131,2370,2362,8,7,754,740,14,1773,968,54,70,356,325
"2021","Buckinghamshire 062","E02003717",7241,4636,3871,3865,6,13,752,726,26,2605,1352,47,111,552,543
"2021","Buckinghamshire 061","E02003718",4432,2732,2108,2098,10,4,620,592,28,1700,923,39,78,389,271
"2021","Buckinghamshire 039","E02006823",7102,4956,4387,4371,16,7,562,544,18,2146,1204,71,76,344,451
"2021","Buckinghamshire 036","E02006824",7667,4994,4250,4240,10,8,736,706,30,2673,1558,69,104,435,507
"2021","Eastbourne 001","E02004356",5892,3330,2398,2384,14,4,928,894,34,2562,1535,33,128,512,354
"2021","Eastbourne 002","E02004357",5993,3440,2406,2374,32,6,1028,984,44,2553,1594,43,114,488,314
"2021","Eastbourne 003","E02004358",6413,3756,2803,2777,26,7,946,908,38,2657,1427,50,131,531,518
"2021","Eastbourne 004","E02004359",6388,3750,2867,2835,32,9,874,814,60,2638,1489,36,112,500,501
"2021","Eastbourne 006","E02004361",6455,4020,3266,3226,40,4,750,712,38,2435,1409,56,117,442,411
"2021","Eastbourne 007","E02004362",7043,4020,2944,2896,48,12,1064,988,76,3023,1861,79,144,562,377
"2021","Eastbourne 008","E02004363",5626,3017,2191,2144,47,6,820,766,54,2609,1507,92,133,526,351
"2021","Eastbourne 009","E02004364",6787,3740,2774,2718,56,4,962,910,52,3047,1649,60,139,746,453
"2021","Eastbourne 010","E02004365",6969,2936,1604,1572,32,2,1330,1220,110,4033,2654,142,249,740,248
"2021","Eastbourne 011","E02004366",6295,2912,1880,1804,76,10,1022,954,68,3383,1823,108,160,737,555
"2021","Eastbourne 012","E02004367",5610,3352,2753,2691,62,3,596,550,46,2258,983,65,97,460,653
"2021","Eastbourne 013","E02006857",7322,4382,3301,3263,38,9,1072,1028,44,2940,1598,61,128,607,546
"2021","Eastbourne 014","E02006858",5898,3472,2592,2552,40,4,876,840,36,2426,1272,65,138,571,380
"2021","Hastings 001","E02004368",6644,4148,3169,3137,32,11,968,928,40,2496,1506,59,130,452,349
"2021","Hastings 002","E02004369",8408,5488,4424,4382,42,10,1054,1012,42,2920,1528,71,115,510,696
"2021","Hastings 003","E02004370",6229,3204,2147,2125,22,9,1048,1008,40,3025,1858,55,159,621,332
"2021","Hastings 004","E02004371",5569,3194,2149,2115,34,15,1030,988,42,2375,1451,33,114,459,318
"2021","Hastings 005","E02004372",5342,2633,1697,1669,28,5,931,878,53,2709,1693,46,185,531,254
"2021","Hastings 006","E02004373",7034,4022,2865,2841,24,5,1152,1110,42,3012,1794,62,136,583,437
"2021","Hastings 007","E02004374",6068,3300,2188,2108,80,2,1110,1044,66,2768,1651,73,139,571,334
"2021","Hastings 008","E02004375",6875,3570,2326,2246,80,20,1224,1158,66,3305,2047,90,135,713,320
"2021","Hastings 009","E02004376",5853,2511,1375,1324,51,8,1128,1056,72,3342,2111,92,200,708,231
"2021","Hastings 010","E02004377",8452,4983,3602,3548,54,12,1369,1304,65,3469,2057,71,173,719,449
"2021","Hastings 011","E02004378",6905,2792,1547,1483,64,9,1236,1148,88,4113,2455,100,259,986,313
"2021","Lewes 001","E02004379",6227,4196,3437,3407,30,1,758,720,38,2031,1195,47,103,351,335
"2021","Lewes 002","E02004380",7709,5249,4295,4261,34,14,940,900,40,2460,1340,45,97,436,542
"2021","Lewes 003","E02004381",7738,4259,3087,3034,53,10,1162,1088,74,3479,2022,55,199,739,464
"2021","Lewes 004","E02004382",5329,3428,2730,2690,40,4,694,654,40,1901,1004,45,63,374,415
"2021","Lewes 005","E02004383",5658,3410,2672,2628,44,2,736,696,40,2248,1310,67,103,468,300
"2021","Lewes 006","E02004384",6094,3652,2808,2674,134,10,834,738,96,2442,1378,54,105,487,418
"2021","Lewes 007","E02004385",6439,3828,2936,2856,80,8,884,834,50,2611,1416,52,114,510,519
"2021","Lewes 008","E02004386",5392,3143,2286,2238,48,7,850,806,44,2249,1244,48,136,429,392
"2021","Lewes 009","E02004387",4618,2573,1757,1723,34,3,813,789,24,2045,1296,33,128,385,203
"2021","Lewes 010","E02004388",6345,3649,2699,2598,101,12,938,870,68,2696,1523,66,127,532,448
"2021","Lewes 011","E02004389",7897,5324,4282,4228,54,6,1036,968,68,2573,1256,73,96,472,676
"2021","Lewes 012","E02004390",6757,4394,3547,3503,44,7,840,794,46,2363,1204,63,104,406,586
"2021","Lewes 013","E02004391",5534,2963,2108,2056,52,5,850,790,60,2571,1267,61,142,597,504
"2021","Rother 001","E02004392",7371,4814,3900,3872,28,10,904,868,36,2557,1389,63,109,536,460
"2021","Rother 002","E02004393",5476,3544,2870,2842,28,8,666,642,24,1932,983,44,94,356,455
"2021","Rother 003","E02004394",6611,4456,3600,3564,36,6,850,810,40,2155,1214,53,102,389,397
"2021","Rother 004","E02004395",6532,3801,2869,2812,57,4,928,890,38,2731,1378,76,127,584,566
"2021","Rother 005","E02004396",7848,5370,4393,4323,70,3,974,948,26,2478,1283,83,94,416,602
"2021","Rother 006","E02004397",6518,4124,3258,3236,22,8,858,830,28,2394,1302,58,103,461,470
"2021","Rother 007","E02004398",7252,3879,2688,2658,30,13,1178,1126,52,3373,2004,73,165,645,486
"2021","Rother 008","E02004399",6713,4020,3174,3144,30,6,840,808,32,2693,1323,68,123,554,625
"2021","Rother 009","E02004400",9250,6333,5378,5340,38,1,954,904,50,2917,1368,77,107,491,874
"2021","Rother 010","E02004401",6780,4254,3554,3506,48,4,696,664,32,2526,1093,62,97,519,755
"2021","Rother 011","E02004402",7510,3444,2282,2235,47,6,1156,1094,62,4066,2011,124,206,1031,694
"2021","Wealden 001","E02004403",5295,3256,2693,2675,18,11,552,528,24,2039,1173,53,96,395,322
"2021","Wealden 002","E02004404",5279,3653,3036,3018,18,6,611,592,19,1626,909,49,58,312,298
"2021","Wealden 003","E02004405",4918,3208,2679,2663,16,5,524,500,24,1710,954,35,69,305,347
"2021","Wealden 004","E02004406",6045,4148,3503,3486,17,1,644,628,16,1897,1028,41,68,338,422
"2021","Wealden 005","E02004407",6642,4410,3749,3709,40,7,654,626,28,2232,1177,47,102,482,424
"2021","Wealden 006","E02004408",6468,4114,3129,3107,22,3,982,946,36,2354,1363,50,119,472,350
"2021","Wealden 007","E02004409",4378,3024,2562,2544,18,8,454,444,10,1354,764,44,75,216,255
"2021","Wealden 008","E02004410",6668,4718,3939,3893,46,9,770,744,26,1950,1106,51,78,326,389
"2021","Wealden 009","E02004411",6953,4326,3356,3336,20,7,963,931,32,2627,1388,47,128,557,507
"2021","Wealden 010","E02004412",6685,4287,3404,3378,26,8,875,848,27,2398,1274,50,108,534,432
"2021","Wealden 011","E02004413",6066,4092,3285,3247,38,11,796,764,32,1974,1109,35,91,368,371
"2021","Wealden 012","E02004414",5298,3345,2542,2516,26,8,795,776,19,1953,1138,32,105,408,270
"2021","Wealden 013","E02004415",5497,3822,3096,3076,20,6,720,700,20,1675,979,37,72,296,291
"2021","Wealden 014","E02004416",5502,3718,2990,2966,24,18,710,686,24,1784,987,45,78,322,352
"2021","Wealden 015","E02004417",5365,3428,2632,2616,16,4,792,766,26,1937,999,45,85,364,444
"2021","Wealden 016","E02004418",4691,2915,2259,2249,10,5,651,627,24,1776,958,27,68,382,341
"2021","Wealden 017","E02004419",5050,2913,2106,2094,12,6,801,760,41,2137,1175,32,106,458,366
"2021","Wealden 018","E02004420",11252,7548,5940,5870,70,16,1592,1516,76,3704,1981,84,184,715,740
"2021","Wealden 019","E02004421",7624,4750,3596,3550,46,6,1148,1090,58,2874,1489,66,158,609,552
"2021","Wealden 020","E02004422",9264,6096,4738,4684,54,12,1346,1292,54,3168,1712,55,145,626,630
"2021","Wealden 021","E02004423",6576,4357,3603,3555,48,4,750,698,52,2219,1088,21,78,432,600
"2021","Basingstoke and Deane 001","E02004675",6179,3916,3042,3030,12,4,870,840,30,2263,1288,54,82,434,405
"2021","Basingstoke and Deane 002","E02004676",6697,4550,3692,3674,18,4,854,822,32,2147,1246,43,79,362,417
"2021","Basingstoke and Deane 003","E02004677",6047,4253,3559,3543,16,0,694,668,26,1794,1113,64,67,262,288
"2021","Basingstoke and Deane 004","E02004678",6286,4254,3433,3415,18,7,814,784,30,2032,1125,50,81,393,383
"2021","Basingstoke and Deane 005","E02004679",8667,6178,4642,4594,48,4,1532,1470,62,2489,1508,58,122,452,349
"2021","Basingstoke and Deane 006","E02004680",6275,4338,3231,3204,27,7,1100,1064,36,1937,1205,40,108,403,181
"2021","Basingstoke and Deane 007","E02004681",11303,6623,4502,4469,33,13,2108,2026,82,4680,3078,171,243,765,423
"2021","Basingstoke and Deane 008","E02004682",6693,4215,3212,3188,24,3,1000,968,32,2478,1576,82,111,458,251
"2021","Basingstoke and Deane 009","E02004683",6552,3709,2620,2600,20,8,1081,1035,46,2843,1819,108,132,466,318
"2021","Basingstoke and Deane 010","E02004684",8932,5486,3891,3871,20,13,1582,1516,66,3446,2266,132,146,549,353
"2021","Basingstoke and Deane 011","E02004685",6622,3739,2548,2515,33,5,1186,1138,48,2883,1871,124,138,453,297
"2021","Basingstoke and Deane 012","E02004686",7223,4140,2873,2845,28,7,1260,1202,58,3083,1921,187,119,516,340
"2021","Basingstoke and Deane 013","E02004687",5825,3447,2382,2362,20,13,1052,1006,46,2378,1554,56,101,407,260
"2021","Basingstoke and Deane 014","E02004688",6351,3532,2522,2512,10,4,1006,978,28,2819,1675,90,137,512,405
"2021","Basingstoke and Deane 015","E02004689",4729,3360,2878,2868,10,0,482,466,16,1369,763,26,54,209,317
"2021","Basingstoke and Deane 016","E02004690",6624,4182,3151,3130,21,13,1018,968,50,2442,1555,45,127,416,299
"2021","Basingstoke and Deane 017","E02004691",6556,4536,3884,3876,8,10,642,622,20,2020,1088,56,85,342,449
"2021","Basingstoke and Deane 018","E02004692",6149,4412,3876,3860,16,8,528,502,26,1737,947,31,46,248,465
"2021","Basingstoke and Deane 019","E02004693",5953,3455,2450,2432,18,3,1002,980,22,2498,1492,50,129,533,294
"2021","Basingstoke and Deane 020","E02004694",6037,4076,3218,3206,12,4,854,830,24,1961,1097,50,86,375,353
"2021","Basingstoke and Deane 021","E02004695",6859,4729,3768,3744,24,6,955,928,27,2130,1450,43,98,372,167
"2021","Basingstoke and Deane 022","E02004696",6080,4212,3292,3266,26,4,916,892,24,1868,1034,36,101,342,355
"2021","East Hampshire 001","E02004697",5311,3714,3082,3062,20,2,630,612,18,1597,908,46,77,300,266
"2021","East Hampshire 002","E02004698",5253,2844,1968,1961,7,12,864,832,32,2409,1334,51,133,495,396
"2021","East Hampshire 003","E02004699",8971,5804,4682,4652,30,8,1114,1078,36,3167,1765,63,168,608,563
"2021","East Hampshire 004","E02004700",5326,3504,2368,2344,24,4,1132,1090,42,1822,1119,51,107,372,173
"2021","East Hampshire 006","E02004702",6510,4134,3017,2995,22,13,1104,1070,34,2376,1399,41,116,491,329
"2021","East Hampshire 007","E02004703",10409,7480,6410,6362,48,10,1060,1034,26,2929,1756,73,140,486,474
"2021","East Hampshire 008","E02004704",5177,3521,2754,2741,13,13,754,738,16,1656,935,55,80,313,273
"2021","East Hampshire 009","E02004705",7804,5073,4156,4127,29,11,906,862,44,2731,1492,55,141,526,517
"2021","East Hampshire 010","E02004706",6097,4056,3334,3328,6,7,715,700,15,2041,1162,51,88,373,367
"2021","East Hampshire 011","E02004707",9055,6176,5227,5203,24,5,944,914,30,2879,1600,75,126,514,564
"2021","East Hampshire 012","E02004708",7844,4559,3499,3471,28,9,1051,994,57,3285,1748,69,184,702,582
"2021","East Hampshire 013","E02004709",7153,5006,4089,4069,20,1,916,890,26,2147,1246,41,81,390,389
"2021","East Hampshire 014","E02004710",5461,3726,3088,3074,14,4,634,620,14,1735,1017,33,78,320,287
"2021","East Hampshire 016","E02006829",6086,4137,3454,3425,29,9,674,650,24,1949,1047,32,71,369,430
"2021","East Hampshire 017","E02006838",5866,4040,3431,3401,30,11,598,568,30,1826,964,46,76,295,445
"2021","Eastleigh 001","E02004712",6912,4949,4430,4414,16,3,516,504,12,1963,1118,39,78,278,450
"2021","Eastleigh 002","E02004713",6447,4374,3632,3620,12,4,738,722,16,2073,1136,38,94,403,402
"2021","Eastleigh 003","E02004714",6309,4189,3414,3388,26,2,773,752,21,2120,1105,62,83,418,452
"2021","Eastleigh 004","E02004715",7263,4513,3284,3257,27,9,1220,1174,46,2750,1587,60,150,550,403
"2021","Eastleigh 005","E02004716",7040,4610,3513,3487,26,5,1092,1058,34,2430,1421,48,89,486,386
"2021","Eastleigh 006","E02004717",9991,5875,3947,3906,41,6,1922,1854,68,4116,2536,97,243,800,440
"2021","Eastleigh 007","E02004718",7051,3797,2454,2429,25,11,1332,1240,92,3254,2057,83,193,607,314
"2021","Eastleigh 008","E02004719",9296,6436,4958,4922,36,6,1472,1432,40,2860,1732,50,123,473,482
"2021","Eastleigh 009","E02004720",9427,6143,4661,4640,21,4,1478,1418,60,3284,1819,57,144,685,579
"2021","Eastleigh 010","E02004721",8797,6040,4501,4467,34,9,1530,1466,64,2757,1794,37,158,526,242
"2021","Eastleigh 011","E02004722",5684,3540,2747,2731,16,5,788,752,36,2144,1119,29,98,454,444
"2021","Eastleigh 012","E02004723",7980,5479,4356,4329,27,8,1115,1078,37,2501,1432,37,104,433,495
"2021","Eastleigh 013","E02004724",7726,5074,3635,3605,30,7,1432,1376,56,2652,1630,67,145,500,310
"2021","Eastleigh 014","E02004725",4421,2647,2004,1992,12,0,643,616,27,1774,947,24,90,402,311
"2021","Eastleigh 015","E02004726",5008,3264,2468,2438,30,4,792,768,24,1744,964,50,102,353,275
"2021","Fareham 001","E02004727",7926,5634,4526,4500,26,18,1090,1046,44,2292,1478,46,114,396,258
"2021","Fareham 002","E02004728",7355,4798,3726,3702,24,18,1054,1014,40,2557,1449,61,112,516,419
"2021","Fareham 003","E02004729",5983,3659,2766,2745,21,9,884,856,28,2324,1334,48,105,476,361
"2021","Fareham 004","E02004730",7155,4993,4143,4117,26,5,845,816,29,2162,1192,55,77,345,493
"2021","Fareham 005","E02004731",6374,4302,3528,3510,18,8,766,732,34,2072,1119,38,84,400,431
"2021","Fareham 006","E02004732",7245,4878,3955,3941,14,7,916,876,40,2367,1316,43,98,465,445
"2021","Fareham 007","E02004733",6585,4380,3480,3458,22,4,896,856,40,2205,1257,46,105,435,362
"2021","Fareham 008","E02004734",8429,5302,4028,3980,48,12,1262,1212,50,3127,1749,68,115,633,562
"2021","Fareham 009","E02004735",6333,4480,3798,3778,20,6,676,652,24,1853,955,32,67,327,472
"2021","Fareham 010","E02004736",6823,4678,3748,3710,38,2,928,896,32,2145,1125,39,92,384,505
"2021","Fareham 011","E02004737",6034,3408,2324,2290,34,6,1078,1024,54,2626,1519,39,123,574,371
"2021","Fareham 012","E02004738",6119,3914,3086,3046,40,4,824,788,36,2205,1175,41,85,425,479
"2021","Fareham 013","E02004739",5573,3666,3144,3126,18,2,520,500,20,1907,890,44,68,390,515
"2021","Fareham 014","E02004740",5990,4196,3645,3617,28,3,548,534,14,1794,857,39,70,339,489
"2021","Gosport 001","E02004741",6200,3724,2904,2888,16,8,812,784,28,2476,1363,32,104,483,494
"2021","Gosport 002","E02004742",5846,3427,2649,2611,38,3,775,746,29,2419,1252,53,122,539,453
"2021","Gosport 003","E02004743",6030,3853,2911,2893,18,5,937,900,37,2177,1214,37,107,433,386
"2021","Gosport 004","E02004744",7162,4060,2717,2689,28,9,1334,1288,46,3102,1960,60,225,643,214
"2021","Gosport 005","E02004745",6873,3898,2629,2603,26,7,1262,1212,50,2975,1710,47,170,689,359
"2021","Gosport 006","E02004746",9128,5933,4934,4907,27,13,986,952,34,3195,1620,69,155,683,668
"2021","Gosport 007","E02004747",5134,3010,2144,2126,18,2,864,830,34,2124,1125,31,140,486,342
"2021","Gosport 008","E02004748",7719,3690,2363,2325,38,3,1324,1240,84,4029,2298,100,224,945,462
"2021","Gosport 009","E02004749",5858,3950,3358,3342,16,2,590,574,16,1908,995,45,74,320,474
"2021","Gosport 010","E02004750",6158,3818,2978,2950,28,6,834,790,44,2340,1277,35,125,503,400
"2021","Hart 001","E02004751",7020,4610,3691,3675,16,9,910,880,30,2410,1364,51,86,430,479
"2021","Hart 002","E02004752",6482,4423,3696,3684,12,12,715,688,27,2059,1223,45,75,390,326
"2021","Hart 003","E02004753",8874,5708,4390,4372,18,6,1312,1268,44,3166,1919,97,143,496,511
"2021","Hart 004","E02004754",5806,3920,3231,3202,29,0,689,671,18,1886,963,42,95,369,417
"2021","Hart 005","E02004755",9629,6237,4714,4666,48,7,1516,1462,54,3392,1991,87,168,653,493
"2021","Hart 006","E02004756",7649,5246,4108,4080,28,6,1132,1096,36,2403,1460,73,130,452,288
"2021","Hart 007","E02004757",6475,4578,4152,4138,14,2,424,416,8,1897,1101,39,48,265,444
"2021","Hart 008","E02004758",7299,4941,4223,4198,25,8,710,680,30,2358,1392,51,105,416,394
"2021","Hart 009","E02004759",6560,4412,3651,3629,22,6,755,725,30,2148,1201,47,74,437,389
"2021","Hart 010","E02004760",8040,5542,4402,4374,28,4,1136,1096,40,2498,1509,71,131,453,334
"2021","Hart 011","E02004761",4808,3266,2706,2696,10,6,554,534,20,1542,843,49,67,308,275
"2021","Havant 003","E02004764",7070,4574,3694,3680,14,4,876,838,38,2496,1354,51,90,414,587
"2021","Havant 004","E02004765",5128,3408,2602,2588,14,2,804,780,24,1720,1000,29,90,303,298
"2021","Havant 005","E02004766",5658,3164,2318,2310,8,8,838,820,18,2494,1443,36,143,451,421
"2021","Havant 006","E02004767",4407,2427,1619,1600,19,0,808,788,20,1980,1227,33,103,381,236
"2021","Havant 007","E02004768",4315,2576,1920,1912,8,0,656,638,18,1739,1019,28,102,365,225
"2021","Havant 008","E02004769",4781,2574,1668,1652,16,6,900,872,28,2207,1439,41,99,394,234
"2021","Havant 009","E02004770",5305,2858,1894,1872,22,0,964,936,28,2447,1483,39,125,489,311
"2021","Havant 010","E02004771",6967,3788,2563,2537,26,5,1220,1184,36,3179,1976,60,165,561,417
"2021","Havant 011","E02004772",7820,5054,4033,4017,16,13,1008,962,46,2766,1557,63,121,510,515
"2021","Havant 013","E02004774",8571,5491,4433,4403,30,4,1054,1014,40,3080,1522,57,126,666,709
"2021","Havant 014","E02004775",8573,5360,4075,4041,34,9,1276,1228,48,3213,1808,69,143,622,571
"2021","Havant 015","E02004776",5146,3425,2851,2829,22,6,568,540,28,1721,864,45,81,326,405
"2021","Havant 016","E02004777",4532,2696,2128,2112,16,6,562,530,32,1836,834,25,82,424,471
"2021","Havant 017","E02004778",5358,3356,2637,2629,8,1,718,688,30,2002,918,63,114,455,452
"2021","Havant 018","E02006822",7638,4986,3798,3778,20,6,1182,1140,42,2652,1539,74,103,435,501
"2021","Havant 019","E02006830",5247,2982,2159,2149,10,12,811,795,16,2265,1378,30,114,462,281
"2021","Havant 020","E02006831",5253,3514,2849,2843,6,5,660,640,20,1739,893,39,77,306,424
"2021","New Forest 001","E02004779",9271,6188,4943,4923,20,11,1234,1178,56,3083,1625,88,127,591,652
"2021","New Forest 002","E02004780",4816,2922,2187,2177,10,11,724,704,20,1894,1084,24,86,360,340
"2021","New Forest 003","E02004781",6438,4162,3142,3130,12,9,1011,983,28,2276,1365,52,112,458,289
"2021","New Forest 004","E02004782",6363,3856,2832,2814,18,6,1018,990,28,2507,1468,35,99,476,429
"2021","New Forest 005","E02004783",5737,3732,2842,2828,14,6,884,860,24,2005,1135,41,101,387,341
"2021","New Forest 006","E02004784",4660,3286,2811,2789,22,1,474,450,24,1374,773,31,42,178,350
"2021","New Forest 007","E02004785",4701,3165,2595,2589,6,2,568,536,32,1536,779,58,74,309,316
"2021","New Forest 008","E02004786",6678,4340,3371,3343,28,19,950,920,30,2338,1357,29,144,520,288
"2021","New Forest 009","E02004787",6247,4142,3385,3367,18,5,752,728,24,2105,987,37,101,411,569
"2021","New Forest 010","E02004788",5915,4056,3409,3395,14,1,646,624,22,1859,1064,36,94,362,303
"2021","New Forest 011","E02004789",8479,5396,4303,4275,28,11,1082,1036,46,3083,1644,60,151,616,612
"2021","New Forest 012","E02004790",6660,3874,2802,2780,22,2,1070,1052,18,2786,1444,48,127,636,531
"2021","New Forest 013","E02004791",4321,2641,1983,1963,20,0,658,636,22,1680,990,30,84,289,287
"2021","New Forest 014","E02004792",7124,4754,3858,3846,12,4,892,874,18,2370,1189,58,116,487,520
"2021","New Forest 015","E02004793",6050,4163,3580,3556,24,4,579,565,14,1887,954,64,73,337,459
"2021","New Forest 016","E02004794",5672,3892,3346,3324,22,4,542,536,6,1780,966,56,77,290,391
"2021","New Forest 017","E02004795",7217,4502,3641,3623,18,5,856,820,36,2715,1287,86,127,596,619
"2021","New Forest 018","E02004796",8397,5729,4725,4693,32,5,999,958,41,2668,1326,76,87,492,687
"2021","New Forest 019","E02004797",6734,4103,3085,3067,18,9,1009,978,31,2631,1396,57,128,580,470
"2021","New Forest 020","E02004798",5015,2894,2196,2182,14,4,694,672,22,2121,1240,35,85,451,310
"2021","New Forest 021","E02004799",6701,3930,3065,3055,10,7,858,792,66,2771,1335,75,104,596,661
"2021","New Forest 022","E02004800",6542,4502,3940,3920,20,4,558,522,36,2040,883,68,63,394,632
"2021","New Forest 023","E02004801",6747,4550,3918,3894,24,4,628,596,32,2197,879,99,82,435,702
"2021","Rushmoor 001","E02004802",5434,3120,2394,2384,10,12,714,680,34,2314,1401,133,96,382,302
"2021","Rushmoor 002","E02004803",5948,3198,2495,2487,8,13,690,654,36,2750,1693,178,129,456,294
"2021","Rushmoor 003","E02004804",5922,3786,2941,2925,16,11,834,802,32,2136,1310,74,96,362,294
"2021","Rushmoor 004","E02004805",7054,4595,3747,3728,19,4,844,806,38,2459,1556,76,107,373,347
"2021","Rushmoor 005","E02004806",6467,4345,3383,3358,25,4,958,916,42,2122,1333,62,84,388,255
"2021","Rushmoor 006","E02004807",7646,4586,3512,3484,28,6,1068,1008,60,3060,1804,134,133,527,462
"2021","Rushmoor 007","E02004808",9185,5480,4013,3977,36,17,1450,1392,58,3705,2369,109,204,694,329
"2021","Rushmoor 008","E02004809",7906,5076,3887,3855,32,7,1182,1122,60,2830,1792,257,176,366,239
"2021","Rushmoor 009","E02004810",6493,3708,2643,2617,26,9,1056,1004,52,2785,1723,155,134,499,274
"2021","Rushmoor 010","E02004811",6662,3728,2916,2902,14,8,804,766,38,2934,1719,163,129,513,410
"2021","Rushmoor 011","E02004812",5522,3498,2808,2796,12,2,688,652,36,2024,1292,117,98,292,225
"2021","Rushmoor 012","E02004813",5182,2863,2129,2116,13,4,730,702,28,2319,1378,114,129,416,282
"2021","Test Valley 001","E02004814",5900,4015,3277,3257,20,9,729,704,25,1885,1090,38,82,348,327
"2021","Test Valley 002","E02004815",5600,2998,1950,1934,16,8,1040,1006,34,2602,1651,67,154,501,229
"2021","Test Valley 004","E02004817",6182,3638,2655,2643,12,5,978,948,30,2544,1417,56,128,532,411
"2021","Test Valley 005","E02004818",8169,5424,4391,4359,32,7,1026,970,56,2745,1555,66,126,504,494
"2021","Test Valley 006","E02004819",6433,4152,3223,3213,10,5,924,882,42,2281,1261,63,97,447,413
"2021","Test Valley 007","E02004820",5836,4174,3460,3424,36,10,704,688,16,1662,918,44,97,309,294
"2021","Test Valley 008","E02004821",4266,3107,2652,2634,18,3,452,440,12,1159,599,30,47,215,268
"2021","Test Valley 009","E02004822",6711,4769,3977,3955,22,2,790,754,36,1942,1081,54,89,332,386
"2021","Test Valley 010","E02004823",7197,4808,3914,3902,12,2,892,852,40,2389,1273,47,93,496,480
"2021","Test Valley 011","E02004824",5067,2761,2117,2102,15,3,641,616,25,2306,1023,56,101,508,618
"2021","Test Valley 012","E02004825",8914,6115,5117,5085,32,5,993,968,25,2799,1535,61,105,501,597
"2021","Test Valley 013","E02004826",7786,5461,4425,4411,14,5,1031,992,39,2325,1328,60,134,407,396
"2021","Test Valley 014","E02004827",5830,4146,3498,3488,10,8,640,626,14,1684,1034,37,75,341,197
"2021","Test Valley 015","E02004828",5977,4188,3392,3382,10,6,790,766,24,1789,1033,58,65,305,328
"2021","Test Valley 016","E02007076",5683,3853,2678,2658,20,6,1169,1108,61,1830,1187,68,99,344,132
"2021","Test Valley 017","E02007077",5427,3668,2396,2370,26,8,1264,1226,38,1759,1142,39,111,335,132
"2021","Test Valley 018","E02007078",4306,2461,1758,1750,8,3,700,666,34,1845,978,42,105,399,321
"2021","Winchester 001","E02004829",4712,3404,2889,2863,26,1,514,488,26,1308,759,38,58,196,257
"2021","Winchester 002","E02004830",5403,3752,3087,3065,22,1,664,636,28,1651,946,71,67,281,286
"2021","Winchester 003","E02004831",7634,5312,4498,4476,22,6,808,756,52,2322,1337,66,87,366,466
"2021","Winchester 004","E02004832",7085,4655,3903,3890,13,2,750,708,42,2430,1221,71,107,458,573
"2021","Winchester 005","E02004833",7168,4504,3728,3706,22,12,764,728,36,2664,1750,77,101,355,381
"2021","Winchester 006","E02004834",6090,3062,2096,2077,19,2,964,914,50,3028,1941,82,123,518,364
"2021","Winchester 007","E02004835",7901,4384,3165,3135,30,7,1212,1150,62,3517,2193,127,129,636,432
"2021","Winchester 008","E02004836",5106,1999,1463,1459,4,12,524,496,28,3107,2502,43,88,287,187
"2021","Winchester 009","E02004837",6640,4341,3606,3600,6,5,730,702,28,2299,1513,58,79,313,336
"2021","Winchester 010","E02004838",7730,5356,4517,4499,18,3,836,806,30,2374,1341,63,97,434,439
"2021","Winchester 011","E02004839",7374,5264,4474,4450,24,6,784,752,32,2110,1179,66,84,366,415
"2021","Winchester 012","E02004840",8418,5606,4505,4489,16,3,1098,1066,32,2812,1492,51,138,576,555
"2021","Winchester 013","E02004841",9408,6132,4735,4703,32,5,1392,1340,52,3276,1962,83,177,589,465
"2021","Winchester 014","E02004842",9008,6174,4838,4802,36,8,1328,1284,44,2834,1642,55,148,487,502
"2021","Ashford 001","E02004996",6706,4303,3400,3369,31,9,894,854,40,2403,1358,60,97,441,447
"2021","Ashford 002","E02004997",6803,4572,3672,3642,30,8,892,840,52,2231,1244,69,100,385,433
"2021","Ashford 003","E02004998",5510,3590,2926,2912,14,6,658,640,18,1920,1125,50,80,313,352
"2021","Ashford 005","E02005000",9519,5159,3492,3464,28,11,1656,1558,98,4360,2901,217,188,680,374
"2021","Ashford 006","E02005001",7646,4998,3929,3911,18,3,1066,1038,28,2648,1608,99,99,427,415
"2021","Ashford 007","E02005002",7765,4414,3056,3030,26,8,1350,1302,48,3351,2029,148,161,597,416
"2021","Ashford 008","E02005003",6966,3940,2768,2750,18,8,1164,1134,30,3026,2014,130,134,434,314
"2021","Ashford 009","E02005004",9211,5790,4252,4224,28,16,1522,1474,48,3421,2269,91,148,573,340
"2021","Ashford 010","E02005005",8223,5824,4600,4550,50,8,1216,1154,62,2399,1378,73,103,421,424
"2021","Ashford 011","E02005006",5070,3452,2835,2831,4,11,606,590,16,1618,958,34,60,274,292
"2021","Ashford 012","E02005007",7579,5038,3949,3923,26,7,1082,1034,48,2541,1498,69,115,431,428
"2021","Ashford 013","E02005008",7502,4692,3795,3771,24,12,885,839,46,2810,1408,72,121,542,667
"2021","Ashford 014","E02005009",4984,3286,2677,2659,18,5,604,576,28,1698,964,42,67,288,337
"2021","Ashford 015","E02007046",5548,3120,2391,2378,13,0,729,699,30,2428,1437,83,110,446,352
"2021","Ashford 016","E02007047",6835,4327,3093,3073,20,11,1223,1160,63,2508,1661,120,119,377,231
"2021","Canterbury 001","E02005010",6085,2955,2055,2016,39,7,893,848,45,3130,1770,70,188,702,400
"2021","Canterbury 002","E02005011",6428,4243,3523,3493,30,0,720,706,14,2185,1073,52,94,392,574
"2021","Canterbury 003","E02005012",7345,4354,3337,3317,20,7,1010,962,48,2991,1727,66,123,534,541
"2021","Canterbury 004","E02005013",6926,4114,3153,3137,16,7,954,922,32,2812,1505,74,116,525,592
"2021","Canterbury 005","E02005014",7262,4964,4187,4151,36,3,774,740,34,2298,1173,63,76,384,602
"2021","Canterbury 006","E02005015",7602,4969,3881,3852,29,4,1084,1048,36,2633,1574,40,125,463,431
"2021","Canterbury 007","E02005016",6448,3892,3018,2978,40,4,870,840,30,2556,1398,55,113,529,461
"2021","Canterbury 008","E02005017",5528,3202,2258,2194,64,8,936,880,56,2326,1274,59,121,523,349
"2021","Canterbury 009","E02005018",7191,4664,3761,3723,38,10,893,850,43,2527,1427,47,115,446,492
"2021","Canterbury 010","E02005019",5149,3316,2545,2523,22,7,764,748,16,1833,1135,55,77,312,254
"2021","Canterbury 011","E02005020",6097,3612,2757,2739,18,7,848,810,38,2485,1467,83,98,409,428
"2021","Canterbury 012","E02005021",5458,3414,2802,2778,24,8,604,576,28,2044,1317,54,75,265,333
"2021","Canterbury 013","E02005022",6945,2502,1832,1818,14,6,664,614,50,4443,3737,66,95,338,207
"2021","Canterbury 014","E02005023",6845,2708,1729,1711,18,3,976,926,50,4137,3129,113,149,501,245
"2021","Canterbury 016","E02005025",7162,3572,2690,2655,35,1,881,835,46,3590,2617,96,110,404,363
"2021","Canterbury 017","E02005026",6489,4314,3330,3298,32,6,978,928,50,2175,1325,57,107,372,314
"2021","Canterbury 018","E02005027",4490,2972,2443,2417,26,3,526,496,30,1518,829,34,51,266,338
"2021","Canterbury 019","E02006855",5102,2421,1469,1458,11,8,944,896,48,2681,2037,64,101,321,158
"2021","Canterbury 020","E02006856",9367,4008,2412,2370,42,1,1595,1499,96,5359,3993,126,168,618,454
"2021","Dartford 001","E02005028",10143,6115,4438,4420,18,21,1656,1594,62,4028,2704,189,234,561,340
"2021","Dartford 002","E02005029",11152,7292,4711,4676,35,18,2563,2468,95,3860,2628,148,227,598,259
"2021","Dartford 003","E02005030",9458,5510,3991,3977,14,9,1510,1440,70,3948,2629,197,186,566,370
"2021","Dartford 004","E02005031",6268,3479,2281,2254,27,6,1192,1154,38,2789,1863,77,127,466,256
"2021","Dartford 005","E02005032",7553,4249,2958,2930,28,20,1271,1223,48,3304,2151,131,188,566,268
"2021","Dartford 006","E02005033",5891,3266,2237,2225,12,5,1024,996,28,2625,1656,80,122,490,277
"2021","Dartford 007","E02005034",6225,4093,3333,3321,12,12,748,716,32,2132,1398,63,76,268,327
"2021","Dartford 008","E02005035",6513,4160,3402,3392,10,4,754,728,26,2353,1492,78,102,330,351
"2021","Dartford 009","E02005036",5139,2727,1964,1956,8,6,757,734,23,2412,1535,55,129,428,265
"2021","Dartford 010","E02005037",5776,3708,3070,3058,12,12,626,614,12,2068,1250,47,77,307,387
"2021","Dartford 011","E02005038",4831,3058,2384,2370,14,6,668,646,22,1773,1046,40,96,260,331
"2021","Dartford 012","E02005039",5402,3370,2560,2556,4,4,806,778,28,2032,1231,54,100,342,305
"2021","Dartford 013","E02005040",5630,3821,3214,3200,14,4,603,584,19,1809,1057,48,56,251,397
"2021","Dover 001","E02005041",6054,4024,3265,3241,24,13,746,714,32,2030,1204,51,84,352,339
"2021","Dover 002","E02005042",7615,4771,3810,3784,26,4,957,906,51,2844,1505,59,152,569,559
"2021","Dover 003","E02005043",5999,3499,2677,2637,40,6,816,780,36,2500,1284,54,140,532,490
"2021","Dover 004","E02005044",5332,2889,2203,2117,86,5,681,634,47,2443,1195,87,115,599,447
"2021","Dover 005","E02005045",7438,4618,3362,3332,30,8,1248,1210,38,2820,1571,54,138,575,482
"2021","Dover 006","E02005046",6781,4271,2930,2908,22,3,1338,1300,38,2510,1528,43,124,441,374
"2021","Dover 007","E02005047",6269,3648,2755,2729,26,3,890,856,34,2621,1378,61,130,531,521
"2021","Dover 008","E02005048",5543,3876,3075,3049,26,3,798,769,29,1667,908,35,63,289,372
"2021","Dover 009","E02005049",5994,4112,3435,3379,56,9,668,626,42,1882,901,62,76,332,511
"2021","Dover 010","E02005050",7864,5272,4064,4040,24,6,1202,1146,56,2592,1435,61,115,461,520
"2021","Dover 011","E02005051",10437,5538,3589,3535,54,15,1934,1856,78,4899,3142,72,277,903,505
"2021","Dover 012","E02005052",6401,3258,2230,2194,36,8,1020,968,52,3143,1778,81,193,639,452
"2021","Dover 013","E02005053",7070,3676,2271,2245,26,5,1400,1352,48,3394,2187,80,193,589,345
"2021","Dover 014","E02005054",5704,3847,3055,3030,25,6,786,758,28,1857,1011,46,83,325,392
"2021","Gravesham 001","E02005055",6162,3256,2230,2224,6,10,1016,991,25,2906,1917,133,158,451,247
"2021","Gravesham 002","E02005056",8165,3866,2549,2528,21,10,1307,1226,81,4299,2611,206,269,757,456
"2021","Gravesham 003","E02005057",8875,5118,3843,3823,20,15,1260,1212,48,3757,2433,175,191,552,406
"2021","Gravesham 004","E02005058",6026,3324,2394,2374,20,4,926,880,46,2702,1707,127,117,430,321
"2021","Gravesham 005","E02005059",7854,4844,3843,3817,26,11,990,952,38,3010,1870,103,127,451,459
"2021","Gravesham 006","E02005060",6721,3946,2908,2884,24,12,1026,996,30,2775,1713,108,146,387,421
"2021","Gravesham 007","E02005061",5772,3090,2360,2358,2,16,714,674,40,2682,1714,75,139,380,374
"2021","Gravesham 008","E02005062",5582,3485,2831,2819,12,5,649,630,19,2097,1290,62,93,274,378
"2021","Gravesham 009","E02005063",5708,3592,2880,2876,4,6,706,684,22,2116,1345,58,97,289,327
"2021","Gravesham 010","E02005064",5461,3572,3029,3013,16,5,538,522,16,1889,1074,52,67,274,422
"2021","Gravesham 011","E02005065",6325,3440,2468,2448,20,26,946,924,22,2885,1877,78,133,433,364
"2021","Gravesham 012","E02005066",6508,4402,3742,3728,14,6,654,644,10,2106,1181,41,88,298,498
"2021","Gravesham 013","E02005067",4907,3314,2699,2689,10,2,613,592,21,1593,961,50,70,236,276
"2021","Maidstone 001","E02005068",5843,4030,3098,3080,18,4,928,900,28,1813,1130,51,89,300,243
"2021","Maidstone 002","E02005069",7284,4656,3671,3645,26,7,978,932,46,2628,1606,107,105,448,362
"2021","Maidstone 003","E02005070",7986,5442,4459,4439,20,17,966,930,36,2544,1386,65,93,378,622
"2021","Maidstone 004","E02005071",9447,4798,2916,2884,32,8,1874,1770,104,4649,2928,206,269,812,434
"2021","Maidstone 005","E02005072",6426,4523,3835,3820,15,2,686,670,16,1903,1092,43,91,344,333
"2021","Maidstone 006","E02005073",9851,5362,3410,3376,34,18,1934,1866,68,4489,2998,160,244,763,324
"2021","Maidstone 007","E02005074",6569,4406,3572,3566,6,2,832,816,16,2163,1192,35,100,375,461
"2021","Maidstone 008","E02005075",8573,5108,3740,3711,29,9,1359,1296,63,3465,2244,126,164,587,344
"2021","Maidstone 009","E02005076",7740,4536,3071,3049,22,7,1458,1388,70,3204,2095,125,166,532,286
"2021","Maidstone 010","E02005077",6479,3890,2969,2955,14,7,914,874,40,2589,1638,80,94,372,405
"2021","Maidstone 011","E02005078",8069,5422,4203,4157,46,11,1208,1138,70,2647,1488,88,102,465,504
"2021","Maidstone 012","E02005079",7200,4850,3932,3918,14,4,914,868,46,2350,1367,83,85,351,464
"2021","Maidstone 013","E02005080",9046,4918,3410,3390,20,4,1504,1460,44,4128,2524,114,206,728,556
"2021","Maidstone 014","E02005081",5894,3962,3192,3180,12,2,768,740,28,1932,1051,43,67,373,398
"2021","Maidstone 015","E02005082",9402,6342,4790,4763,27,9,1543,1498,45,3060,1810,121,160,496,473
"2021","Maidstone 016","E02005083",6372,4226,3307,3293,14,5,914,884,30,2146,1184,55,98,379,430
"2021","Maidstone 017","E02005084",5967,3949,3085,3073,12,3,861,806,55,2018,1126,59,113,331,389
"2021","Maidstone 018","E02005085",6328,4224,3227,3205,22,15,982,942,40,2104,1274,73,81,333,343
"2021","Maidstone 019","E02005086",5369,3573,2811,2786,25,6,756,736,20,1796,1041,38,83,346,288
"2021","Sevenoaks 001","E02005087",5810,3749,2969,2955,14,8,772,736,36,2061,1204,65,85,319,388
"2021","Sevenoaks 002","E02005088",7739,4152,3065,3045,20,17,1070,1026,44,3587,2199,98,183,594,513
"2021","Sevenoaks 003","E02005089",5586,3554,2717,2695,22,7,830,804,26,2032,1213,56,87,311,365
"2021","Sevenoaks 004","E02005090",4921,3203,2784,2778,6,3,416,406,10,1718,964,44,45,272,393
"2021","Sevenoaks 005","E02005091",5538,3440,2632,2612,20,8,800,770,30,2098,1177,45,98,368,410
"2021","Sevenoaks 007","E02005093",5117,3275,2621,2613,8,6,648,634,14,1842,942,57,89,345,409
"2021","Sevenoaks 008","E02005094",7762,5029,3867,3832,35,8,1154,1114,40,2733,1601,66,132,540,394
"2021","Sevenoaks 009","E02005095",6002,4038,3455,3443,12,9,574,550,24,1964,1132,40,66,311,415
"2021","Sevenoaks 010","E02005096",7543,4718,3585,3561,24,15,1118,1078,40,2825,1691,88,140,531,375
"2021","Sevenoaks 011","E02005097",7171,5157,4611,4601,10,17,529,503,26,2014,1228,67,85,284,350
"2021","Sevenoaks 012","E02005098",7629,4986,4201,4187,14,7,778,748,30,2643,1488,101,108,450,496
"2021","Sevenoaks 013","E02005099",6447,4236,3343,3320,23,9,884,834,50,2211,1283,59,97,427,345
"2021","Sevenoaks 014","E02005100",7822,4912,3620,3584,36,4,1288,1260,28,2910,1725,45,133,527,480
"2021","Sevenoaks 015","E02005101",5701,3961,3289,3279,10,4,668,648,20,1740,1019,29,97,305,290
"2021","Sevenoaks 016","E02006832",4846,3059,2367,2352,15,6,686,666,20,1787,1010,42,90,383,262
"2021","Folkestone and Hythe 001","E02005102",5300,3584,2943,2917,26,5,636,614,22,1716,886,42,61,311,416
"2021","Folkestone and Hythe 002","E02005103",7909,5078,3869,3845,24,9,1200,1166,34,2831,1736,81,130,488,396
"2021","Folkestone and Hythe 003","E02005104",6410,3676,2664,2650,14,4,1008,956,52,2734,1620,43,130,526,415
"2021","Folkestone and Hythe 004","E02005105",5828,2939,1895,1873,22,6,1038,1004,34,2889,1844,71,152,545,277
"2021","Folkestone and Hythe 005","E02005106",8010,4824,3548,3526,22,8,1268,1224,44,3186,1884,115,137,579,471
"2021","Folkestone and Hythe 006","E02005107",10264,6352,4856,4802,54,8,1488,1432,56,3912,2247,112,191,734,628
"2021","Folkestone and Hythe 008","E02005109",5631,3802,3267,3240,27,9,526,500,26,1829,881,43,80,329,496
"2021","Folkestone and Hythe 009","E02005110",5964,4095,3285,3259,26,5,805,779,26,1869,995,31,78,344,421
"2021","Folkestone and Hythe 010","E02005111",6207,3476,2646,2612,34,4,826,788,38,2731,1294,62,139,662,574
"2021","Folkestone and Hythe 011","E02005112",6063,3884,3045,3036,9,5,834,806,28,2179,1118,60,83,375,543
"2021","Folkestone and Hythe 012","E02005113",6057,3877,3083,3065,18,4,790,768,22,2180,1134,48,86,394,518
"2021","Folkestone and Hythe 013","E02005114",5245,3272,2428,2416,12,14,830,802,28,1973,1115,42,105,366,345
"2021","Folkestone and Hythe 014","E02006879",5304,2154,1151,1129,22,3,1000,928,72,3150,1919,75,176,723,257
"2021","Folkestone and Hythe 015","E02006880",5483,2638,1606,1554,52,4,1028,938,90,2845,1599,61,146,667,372
"2021","Swale 001","E02005115",4864,2460,1428,1414,14,4,1028,986,42,2404,1536,43,163,468,194
"2021","Swale 002","E02005116",4967,2447,1554,1540,14,4,889,854,35,2520,1554,37,128,458,343
"2021","Swale 003","E02005117",5541,3606,2868,2842,26,2,736,716,20,1935,1060,52,85,337,401
"2021","Swale 004","E02005118",8514,5260,3698,3682,16,14,1548,1498,50,3254,1974,79,174,565,462
"2021","Swale 005","E02005119",5287,3140,2240,2220,20,12,888,852,36,2147,1282,41,103,344,377
"2021","Swale 006","E02005120",6188,3766,2885,2869,16,9,872,832,40,2422,1343,70,155,421,433
"2021","Swale 007","E02005121",10838,6937,4897,4859,38,9,2031,1960,71,3901,2556,114,210,663,358
"2021","Swale 008","E02005122",6354,4256,3245,3229,16,1,1010,976,34,2098,1251,58,106,314,369
"2021","Swale 009","E02005123",9897,6381,4571,4539,32,13,1797,1735,62,3516,2267,100,195,547,407
"2021","Swale 010","E02005124",6991,3570,2210,2196,14,2,1358,1304,54,3421,2080,99,184,581,477
"2021","Swale 011","E02005125",6632,4038,2766,2738,28,4,1268,1214,54,2594,1515,86,122,478,393
"2021","Swale 012","E02005126",6535,4136,3177,3159,18,11,948,922,26,2399,1408,66,103,355,467
"2021","Swale 013","E02005127",7244,4952,4038,4024,14,8,906,862,44,2292,1413,43,93,313,430
"2021","Swale 014","E02005128",7205,4575,3407,3368,39,2,1166,1126,40,2630,1547,56,138,464,425
"2021","Swale 015","E02005129",9375,5443,3745,3703,42,10,1688,1604,84,3932,2288,80,192,741,631
"2021","Swale 016","E02005130",7741,4986,3590,3560,30,6,1390,1334,56,2755,1648,55,131,470,451
"2021","Swale 017","E02005131",4834,3173,2446,2422,24,6,721,690,31,1661,935,41,82,297,306
"2021","Thanet 001","E02005132",8052,3534,1942,1896,46,4,1588,1496,92,4518,2810,106,276,928,398
"2021","Thanet 002","E02005133",7358,4858,3846,3810,36,4,1008,964,44,2500,1249,81,108,454,608
"2021","Thanet 003","E02005134",6191,3074,1816,1772,44,8,1250,1192,58,3117,2028,56,208,602,223
"2021","Thanet 004","E02005135",6109,3450,2342,2320,22,8,1100,1062,38,2659,1650,57,141,493,318
"2021","Thanet 005","E02005136",6534,3994,2995,2959,36,15,984,942,42,2540,1505,44,118,419,454
"2021","Thanet 006","E02005137",5920,3170,2212,2184,28,8,950,926,24,2750,1705,31,122,509,383
"2021","Thanet 007","E02005138",7367,4155,2899,2869,30,4,1252,1202,50,3212,1716,48,167,741,540
"2021","Thanet 008","E02005139",7697,4832,3951,3927,24,5,876,825,51,2865,1278,74,109,583,821
"2021","Thanet 009","E02005140",6337,3950,3190,3157,33,10,750,716,34,2387,1211,49,110,492,525
"2021","Thanet 010","E02005141",5858,3562,2807,2775,32,1,754,718,36,2296,1239,59,133,462,403
"2021","Thanet 011","E02005142",6123,3688,2873,2859,14,3,812,786,26,2435,1313,47,127,430,518
"2021","Thanet 012","E02005143",6607,3760,2676,2656,20,4,1080,1030,50,2847,1666,55,154,577,395
"2021","Thanet 013","E02005144",6877,3581,2400,2364,36,5,1176,1142,34,3296,2111,50,168,598,369
"2021","Thanet 014","E02005145",6666,4355,3321,3299,22,8,1026,978,48,2311,1251,49,134,468,409
"2021","Thanet 015","E02005146",6275,3461,2347,2321,26,4,1110,1054,56,2814,1784,41,162,566,261
"2021","Thanet 016","E02005147",7221,3148,1860,1829,31,14,1274,1212,62,4073,2293,86,283,982,429
"2021","Thanet 017","E02005148",6666,4316,3429,3419,10,9,878,844,34,2350,1192,46,99,433,580
"2021","Tonbridge and Malling 001","E02005149",9716,6398,4624,4594,30,4,1770,1728,42,3318,2030,66,152,607,463
"2021","Tonbridge and Malling 002","E02005150",9280,5668,3955,3913,42,11,1702,1640,62,3612,2173,56,203,672,508
"2021","Tonbridge and Malling 003","E02005151",10188,6603,5054,5020,34,22,1527,1489,38,3585,2079,68,172,651,615
"2021","Tonbridge and Malling 005","E02005153",7442,4784,3641,3633,8,9,1134,1088,46,2658,1521,65,135,463,474
"2021","Tonbridge and Malling 006","E02005154",9297,6260,5101,5067,34,13,1146,1114,32,3037,1749,78,143,514,553
"2021","Tonbridge and Malling 007","E02005155",9551,6530,5357,5337,20,9,1164,1130,34,3021,1873,72,171,552,353
"2021","Tonbridge and Malling 008","E02005156",5861,3696,3031,3017,14,7,658,636,22,2165,1228,54,95,378,410
"2021","Tonbridge and Malling 009","E02005157",5345,3155,2527,2509,18,8,620,602,18,2190,1244,47,88,393,418
"2021","Tonbridge and Malling 010","E02005158",5272,3614,3082,3072,10,4,528,508,20,1658,969,37,65,251,336
"2021","Tonbridge and Malling 011","E02005159",6229,4025,3368,3360,8,11,646,620,26,2204,1265,39,71,335,494
"2021","Tonbridge and Malling 012","E02005160",9657,5696,4056,4030,26,6,1634,1582,52,3961,2332,100,186,795,548
"2021","Tonbridge and Malling 013","E02005161",6789,4274,3264,3246,18,10,1000,968,32,2515,1590,54,109,472,290
"2021","Tonbridge and Malling 014","E02006833",9975,6621,5072,5053,19,17,1532,1480,52,3354,1932,71,187,602,562
"2021","Tunbridge Wells 001","E02005162",8591,5536,4326,4306,20,12,1198,1164,34,3055,1822,64,132,504,533
"2021","Tunbridge Wells 002","E02005163",6254,4026,3225,3209,16,3,798,772,26,2228,1417,45,88,402,276
"2021","Tunbridge Wells 003","E02005164",6981,4378,3246,3224,22,4,1128,1084,44,2603,1578,62,118,519,326
"2021","Tunbridge Wells 004","E02005165",6072,3902,3205,3197,8,7,690,681,9,2170,1245,83,90,348,404
"2021","Tunbridge Wells 005","E02005166",5303,2959,2172,2156,16,3,784,752,32,2344,1485,81,104,408,266
"2021","Tunbridge Wells 006","E02005167",5915,4118,3619,3599,20,5,494,480,14,1797,1065,38,51,332,311
"2021","Tunbridge Wells 007","E02005168",5853,3759,2982,2963,19,3,774,734,40,2094,1217,62,100,382,333
"2021","Tunbridge Wells 008","E02005169",7586,4070,2571,2543,28,3,1496,1444,52,3516,2226,104,212,687,287
"2021","Tunbridge Wells 009","E02005170",7601,4940,3782,3758,24,14,1144,1110,34,2661,1550,68,125,493,425
"2021","Tunbridge Wells 010","E02005171",4882,2732,1968,1956,12,4,760,734,26,2150,1278,43,122,417,290
"2021","Tunbridge Wells 011","E02005172",6554,4434,3731,3717,14,13,690,644,46,2120,1237,48,105,385,345
"2021","Tunbridge Wells 012","E02005173",6793,4485,3667,3637,30,7,811,784,27,2308,1331,57,105,454,361
"2021","Tunbridge Wells 013","E02005174",5875,3664,3031,3009,22,9,624,598,26,2211,1153,53,114,437,454
"2021","Tunbridge Wells 014","E02005175",6626,4418,3540,3524,16,4,874,828,46,2208,1193,46,90,467,412
"2021","Cherwell 001","E02005921",5687,4064,3111,3077,34,13,940,900,40,1623,920,48,75,299,281
"2021","Cherwell 002","E02005922",7053,4482,3090,3074,16,8,1384,1338,46,2571,1645,60,119,486,261
"2021","Cherwell 003","E02005923",4713,2531,1822,1812,10,9,700,686,14,2182,1271,127,131,404,249
"2021","Cherwell 004","E02005924",10265,5566,3415,3383,32,7,2144,2026,118,4699,2985,231,235,805,443
"2021","Cherwell 005","E02005925",6686,3670,2581,2563,18,11,1078,1054,24,3016,1920,110,131,491,364
"2021","Cherwell 006","E02005926",7365,4610,3595,3561,34,7,1008,964,44,2755,1622,74,102,451,506
"2021","Cherwell 007","E02005927",4675,2952,2223,2207,16,9,720,680,40,1723,1051,56,67,315,234
"2021","Cherwell 008","E02005928",8515,5856,4584,4562,22,8,1264,1230,34,2659,1609,63,126,477,384
"2021","Cherwell 009","E02005929",6021,4102,3350,3306,44,2,750,726,24,1919,1091,51,78,352,347
"2021","Cherwell 010","E02005930",7542,5169,4041,4010,31,8,1120,1058,62,2373,1363,65,107,431,407
"2021","Cherwell 011","E02005931",8658,6060,4622,4570,52,8,1430,1376,54,2598,1588,93,140,466,311
"2021","Cherwell 012","E02005932",5415,3570,2630,2619,11,4,936,904,32,1845,1258,47,72,330,138
"2021","Cherwell 013","E02005933",6324,3979,2933,2907,26,7,1039,989,50,2345,1461,86,99,421,278
"2021","Cherwell 014","E02005934",7274,4590,3521,3489,32,9,1060,1020,40,2684,1649,72,117,441,405
"2021","Cherwell 015","E02005935",6953,4258,2931,2895,36,5,1322,1268,54,2695,1687,80,118,500,310
"2021","Cherwell 016","E02005936",9700,6704,5184,5140,44,18,1502,1436,66,2996,1816,95,145,508,432
"2021","Cherwell 017","E02005937",5561,3386,2704,2686,18,4,678,656,22,2175,1241,62,85,369,418
"2021","Cherwell 018","E02005938",4672,2763,2224,2206,18,3,536,514,22,1909,1142,89,83,271,324
"2021","Cherwell 019","E02005939",5581,3498,2682,2672,10,6,810,784,26,2083,1283,57,63,331,349
"2021","Oxford 001","E02005940",4972,2910,2426,2404,22,2,482,466,16,2062,1294,72,58,321,317
"2021","Oxford 002","E02005941",5125,2902,2324,2302,22,4,574,542,32,2223,1438,121,68,355,241
"2021","Oxford 003","E02005942",4252,2528,2132,2112,20,2,394,376,18,1724,1111,112,49,247,205
"2021","Oxford 004","E02005943",5911,3109,2447,2425,22,4,658,614,44,2802,2000,92,54,378,278
"2021","Oxford 005","E02005944",6523,3087,2237,2219,18,4,846,800,46,3436,2461,185,124,413,253
"2021","Oxford 006","E02005945",8042,4170,3312,3278,34,8,850,792,58,3872,2913,203,71,364,321
"2021","Oxford 007","E02005946",6876,4052,3036,3018,18,12,1004,946,58,2824,1955,121,83,358,307
"2021","Oxford 008","E02005947",4444,1994,1407,1387,20,5,582,532,50,2450,1896,146,52,237,119
"2021","Oxford 009","E02005948",5263,2338,1555,1525,30,5,778,738,40,2925,2246,96,51,339,193
"2021","Oxford 010","E02005949",5309,2244,1671,1663,8,9,564,524,40,3065,2377,136,92,277,183
"2021","Oxford 011","E02005950",9500,2872,1768,1726,42,0,1104,1004,100,6628,5763,259,81,327,198
"2021","Oxford 012","E02005951",4701,2252,1530,1512,18,4,718,680,38,2449,1821,78,71,286,193
"2021","Oxford 014","E02005953",5175,2230,1520,1486,34,8,702,656,46,2945,2374,123,73,228,147
"2021","Oxford 015","E02005954",8438,4236,3137,3103,34,17,1082,1000,82,4202,2743,385,139,554,381
"2021","Oxford 016","E02005955",8749,4510,3174,3116,58,14,1322,1250,72,4239,2897,275,164,557,346
"2021","Oxford 017","E02005956",5109,2444,1736,1726,10,6,702,582,120,2665,1782,131,122,357,273
"2021","Oxford 018","E02005957",5248,2446,1668,1656,12,4,774,742,32,2802,1993,76,121,403,209
"2021","Oxford 020","E02007021",6010,2968,2277,2273,4,11,680,648,32,3042,2250,169,90,282,251
"2021","Oxford 019","E02007116",6615,2794,1841,1815,26,7,946,890,56,3821,3003,225,105,341,147
"2021","South Oxfordshire 001","E02005958",4463,2844,2200,2188,12,6,638,616,22,1619,955,38,82,311,233
"2021","South Oxfordshire 002","E02005959",4822,3186,2523,2509,14,5,658,640,18,1636,978,60,60,261,277
"2021","South Oxfordshire 003","E02005960",6173,4025,3192,3180,12,10,823,790,33,2148,1192,54,103,393,406
"2021","South Oxfordshire 004","E02005961",5613,3708,2956,2928,28,4,748,712,36,1905,1124,42,70,319,350
"2021","South Oxfordshire 005","E02005962",8214,5696,4391,4375,16,11,1294,1250,44,2518,1512,56,106,447,397
"2021","South Oxfordshire 006","E02005963",6525,4168,3298,3264,34,8,862,850,12,2357,1426,53,108,408,362
"2021","South Oxfordshire 007","E02005964",6108,4150,3462,3450,12,10,678,654,24,1958,1132,52,69,322,383
"2021","South Oxfordshire 008","E02005965",4491,2996,2476,2464,12,4,516,496,20,1495,848,43,57,247,300
"2021","South Oxfordshire 009","E02005966",6498,4420,3081,3049,32,5,1334,1282,52,2078,1444,46,98,346,144
"2021","South Oxfordshire 010","E02005967",7274,4762,3392,3374,18,12,1358,1294,64,2512,1657,64,105,373,313
"2021","South Oxfordshire 011","E02005968",5639,3962,3234,3210,24,2,726,700,26,1677,960,53,81,297,286
"2021","South Oxfordshire 012","E02005969",7823,4922,3871,3856,15,3,1048,1004,44,2901,1664,78,138,543,478
"2021","South Oxfordshire 013","E02005970",4592,2606,1720,1712,8,8,878,840,38,1986,1354,46,87,353,146
"2021","South Oxfordshire 014","E02005971",5163,3125,2346,2322,24,9,770,738,32,2038,1249,54,88,310,337
"2021","South Oxfordshire 015","E02005972",9294,6527,4853,4821,32,7,1667,1596,71,2767,1640,78,128,481,440
"2021","South Oxfordshire 016","E02005973",4948,2789,2185,2177,8,0,604,574,30,2159,1125,56,94,479,405
"2021","South Oxfordshire 017","E02005974",5127,3128,2481,2469,12,11,636,602,34,1999,1093,58,90,414,344
"2021","South Oxfordshire 018","E02005975",6542,4558,3959,3939,20,3,596,570,26,1984,1129,56,75,327,397
"2021","South Oxfordshire 019","E02005976",5054,3575,3090,3070,20,1,484,466,18,1479,914,51,49,202,263
"2021","South Oxfordshire 020","E02005977",4922,3366,2838,2827,11,2,526,502,24,1556,906,17,61,271,301
"2021","Vale of White Horse 001","E02005978",6191,4154,3459,3429,30,5,690,662,28,2037,1241,98,77,309,312
"2021","Vale of White Horse 002","E02005979",8128,5100,4026,3980,46,10,1064,1022,42,3028,1954,119,113,389,453
"2021","Vale of White Horse 003","E02005980",8325,5742,4814,4786,28,6,922,880,42,2583,1511,102,89,427,454
"2021","Vale of White Horse 004","E02005981",7055,4880,4035,4021,14,5,840,802,38,2175,1368,49,72,365,321
"2021","Vale of White Horse 005","E02005982",4667,3066,2484,2474,10,4,578,560,18,1601,976,41,52,286,246
"2021","Vale of White Horse 006","E02005983",8878,5006,3553,3541,12,9,1444,1390,54,3872,2423,102,162,685,500
"2021","Vale of White Horse 007","E02005984",7394,5290,4278,4248,30,4,1008,976,32,2104,1261,65,90,332,356
"2021","Vale of White Horse 008","E02005985",6434,3861,2883,2867,16,3,975,942,33,2573,1508,64,132,451,418
"2021","Vale of White Horse 009","E02005986",7766,4967,3673,3652,21,12,1282,1244,38,2799,1597,64,159,532,447
"2021","Vale of White Horse 010","E02005987",8122,5390,4105,4077,28,9,1276,1236,40,2732,1659,66,118,465,424
"2021","Vale of White Horse 011","E02005988",7237,4874,3580,3556,24,6,1288,1252,36,2363,1441,29,119,412,362
"2021","Vale of White Horse 014","E02005991",8258,5134,3919,3893,26,9,1206,1166,40,3124,1788,72,150,528,586
"2021","Vale of White Horse 015","E02005992",10844,7350,5785,5749,36,5,1560,1506,54,3494,2101,79,174,608,532
"2021","Vale of White Horse 016","E02006886",10819,7520,6111,6057,54,5,1404,1354,50,3299,1932,102,185,535,545
"2021","West Oxfordshire 001","E02005993",5884,3605,2709,2678,31,0,896,858,38,2279,1293,42,114,434,396
"2021","West Oxfordshire 002","E02005994",4953,3310,2662,2642,20,4,644,614,30,1643,960,50,69,289,275
"2021","West Oxfordshire 003","E02005995",5274,3542,2966,2938,28,4,572,560,12,1732,936,60,73,331,332
"2021","West Oxfordshire 004","E02005996",7286,4775,3764,3744,20,7,1004,970,34,2511,1419,64,102,462,464
"2021","West Oxfordshire 005","E02005997",5009,3304,2683,2671,12,1,620,604,16,1705,925,37,68,353,322
"2021","West Oxfordshire 006","E02005998",5630,3826,3135,3121,14,3,688,660,28,1804,1046,41,91,307,319
"2021","West Oxfordshire 007","E02005999",5441,3734,3076,3048,28,2,656,630,26,1707,995,38,75,292,307
"2021","West Oxfordshire 008","E02006000",9444,6018,4582,4554,28,6,1430,1360,70,3426,2067,49,136,705,469
"2021","West Oxfordshire 009","E02006001",5566,3544,2501,2487,14,8,1035,1014,21,2022,1246,38,93,382,263
"2021","West Oxfordshire 010","E02006002",8995,5168,3712,3684,28,10,1446,1388,58,3827,2260,80,170,669,648
"2021","West Oxfordshire 011","E02006003",4878,3116,2438,2426,12,2,676,652,24,1762,1005,42,95,306,314
"2021","West Oxfordshire 012","E02006004",5023,3373,2667,2645,22,4,702,674,28,1650,897,52,90,325,286
"2021","West Oxfordshire 013","E02006005",7566,5268,4015,3981,34,13,1240,1192,48,2298,1444,66,139,425,224
"2021","West Oxfordshire 014","E02006006",4630,2998,2412,2404,8,2,584,566,18,1632,916,41,84,315,276
"2021","West Oxfordshire 015","E02006007",5959,4052,3271,3251,20,5,776,750,26,1907,1064,40,78,355,370
"2021","Elmbridge 001","E02006317",4987,3102,2506,2492,14,14,582,552,30,1885,1107,52,71,373,282
"2021","Elmbridge 002","E02006318",5579,3735,2983,2951,32,8,744,706,38,1844,1129,52,96,313,254
"2021","Elmbridge 003","E02006319",5562,3266,2496,2484,12,4,766,742,24,2296,1431,46,86,432,301
"2021","Elmbridge 004","E02006320",5607,3262,2312,2288,24,6,944,902,42,2345,1472,53,118,462,240
"2021","Elmbridge 005","E02006321",4902,3414,2787,2767,20,7,620,596,24,1488,902,43,77,257,209
"2021","Elmbridge 006","E02006322",5004,3313,2723,2705,18,14,576,542,34,1691,1040,42,72,300,237
"2021","Elmbridge 007","E02006323",6022,3722,2874,2852,22,6,842,808,34,2300,1304,83,96,448,369
"2021","Elmbridge 008","E02006324",5932,3896,3175,3157,18,3,718,694,24,2036,1337,63,86,309,241
"2021","Elmbridge 009","E02006325",6978,4896,4347,4317,30,17,532,512,20,2082,1337,63,81,250,351
"2021","Elmbridge 010","E02006326",5828,3776,2959,2933,26,3,814,780,34,2052,1259,62,88,350,293
"2021","Elmbridge 011","E02006327",5213,3419,2932,2926,6,3,484,460,24,1794,950,64,77,360,343
"2021","Elmbridge 012","E02006328",7522,4606,3623,3609,14,11,972,942,30,2916,1706,86,141,593,390
"2021","Elmbridge 013","E02006329",5632,3706,3154,3144,10,10,542,512,30,1926,1183,71,97,316,259
"2021","Elmbridge 014","E02006330",7702,4772,3857,3839,18,7,908,876,32,2930,1643,84,129,559,515
"2021","Elmbridge 015","E02006331",5662,3790,3255,3245,10,7,528,508,20,1872,1116,41,81,282,352
"2021","Elmbridge 016","E02006332",5116,3382,2832,2816,16,4,546,512,34,1734,1044,76,77,334,203
"2021","Elmbridge 017","E02006333",7495,4664,3883,3873,10,5,776,748,28,2831,1575,116,134,545,461
"2021","Elmbridge 018","E02006334",6645,4661,4170,4153,17,7,484,468,16,1984,1177,78,74,304,351
"2021","Epsom and Ewell 001","E02006335",6551,4162,3509,3495,14,11,642,632,10,2389,1461,101,81,336,410
"2021","Epsom and Ewell 002","E02006336",5606,3278,2543,2527,16,9,726,696,30,2328,1526,76,93,369,264
"2021","Epsom and Ewell 003","E02006337",7160,4864,4233,4223,10,7,624,594,30,2296,1454,73,76,264,429
"2021","Epsom and Ewell 004","E02006338",5408,3524,2928,2918,10,10,586,574,12,1884,1153,59,47,284,341
"2021","Epsom and Ewell 005","E02006339",8193,5014,3945,3919,26,21,1048,982,66,3179,2117,109,136,536,281
"2021","Epsom and Ewell 007","E02006341",8176,4756,3738,3722,16,4,1014,962,52,3420,2256,88,147,507,422
"2021","Epsom and Ewell 008","E02006342",6453,3602,2678,2644,34,2,922,878,44,2851,1745,100,114,493,399
"2021","Epsom and Ewell 009","E02006343",6857,4592,3871,3857,14,7,714,678,36,2265,1409,65,74,342,375
"2021","Epsom and Ewell 010","E02006837",9426,6220,5378,5364,14,10,832,786,46,3206,2032,139,98,405,532
"2021","Guildford 001","E02006344",6897,4549,3842,3816,26,9,698,672,26,2348,1391,65,93,389,410
"2021","Guildford 002","E02006345",4907,3472,2856,2826,30,4,612,592,20,1435,835,40,68,233,259
"2021","Guildford 003","E02006346",7954,5488,4837,4823,14,13,638,604,34,2466,1429,59,91,382,505
"2021","Guildford 004","E02006347",5827,3817,2880,2846,34,6,931,914,17,2010,1184,58,102,354,312
"2021","Guildford 005","E02006348",6903,4440,3638,3626,12,10,792,750,42,2463,1513,71,101,366,412
"2021","Guildford 006","E02006349",6138,3598,2716,2690,26,14,868,822,46,2540,1752,65,96,392,235
"2021","Guildford 007","E02006350",5143,2679,2039,2019,20,7,633,618,15,2464,1741,68,82,343,230
"2021","Guildford 008","E02006351",6569,4206,3398,3386,12,2,806,772,34,2363,1475,61,108,421,298
"2021","Guildford 009","E02006352",5175,2626,2062,2053,9,7,557,543,14,2549,1981,45,59,259,205
"2021","Guildford 010","E02006353",4978,2964,2185,2173,12,5,774,744,30,2014,1175,52,98,372,317
"2021","Guildford 011","E02006354",7646,5134,4439,4429,10,13,682,660,22,2512,1577,71,82,370,412
"2021","Guildford 012","E02006355",5506,2164,1587,1581,6,5,572,540,32,3342,2638,109,95,290,210
"2021","Guildford 013","E02006356",9802,5055,3152,3112,40,5,1898,1798,100,4747,3513,180,156,559,339
"2021","Guildford 014","E02006357",5886,4004,3066,3038,28,6,932,902,30,1882,1132,33,83,353,281
"2021","Guildford 015","E02006358",5657,2816,2146,2120,26,2,668,632,36,2841,2277,63,57,232,212
"2021","Guildford 016","E02006359",5015,3238,2672,2660,12,4,562,524,38,1777,1136,66,54,301,220
"2021","Guildford 017","E02006360",6374,4214,3531,3517,14,4,679,650,29,2160,1241,68,95,374,382
"2021","Guildford 018","E02006361",4684,3130,2674,2652,22,2,454,444,10,1554,887,48,74,277,268
"2021","Mole Valley 001","E02006362",5521,3682,3252,3242,10,4,426,406,20,1839,1057,58,67,254,403
"2021","Mole Valley 002","E02006363",4747,3156,2707,2694,13,1,448,426,22,1591,918,36,69,257,311
"2021","Mole Valley 003","E02006364",6104,3428,2183,2173,10,5,1240,1190,50,2676,1728,50,151,509,238
"2021","Mole Valley 004","E02006365",5168,3282,2742,2724,18,6,534,516,18,1886,1045,38,102,348,353
"2021","Mole Valley 005","E02006366",6552,4591,3941,3931,10,26,624,590,34,1961,1157,54,73,290,387
"2021","Mole Valley 006","E02006367",4920,3204,2779,2767,12,3,422,408,14,1716,974,43,73,276,350
"2021","Mole Valley 007","E02006368",4642,2992,2564,2558,6,6,422,406,16,1650,874,28,55,278,415
"2021","Mole Valley 008","E02006369",5366,3478,2895,2881,14,9,574,556,18,1888,972,46,75,381,414
"2021","Mole Valley 009","E02006370",5180,3278,2601,2571,30,7,670,650,20,1902,1089,44,96,346,327
"2021","Mole Valley 010","E02006371",5942,3666,2857,2831,26,9,800,772,28,2276,1308,69,104,447,348
"2021","Mole Valley 011","E02006372",5113,3038,2293,2275,18,3,742,716,26,2075,1255,31,95,424,270
"2021","Mole Valley 012","E02006373",6127,3974,3244,3228,16,6,724,698,26,2153,1243,54,95,395,366
"2021","Mole Valley 013","E02006374",5810,3747,3016,3004,12,8,723,701,22,2063,1151,63,100,382,367
"2021","Reigate and Banstead 001","E02006375",5377,3589,3135,3123,12,6,448,432,16,1788,1104,59,61,256,308
"2021","Reigate and Banstead 002","E02006376",6379,3972,3291,3269,22,9,672,644,28,2407,1342,48,106,400,511
"2021","Reigate and Banstead 003","E02006377",5033,3378,2885,2881,4,5,488,468,20,1655,1049,37,48,229,292
"2021","Reigate and Banstead 004","E02006378",7033,4650,3805,3781,24,12,833,806,27,2383,1516,71,90,362,344
"2021","Reigate and Banstead 005","E02006379",5214,2946,2096,2078,18,12,838,816,22,2268,1420,47,103,422,276
"2021","Reigate and Banstead 006","E02006380",5793,3900,3377,3360,17,12,511,494,17,1893,1033,58,78,312,412
"2021","Reigate and Banstead 007","E02006381",5927,3922,3284,3266,18,10,628,590,38,2005,1179,74,74,340,338
"2021","Reigate and Banstead 008","E02006382",5227,3204,2372,2352,20,9,823,792,31,2023,1307,43,92,340,241
"2021","Reigate and Banstead 009","E02006383",7571,4961,3965,3946,19,4,992,958,34,2610,1561,86,100,425,438
"2021","Reigate and Banstead 010","E02006384",8553,5098,3941,3920,21,13,1144,1084,60,3455,2225,121,152,527,430
"2021","Reigate and Banstead 011","E02006385",8865,5477,3934,3900,34,11,1532,1466,66,3388,2263,169,157,541,258
"2021","Reigate and Banstead 012","E02006386",6379,4210,3409,3399,10,11,790,748,42,2169,1352,60,89,358,310
"2021","Reigate and Banstead 013","E02006387",5189,3262,2643,2627,16,9,610,594,16,1927,1202,36,101,329,259
"2021","Reigate and Banstead 014","E02006388",7434,4517,3446,3422,24,11,1060,1018,42,2917,1812,130,137,489,349
"2021","Reigate and Banstead 015","E02006389",5779,3694,2938,2914,24,4,752,734,18,2085,1287,53,83,314,348
"2021","Reigate and Banstead 016","E02006390",8043,5186,3831,3799,32,13,1342,1290,52,2857,1734,87,119,500,417
"2021","Reigate and Banstead 017","E02006391",6031,4178,3282,3246,36,6,890,838,52,1853,1134,57,89,329,244
"2021","Reigate and Banstead 018","E02006392",7292,4232,3076,3058,18,4,1152,1090,62,3060,1818,100,123,566,453
"2021","Runnymede 001","E02006393",5998,2666,1882,1872,10,6,778,742,36,3332,2610,76,76,297,273
"2021","Runnymede 002","E02006394",7300,3505,2687,2669,18,2,816,768,48,3795,2877,87,101,410,320
"2021","Runnymede 003","E02006395",7857,4642,3494,3472,22,2,1146,1106,40,3215,2090,93,125,530,377
"2021","Runnymede 004","E02006396",4837,2977,2351,2333,18,2,624,596,28,1860,1051,88,70,363,288
"2021","Runnymede 005","E02006397",5080,3331,2879,2860,19,10,442,416,26,1749,1002,124,86,276,261
"2021","Runnymede 006","E02006398",6960,4068,2778,2748,30,8,1282,1228,54,2892,1802,61,128,564,337
"2021","Runnymede 007","E02006399",9758,5928,4499,4469,30,11,1418,1358,60,3830,2349,118,168,652,543
"2021","Runnymede 008","E02006400",4583,2934,2344,2328,16,6,584,576,8,1649,909,75,69,322,274
"2021","Runnymede 009","E02006401",8481,5048,3807,3783,24,4,1237,1172,65,3433,2114,105,150,590,474
"2021","Runnymede 010","E02006402",8063,5287,4283,4269,14,13,991,943,48,2776,1679,84,111,415,487
"2021","Spelthorne 001","E02006403",5334,2863,2181,2165,16,8,674,630,44,2471,1537,126,131,431,246
"2021","Spelthorne 002","E02006404",5886,3276,2570,2566,4,10,696,670,26,2610,1696,152,112,387,263
"2021","Spelthorne 003","E02006405",8999,5531,4437,4406,31,1,1093,1056,37,3468,2203,151,149,527,438
"2021","Spelthorne 004","E02006406",7442,4352,3138,3094,44,6,1208,1144,64,3090,2012,124,144,519,291
"2021","Spelthorne 005","E02006407",7528,4558,3621,3601,20,3,934,894,40,2970,1806,85,123,448,508
"2021","Spelthorne 006","E02006408",7139,4246,3209,3197,12,7,1030,982,48,2893,1780,90,154,465,404
"2021","Spelthorne 007","E02006409",5416,3067,2336,2328,8,11,720,696,24,2349,1453,54,85,436,321
"2021","Spelthorne 008","E02006410",6589,3758,2813,2787,26,11,934,900,34,2831,1853,96,138,440,304
"2021","Spelthorne 009","E02006411",5974,3881,3159,3143,16,9,713,676,37,2093,1199,83,81,327,403
"2021","Spelthorne 010","E02006412",6241,4046,3320,3288,32,10,716,686,30,2195,1296,76,93,331,399
"2021","Spelthorne 011","E02006413",5166,3169,2501,2487,14,10,658,632,26,1997,1194,43,95,352,313
"2021","Spelthorne 012","E02006414",5014,3144,2504,2488,16,8,632,610,22,1870,1095,53,65,351,306
"2021","Spelthorne 013","E02006415",5862,3704,2998,2958,40,2,704,670,34,2158,1151,64,70,396,477
"2021","Surrey Heath 001","E02006416",6904,4636,3865,3845,20,11,760,736,24,2268,1283,71,95,413,406
"2021","Surrey Heath 002","E02006417",4827,3053,2312,2297,15,5,736,698,38,1774,983,68,89,357,277
"2021","Surrey Heath 003","E02006418",5494,3644,3028,3020,8,4,612,586,26,1850,1061,50,56,329,354
"2021","Surrey Heath 004","E02006419",6552,3806,2846,2824,22,12,948,916,32,2746,1709,99,119,462,357
"2021","Surrey Heath 005","E02006420",6391,4178,3596,3582,14,8,574,550,24,2213,1340,96,91,313,373
"2021","Surrey Heath 006","E02006421",7398,5045,4143,4123,20,11,891,851,40,2353,1466,89,104,360,334
"2021","Surrey Heath 007","E02006422",4930,3356,2839,2823,16,9,508,488,20,1574,916,34,86,294,244
"2021","Surrey Heath 008","E02006423",9198,5434,4129,4099,30,1,1304,1248,56,3764,2330,200,153,599,482
"2021","Surrey Heath 009","E02006424",5261,3606,3196,3192,4,8,402,398,4,1655,998,58,57,242,300
"2021","Surrey Heath 010","E02006425",5169,3218,2592,2576,16,4,622,578,44,1951,1207,92,71,310,271
"2021","Surrey Heath 011","E02006426",4498,2995,2442,2428,14,2,551,535,16,1503,871,30,60,290,252
"2021","Surrey Heath 012","E02006427",5736,3718,2910,2880,30,4,804,774,30,2018,1175,41,104,380,318
"2021","Tandridge 002","E02006429",6633,4057,2985,2971,14,4,1068,1036,32,2576,1635,77,127,439,298
"2021","Tandridge 003","E02006430",7330,4395,3372,3354,18,17,1006,966,40,2935,1870,59,148,511,347
"2021","Tandridge 004","E02006431",8655,5366,4105,4069,36,5,1256,1224,32,3289,2038,79,161,563,448
"2021","Tandridge 005","E02006432",4535,2887,2429,2419,10,6,452,442,10,1648,971,45,70,280,282
"2021","Tandridge 006","E02006433",7582,5030,4255,4225,30,11,764,736,28,2552,1425,82,115,431,499
"2021","Tandridge 007","E02006434",5114,3299,2580,2570,10,4,715,696,19,1815,1142,23,64,319,267
"2021","Tandridge 008","E02006435",4844,3124,2464,2452,12,14,646,622,24,1720,1006,48,81,323,262
"2021","Tandridge 009","E02006436",4964,3104,2350,2328,22,2,752,722,30,1860,1081,47,87,349,296
"2021","Tandridge 010","E02006437",6643,4300,3451,3429,22,17,832,798,34,2343,1312,58,103,421,449
"2021","Tandridge 011","E02006438",6900,4471,3633,3617,16,7,831,802,29,2429,1451,75,108,370,425
"2021","Tandridge 012","E02006790",6259,3874,3109,3091,18,7,758,734,24,2385,1326,67,115,420,457
"2021","Waverley 001","E02006439",5101,3244,2497,2487,10,4,743,714,29,1857,1073,40,74,338,332
"2021","Waverley 002","E02006440",5862,3766,3092,3072,20,4,670,634,36,2096,1333,38,99,308,318
"2021","Waverley 003","E02006441",6727,3614,2571,2549,22,3,1040,1002,38,3113,1910,66,138,545,454
"2021","Waverley 004","E02006442",4930,3520,3093,3087,6,3,424,402,22,1410,896,41,49,178,246
"2021","Waverley 005","E02006443",6002,3650,2704,2682,22,4,942,904,38,2352,1305,46,120,461,420
"2021","Waverley 006","E02006444",5485,3566,3010,2996,14,4,552,536,16,1919,1200,60,80,300,279
"2021","Waverley 007","E02006445",6208,3948,2953,2929,24,5,990,972,18,2260,1351,60,150,408,291
"2021","Waverley 008","E02006446",5496,3670,3146,3134,12,10,514,484,30,1826,1028,46,77,343,332
"2021","Waverley 009","E02006447",5145,3392,2857,2851,6,8,527,516,11,1753,1041,39,86,323,264
"2021","Waverley 010","E02006448",5681,3942,3273,3263,10,3,666,642,24,1739,1046,53,68,298,274
"2021","Waverley 011","E02006449",5656,3585,3016,2998,18,8,561,542,19,2071,1140,35,83,373,440
"2021","Waverley 012","E02006450",5528,3836,3278,3270,8,0,558,520,38,1692,1006,45,56,306,279
"2021","Waverley 013","E02006451",9257,6092,5018,4994,24,10,1064,1026,38,3165,1696,90,152,607,620
"2021","Waverley 015","E02006453",6602,4456,3782,3766,16,4,670,654,16,2146,1115,64,81,399,487
"2021","Waverley 016","E02006454",5390,3630,3060,3044,16,2,568,544,24,1760,954,55,78,313,360
"2021","Waverley 017","E02006455",4647,3004,2368,2354,14,2,634,610,24,1643,971,41,98,310,223
"2021","Waverley 018","E02006839",6760,4542,3863,3849,14,7,672,642,30,2218,1273,80,88,366,411
"2021","Woking 001","E02006456",6360,3796,2908,2894,14,8,880,852,28,2564,1508,71,118,458,409
"2021","Woking 002","E02006457",7419,5143,4450,4432,18,3,690,672,18,2276,1340,65,87,363,421
"2021","Woking 003","E02006458",7245,5010,4307,4277,30,15,688,660,28,2235,1436,78,83,298,340
"2021","Woking 004","E02006459",8283,4282,3408,3382,26,10,864,838,26,4001,2564,449,182,468,338
"2021","Woking 005","E02006460",7344,4406,3345,3331,14,13,1048,1014,34,2938,1817,82,155,531,353
"2021","Woking 006","E02006461",5464,3472,2859,2839,20,3,610,592,18,1992,1192,84,78,345,293
"2021","Woking 007","E02006462",6620,4131,3190,3167,23,11,930,886,44,2489,1549,75,108,464,293
"2021","Woking 008","E02006463",8748,5214,3578,3544,34,2,1634,1548,86,3534,2232,165,149,611,377
"2021","Woking 009","E02006464",5495,3406,2681,2661,20,7,718,690,28,2089,1222,42,96,390,339
"2021","Woking 010","E02006465",4995,3412,2871,2855,16,5,536,514,22,1583,983,59,57,240,244
"2021","Woking 011","E02006466",8568,5161,3967,3937,30,6,1188,1136,52,3407,2195,130,160,538,384
"2021","Woking 012","E02006467",5739,4036,3374,3356,18,12,650,624,26,1703,1034,50,72,249,298
"2021","Adur 001","E02006534",7363,4517,3437,3385,52,7,1073,1036,37,2846,1690,60,110,468,518
"2021","Adur 002","E02006535",5839,3946,3166,3122,44,10,770,734,36,1893,1044,42,77,340,390
"2021","Adur 003","E02006536",5889,3938,3089,3053,36,5,844,806,38,1951,1136,35,82,340,358
"2021","Adur 004","E02006537",8267,4558,3192,3160,32,16,1350,1302,48,3709,2205,80,203,707,514
"2021","Adur 005","E02006538",7704,4554,3234,3144,90,14,1306,1214,92,3150,1721,67,161,706,495
"2021","Adur 006","E02006539",6033,3636,2708,2674,34,8,920,884,36,2397,1361,43,103,437,453
"2021","Adur 007","E02006540",4785,2852,2041,2019,22,3,808,774,34,1933,1017,37,95,420,364
"2021","Adur 008","E02006541",6517,3704,2615,2575,40,3,1086,1026,60,2813,1477,61,123,619,533
"2021","Arun 001","E02006542",4900,3044,2456,2416,40,2,586,556,30,1856,961,51,87,397,360
"2021","Arun 002","E02006543",4813,3130,2452,2436,16,10,668,630,38,1683,861,43,71,369,339
"2021","Arun 003","E02006544",9392,6244,4978,4936,42,10,1256,1204,52,3148,1803,60,152,607,526
"2021","Arun 004","E02006545",9229,5584,3872,3814,58,12,1700,1626,74,3645,2240,71,228,708,398
"2021","Arun 005","E02006546",9038,5688,4416,4384,32,14,1258,1212,46,3350,1815,49,157,627,702
"2021","Arun 006","E02006547",5271,3385,2601,2563,38,18,766,734,32,1886,1075,40,91,369,311
"2021","Arun 007","E02006548",7994,4904,3720,3690,30,6,1178,1136,42,3090,1626,54,146,685,579
"2021","Arun 008","E02006549",5594,3816,3271,3239,32,3,542,494,48,1778,799,32,62,327,558
"2021","Arun 009","E02006550",8154,4995,4015,3989,26,6,974,938,36,3159,1645,70,128,573,743
"2021","Arun 010","E02006551",7223,4601,3922,3878,44,2,677,646,31,2622,964,68,115,594,881
"2021","Arun 011","E02006552",5992,2878,1855,1827,28,3,1020,968,52,3114,1740,82,199,753,340
"2021","Arun 012","E02006553",7824,5008,3584,3558,26,4,1420,1346,74,2816,1575,95,122,551,473
"2021","Arun 013","E02006554",5724,3646,2873,2857,16,11,762,726,36,2078,977,43,87,441,530
"2021","Arun 014","E02006555",6238,3308,2278,2252,26,4,1026,962,64,2930,1765,75,115,611,364
"2021","Arun 015","E02006556",8742,5740,4566,4530,36,6,1168,1122,46,3002,1598,73,120,553,658
"2021","Arun 016","E02006557",6137,3275,2272,2251,21,9,994,958,36,2862,1818,87,137,508,312
"2021","Arun 017","E02006558",8424,4098,2496,2467,29,6,1596,1498,98,4326,2430,120,218,994,564
"2021","Arun 018","E02006559",7252,5066,4291,4271,20,7,768,742,26,2186,962,65,77,370,712
"2021","Arun 019","E02006560",8171,5249,4157,4141,16,10,1082,1046,36,2922,1383,76,109,570,784
"2021","Chichester 001","E02006561",5213,3584,3015,3001,14,3,566,552,14,1629,941,30,68,303,287
"2021","Chichester 002","E02006562",5108,3630,3025,3007,18,3,602,574,28,1478,861,48,60,233,276
"2021","Chichester 003","E02006563",4813,3211,2751,2739,12,6,454,436,18,1602,901,55,66,273,307
"2021","Chichester 004","E02006564",6712,4264,3365,3335,30,3,896,856,40,2448,1176,36,106,559,571
"2021","Chichester 005","E02006565",6622,4314,3547,3513,34,1,766,726,40,2308,1181,65,110,463,489
"2021","Chichester 006","E02006566",6907,4461,3647,3619,28,5,809,783,26,2446,1285,61,123,462,515
"2021","Chichester 007","E02006567",6385,4173,3421,3401,20,0,752,722,30,2212,1229,38,111,427,407
"2021","Chichester 008","E02006568",9844,4853,3328,3288,40,8,1517,1455,62,4991,3225,81,206,849,630
"2021","Chichester 009","E02006569",6960,4660,3821,3793,28,9,830,796,34,2300,1177,70,102,488,463
"2021","Chichester 010","E02006570",7346,3784,2606,2576,30,0,1178,1084,94,3562,2029,71,154,732,576
"2021","Chichester 011","E02006571",6865,4436,3590,3558,32,2,844,812,32,2429,1345,68,116,469,431
"2021","Chichester 012","E02006572",9042,5437,4002,3975,27,7,1428,1376,52,3605,2134,93,184,728,466
"2021","Chichester 013","E02006573",9780,6287,5134,5088,46,12,1141,1100,41,3493,1730,125,171,627,840
"2021","Chichester 014","E02006574",9414,5792,4661,4611,50,15,1116,1086,30,3622,1711,103,155,701,952
"2021","Crawley 001","E02006575",6847,3642,2889,2875,14,5,748,712,36,3205,2010,243,162,458,332
"2021","Crawley 002","E02006576",8320,5546,4158,4142,16,6,1382,1346,36,2774,1761,87,136,453,337
"2021","Crawley 003","E02006577",7006,3931,2976,2961,15,15,940,902,38,3075,1893,104,122,535,421
"2021","Crawley 004","E02006578",9949,5499,3869,3847,22,16,1614,1510,104,4450,2946,261,167,644,432
"2021","Crawley 005","E02006579",6761,3950,2963,2951,12,11,976,908,68,2811,1795,122,119,421,354
"2021","Crawley 006","E02006580",6662,4007,3040,3026,14,5,962,924,38,2655,1652,83,125,410,385
"2021","Crawley 007","E02006581",8136,4404,3039,3008,31,13,1352,1260,92,3732,2378,173,175,593,413
"2021","Crawley 008","E02006582",6241,4174,3300,3272,28,14,860,814,46,2067,1410,39,79,348,191
"2021","Crawley 009","E02006583",7646,4569,3546,3524,22,8,1015,962,53,3077,1895,79,141,548,414
"2021","Crawley 010","E02006584",6061,3326,2375,2365,10,9,942,906,36,2735,1779,91,121,484,260
"2021","Crawley 011","E02006585",6492,3622,2756,2738,18,4,862,830,32,2870,1790,96,100,473,411
"2021","Crawley 012","E02006586",6157,3366,2446,2430,16,8,912,878,34,2791,1901,126,148,413,203
"2021","Crawley 013","E02006587",6731,3567,2519,2501,18,13,1035,1006,29,3164,2032,126,169,598,239
"2021","Horsham 001","E02006588",8407,5386,3898,3859,39,5,1483,1414,69,3021,1873,82,126,581,359
"2021","Horsham 002","E02006589",9258,6432,5277,5247,30,9,1146,1100,46,2826,1724,56,93,509,444
"2021","Horsham 003","E02006590",7114,4474,3424,3410,14,6,1044,998,46,2640,1530,50,138,514,408
"2021","Horsham 004","E02006591",6762,4158,3093,3071,22,11,1054,1020,34,2604,1565,50,128,456,405
"2021","Horsham 005","E02006592",5236,3635,2996,2990,6,2,637,618,19,1601,923,42,73,275,288
"2021","Horsham 006","E02006593",9093,5154,3762,3724,38,4,1388,1330,58,3939,2299,89,158,765,628
"2021","Horsham 007","E02006594",8562,5758,4328,4300,28,6,1424,1358,66,2804,1674,49,137,544,400
"2021","Horsham 008","E02006595",6748,4782,4033,3997,36,5,744,712,32,1966,1161,58,67,295,385
"2021","Horsham 009","E02006596",7533,5050,4100,4074,26,12,938,910,28,2483,1557,25,110,430,361
"2021","Horsham 010","E02006597",9875,6596,5034,4996,38,14,1548,1496,52,3279,1902,61,150,659,507
"2021","Horsham 011","E02006598",4524,3115,2525,2509,16,6,584,560,24,1409,828,38,68,242,233
"2021","Horsham 012","E02006599",6095,4506,3988,3958,30,4,514,490,24,1589,778,47,59,255,450
"2021","Horsham 013","E02006600",8295,5168,4045,4001,44,3,1120,1078,42,3127,1513,54,177,680,703
"2021","Horsham 014","E02006601",7280,4605,3678,3629,49,9,918,880,38,2675,1427,55,132,522,539
"2021","Horsham 015","E02006602",6994,4925,4027,4000,27,12,886,856,30,2069,1263,57,103,317,329
"2021","Horsham 016","E02006603",7120,4582,3747,3725,22,7,828,802,26,2538,1270,61,97,552,558
"2021","Mid Sussex 001","E02006604",10788,6413,4672,4646,26,10,1731,1666,65,4375,2525,94,231,907,618
"2021","Mid Sussex 002","E02006605",5195,3315,2654,2634,20,10,651,619,32,1880,1160,58,90,309,263
"2021","Mid Sussex 003","E02006606",6678,4454,3554,3542,12,8,892,868,24,2224,1285,43,86,455,355
"2021","Mid Sussex 004","E02006607",6448,4362,3696,3678,18,10,656,642,14,2086,1209,72,81,350,374
"2021","Mid Sussex 005","E02006608",5162,3521,2948,2942,6,0,573,556,17,1641,897,40,71,299,334
"2021","Mid Sussex 006","E02006609",5439,3773,3037,3005,32,3,733,692,41,1666,939,35,72,293,327
"2021","Mid Sussex 007","E02006610",6150,4183,3226,3196,30,10,947,907,40,1967,1175,42,117,349,284
"2021","Mid Sussex 008","E02006611",8925,6228,5215,5185,30,15,998,942,56,2697,1455,61,97,507,577
"2021","Mid Sussex 009","E02006612",9425,5734,4123,4063,60,11,1600,1524,76,3691,2147,119,192,732,501
"2021","Mid Sussex 010","E02006613",6192,3709,2780,2749,31,3,926,890,36,2483,1557,50,97,459,320
"2021","Mid Sussex 011","E02006614",10117,6659,5241,5179,62,12,1406,1352,54,3458,2078,81,185,632,482
"2021","Mid Sussex 012","E02006615",5630,3722,2796,2774,22,4,922,882,40,1908,1216,39,64,380,209
"2021","Mid Sussex 013","E02006616",7922,5336,3991,3951,40,14,1331,1268,63,2586,1569,43,117,435,422
"2021","Mid Sussex 014","E02006617",7468,4348,3277,3245,32,7,1064,1006,58,3120,1723,98,165,595,539
"2021","Mid Sussex 015","E02006618",5239,3656,3098,3084,14,4,554,528,26,1583,956,30,61,250,286
"2021","Mid Sussex 016","E02006619",6870,4514,3607,3567,40,9,898,852,46,2356,1412,54,110,436,344
"2021","Mid Sussex 017","E02006620",8058,5426,4462,4420,42,12,952,912,40,2632,1393,59,116,449,615
"2021","Worthing 001","E02006621",6655,4598,3845,3815,30,5,748,726,22,2057,1054,56,80,363,504
"2021","Worthing 002","E02006622",6494,4090,3169,3137,32,5,916,896,20,2404,1315,44,120,507,418
"2021","Worthing 003","E02006623",6479,3792,2833,2795,38,11,948,914,34,2687,1486,40,130,592,439
"2021","Worthing 004","E02006624",5971,4020,3332,3300,32,0,688,660,28,1951,1244,23,80,269,335
"2021","Worthing 005","E02006625",6443,3866,2808,2772,36,8,1050,988,62,2577,1542,52,130,514,339
"2021","Worthing 006","E02006626",7694,4638,3320,3290,30,6,1312,1260,52,3056,1937,47,184,577,311
"2021","Worthing 007","E02006627",7868,4875,3555,3516,39,14,1306,1240,66,2993,1695,45,145,587,521
"2021","Worthing 008","E02006628",7110,3787,2569,2519,50,6,1212,1140,72,3323,2086,64,162,716,295
"2021","Worthing 009","E02006629",6179,3392,2461,2405,56,5,926,868,58,2787,1731,62,140,538,316
"2021","Worthing 010","E02006630",7118,3562,2296,2252,44,6,1260,1182,78,3556,1943,87,187,810,529
"2021","Worthing 011","E02006631",8548,3953,2228,2145,83,5,1720,1574,146,4595,2718,124,231,1024,498
"2021","Worthing 012","E02006632",6937,4212,3169,3118,51,4,1039,966,73,2725,1411,51,144,621,498
"2021","Worthing 013","E02006633",7192,4645,3846,3811,35,5,794,752,42,2547,1285,59,88,453,662
"2021","Bath and North East Somerset 001","E02002985",5358,3414,2499,2477,22,9,906,882,24,1944,1162,34,101,333,314
"2021","Bath and North East Somerset 002","E02002986",5645,3400,2320,2302,18,8,1072,1008,64,2245,1298,32,99,430,386
"2021","Bath and North East Somerset 003","E02002987",4789,3214,2692,2680,12,6,516,482,34,1575,874,24,65,279,333
"2021","Bath and North East Somerset 004","E02002988",4527,2704,2123,2099,24,3,578,542,36,1823,1127,39,53,360,244
"2021","Bath and North East Somerset 005","E02002989",4455,2633,2133,2117,16,2,498,484,14,1822,1129,46,57,290,300
"2021","Bath and North East Somerset 006","E02002990",4976,2720,1769,1737,32,5,946,900,46,2256,1632,60,70,329,165
"2021","Bath and North East Somerset 007","E02002991",9350,4681,3096,3027,69,7,1578,1486,92,4669,3333,115,130,627,464
"2021","Bath and North East Somerset 008","E02002992",4698,2713,2177,2167,10,11,525,498,27,1985,1322,33,52,303,275
"2021","Bath and North East Somerset 009","E02002993",4723,2186,1362,1340,22,0,824,776,48,2537,2000,43,53,298,143
"2021","Bath and North East Somerset 010","E02002994",8447,5536,4610,4570,40,12,914,880,34,2911,1717,88,91,511,504
"2021","Bath and North East Somerset 011","E02002995",4454,1984,1256,1250,6,2,726,700,26,2470,1826,52,72,343,177
"2021","Bath and North East Somerset 012","E02002996",7415,3802,2976,2934,42,5,821,783,38,3613,2787,75,89,309,353
"2021","Bath and North East Somerset 013","E02002997",6890,2629,1638,1606,32,0,991,927,64,4261,3718,45,78,265,155
"2021","Bath and North East Somerset 014","E02002998",5138,1958,1434,1422,12,4,520,498,22,3180,2666,38,47,247,182
"2021","Bath and North East Somerset 015","E02002999",4665,2480,1876,1874,2,2,602,582,20,2185,1515,39,74,285,272
"2021","Bath and North East Somerset 016","E02003000",7976,5389,4492,4465,27,5,892,848,44,2587,1453,61,89,438,546
"2021","Bath and North East Somerset 017","E02003001",4450,2854,2371,2349,22,5,478,460,18,1596,1058,34,57,219,228
"2021","Bath and North East Somerset 018","E02003002",4977,2734,2118,2100,18,4,612,578,34,2243,1469,51,97,329,297
"2021","Bath and North East Somerset 019","E02003003",4836,2620,1990,1972,18,4,626,598,28,2216,1542,39,55,306,274
"2021","Bath and North East Somerset 020","E02003004",5917,4062,3088,3086,2,8,966,934,32,1855,1193,54,75,253,280
"2021","Bath and North East Somerset 021","E02003005",5510,3822,3230,3218,12,4,588,560,28,1688,993,54,73,262,306
"2021","Bath and North East Somerset 022","E02003006",7198,4528,3625,3593,32,5,898,860,38,2670,1639,52,124,460,395
"2021","Bath and North East Somerset 023","E02003007",7668,5006,3843,3817,26,7,1156,1116,40,2662,1554,62,121,474,451
"2021","Bath and North East Somerset 024","E02003008",4807,2970,2096,2080,16,8,866,842,24,1837,1127,32,100,346,232
"2021","Bath and North East Somerset 025","E02003009",5084,3289,2508,2488,20,2,779,756,23,1795,1056,27,74,327,311
"2021","Bath and North East Somerset 026","E02003010",5198,3329,2427,2411,16,7,895,876,19,1869,1192,29,80,313,255
"2021","Bath and North East Somerset 027","E02003011",4825,3068,2460,2454,6,10,598,574,24,1757,1046,25,77,273,336
"2021","Bristol 001","E02003012",9436,5121,3502,3482,20,19,1600,1548,52,4315,2832,122,171,752,438
"2021","Bristol 002","E02003013",9954,4886,3478,3464,14,18,1390,1308,82,5068,3457,171,215,689,536
"2021","Bristol 003","E02003014",6290,3070,2058,2050,8,4,1008,946,62,3220,2153,88,147,481,351
"2021","Bristol 004","E02003015",5597,2893,2118,2098,20,10,765,715,50,2704,1967,68,79,338,252
"2021","Bristol 005","E02003016",6584,2788,1783,1771,12,11,994,956,38,3796,3062,86,110,331,207
"2021","Bristol 006","E02003017",4968,3042,2490,2474,16,2,550,526,24,1926,1136,38,68,344,340
"2021","Bristol 007","E02003018",4903,2896,2238,2226,12,2,656,632,24,2007,1232,42,87,384,262
"2021","Bristol 008","E02003019",8202,4600,3148,3118,30,12,1440,1406,34,3602,2245,118,165,650,424
"2021","Bristol 009","E02003020",4829,3372,2928,2910,18,6,438,416,22,1457,796,35,34,229,363
"2021","Bristol 010","E02003021",6104,2894,1874,1852,22,2,1018,972,46,3210,2695,41,70,247,157
"2021","Bristol 011","E02003022",4863,3442,3033,3017,16,11,398,378,20,1421,867,24,36,200,294
"2021","Bristol 012","E02003023",5160,2674,1982,1958,24,10,682,658,24,2486,1722,73,85,367,239
"2021","Bristol 013","E02003024",8007,3927,2562,2526,36,11,1354,1264,90,4080,2891,132,152,474,431
"2021","Bristol 014","E02003025",6048,2857,1947,1937,10,6,904,866,38,3191,2256,95,128,425,287
"2021","Bristol 015","E02003026",6369,4246,3590,3558,32,6,650,622,28,2123,1259,72,65,335,392
"2021","Bristol 016","E02003027",10534,5538,3697,3631,66,12,1829,1736,93,4996,4131,62,115,450,238
"2021","Bristol 017","E02003028",7012,4145,3180,3167,13,1,964,922,42,2867,2195,49,67,331,225
"2021","Bristol 018","E02003029",5160,2624,1835,1821,14,7,782,748,34,2536,1742,72,108,342,272
"2021","Bristol 019","E02003030",6507,3198,2100,2062,38,12,1086,1016,70,3309,2517,119,115,372,186
"2021","Bristol 020","E02003031",8774,4468,2869,2823,46,13,1586,1514,72,4306,3745,55,80,278,148
"2021","Bristol 021","E02003032",6671,3560,2394,2366,28,4,1162,1106,56,3111,2188,103,126,437,257
"2021","Bristol 022","E02003033",8076,3030,1610,1580,30,6,1414,1344,70,5046,4568,52,67,239,120
"2021","Bristol 025","E02003036",6958,3010,1411,1391,20,3,1596,1502,94,3948,3508,50,73,241,76
"2021","Bristol 026","E02003037",8290,3418,1692,1672,20,2,1724,1634,90,4872,4312,80,67,266,147
"2021","Bristol 027","E02003038",5621,3192,2129,2121,8,9,1054,994,60,2429,1594,69,107,381,278
"2021","Bristol 028","E02003039",7139,3790,2435,2411,24,13,1342,1266,76,3349,2335,80,132,508,294
"2021","Bristol 029","E02003040",8293,4208,1914,1870,44,14,2280,2152,128,4085,3094,94,127,523,247
"2021","Bristol 030","E02003041",5404,2645,1515,1475,40,1,1129,1067,62,2759,2189,63,62,267,178
"2021","Bristol 033","E02003044",5103,3117,2087,2076,11,8,1022,968,54,1986,1296,58,73,314,245
"2021","Bristol 034","E02003045",5428,2374,1271,1248,23,4,1099,1022,77,3054,2573,32,69,266,114
"2021","Bristol 035","E02003046",8182,4759,2818,2769,49,9,1932,1822,110,3423,2457,73,137,434,322
"2021","Bristol 036","E02003047",9279,4964,2823,2775,48,5,2136,2028,108,4315,3461,60,107,438,249
"2021","Bristol 037","E02003048",5815,3198,1661,1599,62,7,1530,1426,104,2617,2035,70,72,315,125
"2021","Bristol 038","E02003049",6323,3782,2666,2640,26,8,1108,1062,46,2541,1670,74,103,381,313
"2021","Bristol 039","E02003050",8891,4550,2124,2078,46,10,2416,2288,128,4341,3362,88,105,474,312
"2021","Bristol 040","E02003051",6018,3214,1903,1879,24,3,1308,1224,84,2804,2190,61,82,305,166
"2021","Bristol 041","E02003052",5953,3482,2290,2234,56,4,1188,1140,48,2471,1851,24,76,277,243
"2021","Bristol 042","E02003053",6949,4254,2993,2949,44,13,1248,1184,64,2695,1853,66,83,380,313
"2021","Bristol 043","E02003054",5507,3352,2402,2374,28,6,944,890,54,2155,1479,43,89,308,236
"2021","Bristol 044","E02003055",6916,3568,2391,2379,12,5,1172,1108,64,3348,2472,85,120,361,310
"2021","Bristol 045","E02003056",5901,2909,1907,1897,10,5,997,947,50,2992,2052,69,136,411,324
"2021","Bristol 046","E02003057",5019,3090,2140,2116,24,8,942,908,34,1929,1228,42,81,291,287
"2021","Bristol 047","E02003058",7790,4416,3046,3022,24,10,1360,1308,52,3374,2198,87,138,526,425
"2021","Bristol 048","E02003059",5373,3056,2004,1990,14,4,1048,988,60,2317,1510,54,91,315,347
"2021","Bristol 049","E02003060",9033,5228,4013,3983,30,7,1208,1174,34,3805,2348,81,140,580,656
"2021","Bristol 050","E02003061",4754,2385,1577,1569,8,7,801,766,35,2369,1581,40,109,383,256
"2021","Bristol 051","E02003062",4538,2269,1419,1414,5,0,850,822,28,2269,1564,48,103,309,245
"2021","Bristol 052","E02003063",6021,3953,3110,3103,7,1,842,810,32,2068,1239,33,73,304,419
"2021","Bristol 053","E02003064",5359,2467,1433,1426,7,6,1028,986,42,2892,2031,50,133,382,296
"2021","Bristol 054","E02006887",7325,3195,1256,1236,20,2,1937,1778,159,4130,3378,141,116,392,103
"2021","Bristol 055","E02006888",5613,2198,1354,1340,14,8,836,774,62,3415,2542,199,133,373,168
"2021","Bristol 056","E02006889",5763,2177,1538,1520,18,4,635,580,55,3586,2479,239,199,459,210
"2021","Bristol 057","E02006890",7417,3354,1948,1906,42,6,1400,1302,98,4063,3113,203,131,413,203
"2021","Bristol 058","E02006949",5681,2306,1159,1136,23,7,1140,1088,52,3375,2733,114,88,324,116
"2021","Bristol 059","E02006950",6291,2173,899,871,28,1,1273,1190,83,4118,3458,130,85,364,81
"2021","Bristol 060","E02006951",6263,1898,859,834,25,3,1036,948,88,4365,4008,74,56,167,60
"2021","Bristol 061","E02006952",5027,2082,936,902,34,2,1144,1056,88,2945,2502,76,74,216,77
"2021","North Somerset 001","E02003065",8109,4963,3789,3765,24,14,1160,1098,62,3146,1644,67,167,686,582
"2021","North Somerset 002","E02003066",5126,3740,3250,3230,20,0,490,476,14,1386,755,29,48,244,310
"2021","North Somerset 003","E02003067",6373,4136,3265,3249,16,5,866,840,26,2237,1210,41,110,436,440
"2021","North Somerset 004","E02003068",5266,3478,2706,2686,20,10,762,740,22,1788,1017,38,86,334,313
"2021","North Somerset 005","E02003069",4642,3166,2650,2622,28,2,514,494,20,1476,740,31,63,301,341
"2021","North Somerset 006","E02003070",10493,7410,6086,6050,36,14,1310,1256,54,3083,1755,70,143,528,587
"2021","North Somerset 007","E02003071",6583,3943,2960,2942,18,6,977,946,31,2640,1415,35,122,577,491
"2021","North Somerset 008","E02003072",7792,4849,3891,3873,18,3,955,937,18,2943,1468,51,113,581,730
"2021","North Somerset 009","E02003073",5261,3662,3164,3148,16,4,494,476,18,1599,888,51,63,293,304
"2021","North Somerset 010","E02003074",6371,4070,3150,3130,20,2,918,878,40,2301,1288,34,98,499,382
"2021","North Somerset 011","E02003075",4894,3430,2974,2958,16,4,452,436,16,1464,873,33,38,245,275
"2021","North Somerset 012","E02003076",8050,5384,4278,4250,28,8,1098,1076,22,2666,1506,60,103,524,473
"2021","North Somerset 013","E02003077",5242,3608,2874,2858,16,12,722,696,26,1634,935,38,74,249,338
"2021","North Somerset 014","E02003078",6111,4024,3280,3250,30,4,740,706,34,2087,1216,42,85,356,388
"2021","North Somerset 015","E02003079",7519,4983,3796,3785,11,5,1182,1148,34,2536,1488,43,128,532,345
"2021","North Somerset 016","E02003080",7301,4283,3259,3244,15,6,1018,984,34,3018,1459,68,151,639,701
"2021","North Somerset 017","E02003081",7983,5217,4109,4093,16,7,1101,1048,53,2766,1560,67,102,485,552
"2021","North Somerset 018","E02003082",7639,3992,2696,2654,42,2,1294,1206,88,3647,2023,113,186,911,414
"2021","North Somerset 020","E02003084",8593,3986,2573,2541,32,7,1406,1330,76,4607,2773,125,253,946,510
"2021","North Somerset 021","E02003085",6053,2877,1836,1820,16,13,1028,978,50,3176,1953,60,158,651,354
"2021","North Somerset 022","E02003086",4976,2779,2053,2031,22,11,715,651,64,2197,1259,74,101,436,327
"2021","North Somerset 023","E02003087",8995,6091,4771,4741,30,10,1310,1268,42,2904,1519,64,145,571,605
"2021","North Somerset 024","E02003088",7359,4958,4155,4129,26,9,794,778,16,2401,1299,58,116,391,537
"2021","North Somerset 025","E02003089",4879,2907,2282,2276,6,4,621,578,43,1972,1089,56,101,365,361
"2021","North Somerset 026","E02006845",7340,4659,3297,3265,32,10,1352,1288,64,2681,1591,53,161,564,312
"2021","North Somerset 027","E02006846",7216,4515,2810,2776,34,5,1700,1620,80,2701,1729,56,173,563,180
"2021","South Gloucestershire 001","E02003090",7203,4962,3868,3844,24,8,1086,1036,50,2241,1313,45,99,362,422
"2021","South Gloucestershire 002","E02003091",5542,3507,2785,2771,14,4,718,686,32,2035,1127,34,99,387,388
"2021","South Gloucestershire 003","E02003092",6727,4641,3739,3711,28,2,900,866,34,2086,1328,47,110,307,294
"2021","South Gloucestershire 004","E02003093",5612,3924,3338,3336,2,2,584,560,24,1688,937,38,74,257,382
"2021","South Gloucestershire 005","E02003094",7218,4788,3786,3764,22,6,996,938,58,2430,1485,68,114,419,344
"2021","South Gloucestershire 006","E02003095",6951,4746,3613,3599,14,3,1130,1084,46,2205,1502,40,82,306,275
"2021","South Gloucestershire 007","E02003096",5161,3097,2169,2158,11,0,928,898,30,2064,1269,40,96,375,284
"2021","South Gloucestershire 008","E02003097",5479,3550,2865,2857,8,1,684,668,16,1929,995,41,71,335,487
"2021","South Gloucestershire 009","E02003098",8014,5212,3781,3753,28,11,1420,1336,84,2802,1873,95,121,521,192
"2021","South Gloucestershire 010","E02003099",6160,3845,2919,2905,14,2,924,888,36,2315,1329,35,88,450,413
"2021","South Gloucestershire 012","E02003101",8514,5548,4013,3999,14,13,1522,1434,88,2966,1967,88,133,541,237
"2021","South Gloucestershire 013","E02003102",5719,3874,3253,3235,18,1,620,598,22,1845,1120,37,66,279,343
"2021","South Gloucestershire 014","E02003103",5670,3573,2480,2468,12,9,1084,1034,50,2097,1345,30,97,407,218
"2021","South Gloucestershire 015","E02003104",6190,3864,2922,2904,18,6,936,896,40,2326,1460,47,93,406,320
"2021","South Gloucestershire 016","E02003105",5179,3389,2769,2758,11,4,616,602,14,1790,991,52,73,285,389
"2021","South Gloucestershire 018","E02003107",9621,4472,3234,3210,24,6,1232,1178,54,5149,3826,125,152,560,486
"2021","South Gloucestershire 019","E02003108",9845,6480,4631,4611,20,7,1842,1756,86,3365,2132,90,149,512,482
"2021","South Gloucestershire 020","E02003109",4997,3538,2991,2983,8,7,540,526,14,1459,866,31,42,200,320
"2021","South Gloucestershire 021","E02003110",9560,6593,4999,4973,26,13,1581,1550,31,2967,2008,66,155,430,308
"2021","South Gloucestershire 022","E02003111",5353,3437,2728,2702,26,4,705,664,41,1916,1105,36,69,320,386
"2021","South Gloucestershire 023","E02003112",5189,2988,2174,2164,10,8,806,774,32,2201,1333,41,83,396,348
"2021","South Gloucestershire 024","E02003113",8667,5898,4797,4767,30,15,1086,1056,30,2769,1634,72,115,428,520
"2021","South Gloucestershire 025","E02003114",5955,3614,2627,2614,13,2,985,940,45,2341,1367,43,87,398,446
"2021","South Gloucestershire 026","E02003115",7841,4472,3030,3006,24,11,1431,1378,53,3369,2175,69,160,549,416
"2021","South Gloucestershire 027","E02003116",6228,3500,2389,2379,10,7,1104,1062,42,2728,1657,60,102,486,423
"2021","South Gloucestershire 028","E02003117",7540,4570,3122,3088,34,0,1448,1372,76,2970,1944,63,117,458,388
"2021","South Gloucestershire 029","E02003118",8163,5164,3750,3712,38,10,1404,1346,58,2999,1908,42,122,550,377
"2021","South Gloucestershire 030","E02003119",8305,5184,3837,3817,20,3,1344,1302,42,3121,1930,43,143,577,428
"2021","South Gloucestershire 031","E02003120",7601,4988,3987,3975,12,7,994,968,26,2613,1578,49,89,398,499
"2021","South Gloucestershire 032","E02003121",8565,5676,4507,4479,28,5,1164,1124,40,2889,1649,49,92,496,603
"2021","South Gloucestershire 033","E02007064",6410,3819,2791,2774,17,12,1016,974,42,2591,1537,79,128,437,410
"2021","South Gloucestershire 034","E02007065",5978,3597,2333,2308,25,2,1262,1188,74,2381,1633,73,88,398,189
"2021","South Gloucestershire 035","E02007066",5436,2514,1654,1638,16,2,858,816,42,2922,2359,57,91,273,142
"2021","South Gloucestershire 036","E02007067",5401,3528,2761,2741,20,3,764,726,38,1873,1277,62,80,236,218
"2021","Plymouth 001","E02003122",6039,4236,3512,3494,18,4,720,704,16,1803,916,33,76,314,464
"2021","Plymouth 002","E02003123",6875,4042,2904,2888,16,0,1138,1090,48,2833,1605,46,154,571,457
"2021","Plymouth 003","E02003124",6400,3696,2487,2467,20,3,1206,1138,68,2704,1604,45,160,531,364
"2021","Plymouth 004","E02003125",4939,2766,1909,1899,10,7,850,810,40,2173,1228,26,113,474,332
"2021","Plymouth 005","E02003126",6510,4122,3145,3137,8,5,972,934,38,2388,1352,36,103,496,401
"2021","Plymouth 006","E02003127",5933,3387,2377,2373,4,3,1007,948,59,2546,1501,29,135,517,364
"2021","Plymouth 007","E02003128",7292,4139,2748,2728,20,18,1373,1294,79,3153,1770,57,170,694,462
"2021","Plymouth 008","E02003129",5224,3368,2708,2694,14,8,652,630,22,1856,970,33,110,389,354
"2021","Plymouth 009","E02003130",8448,4874,3444,3414,30,10,1420,1344,76,3574,2144,56,177,694,503
"2021","Plymouth 010","E02003131",5967,3576,2599,2581,18,11,966,926,40,2391,1352,28,126,482,403
"2021","Plymouth 011","E02003132",7014,4286,3206,3190,16,12,1068,1012,56,2728,1602,51,138,557,380
"2021","Plymouth 012","E02003133",5849,3720,2864,2850,14,8,848,824,24,2129,1170,38,103,429,389
"2021","Plymouth 013","E02003134",5496,3158,2180,2154,26,6,972,926,46,2338,1475,40,102,413,308
"2021","Plymouth 014","E02003135",5340,2804,1746,1730,16,6,1052,990,62,2536,1553,64,138,494,287
"2021","Plymouth 015","E02003136",6392,4186,3467,3457,10,9,710,692,18,2206,1148,47,97,405,509
"2021","Plymouth 016","E02003137",6246,4210,3397,3371,26,3,810,784,26,2036,1179,52,81,343,381
"2021","Plymouth 017","E02003138",6098,3784,2673,2621,52,5,1106,1028,78,2314,1430,57,127,452,248
"2021","Plymouth 018","E02003139",5336,3740,2769,2755,14,3,968,930,38,1596,996,19,84,325,172
"2021","Plymouth 019","E02003140",6269,4152,3263,3241,22,9,880,842,38,2117,1177,42,88,387,423
"2021","Plymouth 020","E02003141",6482,3382,2088,2048,40,0,1294,1194,100,3100,1934,74,171,658,263
"2021","Plymouth 021","E02003142",7414,4156,2777,2739,38,3,1376,1314,62,3258,1934,59,162,694,409
"2021","Plymouth 022","E02003143",5991,3793,2938,2924,14,9,846,822,24,2198,1128,38,146,487,399
"2021","Plymouth 023","E02003144",6874,2318,1125,1115,10,7,1186,1106,80,4556,3814,79,136,383,144
"2021","Plymouth 024","E02003145",5279,2885,2035,2006,29,6,844,802,42,2394,1507,36,128,436,287
"2021","Plymouth 025","E02003146",6930,3262,1851,1834,17,8,1403,1308,95,3668,2785,71,150,488,174
"2021","Plymouth 026","E02003147",7132,3358,1997,1961,36,7,1354,1268,86,3774,2435,77,214,790,258
"2021","Plymouth 027","E02003148",7438,2573,1274,1249,25,1,1298,1190,108,4865,3601,99,202,686,277
"2021","Plymouth 028","E02003149",7896,3310,1758,1732,26,2,1550,1458,92,4586,3383,94,182,666,261
"2021","Plymouth 030","E02003151",6842,4687,3937,3925,12,4,746,714,32,2155,1096,43,97,345,574
"2021","Plymouth 031","E02003152",9194,6035,4708,4677,31,5,1322,1260,62,3159,1764,73,155,580,587
"2021","Plymouth 032","E02003153",6081,3906,3113,3103,10,5,788,738,50,2175,1100,55,106,425,489
"2021","Plymouth 033","E02006989",4498,1778,1072,1050,22,0,706,640,66,2720,1823,53,139,527,178
"2021","Plymouth 034","E02006990",5752,2458,1402,1374,28,10,1046,966,80,3294,2020,84,168,718,304
"2021","Torbay 001","E02003154",5791,3254,2396,2372,24,4,854,812,42,2537,1494,43,113,476,411
"2021","Torbay 002","E02003155",4852,2672,2054,2036,18,4,614,568,46,2180,1139,57,99,485,400
"2021","Torbay 003","E02003156",8500,5435,4007,3963,44,17,1411,1360,51,3065,1834,63,135,627,406
"2021","Torbay 004","E02003157",5469,2760,1912,1884,28,8,840,810,30,2709,1608,60,141,622,278
"2021","Torbay 005","E02003158",4715,2470,1788,1768,20,2,680,652,28,2245,1195,45,93,504,408
"2021","Torbay 006","E02003159",4755,2467,1660,1634,26,7,800,764,36,2288,1378,37,128,503,242
"2021","Torbay 008","E02003161",6465,2786,1655,1585,70,7,1124,1040,84,3679,2283,108,193,779,316
"2021","Torbay 010","E02003163",7070,4058,3168,3080,88,14,876,800,76,3012,1429,90,143,730,620
"2021","Torbay 011","E02003164",7515,4748,3757,3719,38,3,988,938,50,2767,1436,74,122,537,598
"2021","Torbay 012","E02003165",5939,3740,2794,2768,26,8,938,898,40,2199,1256,47,97,427,372
"2021","Torbay 013","E02003166",10135,6000,4324,4288,36,10,1666,1600,66,4135,2527,73,193,801,541
"2021","Torbay 014","E02003167",8319,3975,2756,2716,40,0,1219,1154,65,4344,2271,131,221,1050,671
"2021","Torbay 015","E02003168",6095,3801,2947,2906,41,10,844,808,36,2294,1122,41,99,522,510
"2021","Torbay 016","E02003169",5799,3978,3370,3352,18,4,604,560,44,1821,872,40,59,318,532
"2021","Torbay 017","E02003170",8257,4992,3975,3939,36,3,1014,964,50,3265,1529,89,159,766,722
"2021","Torbay 018","E02003171",6205,3882,3030,2998,32,0,852,820,32,2323,1215,44,88,477,499
"2021","Torbay 019","E02006840",9132,5490,4196,4164,32,8,1286,1224,62,3642,2083,88,166,752,553
"2021","Swindon 001","E02003212",7032,4530,3622,3602,20,14,894,854,40,2502,1333,42,128,490,509
"2021","Swindon 003","E02003214",4993,2548,1668,1656,12,6,874,844,30,2445,1539,51,127,446,282
"2021","Swindon 004","E02003215",5733,3790,3038,3028,10,8,744,710,34,1943,1033,33,86,374,417
"2021","Swindon 005","E02003216",8238,5127,3928,3898,30,18,1181,1126,55,3111,1767,76,148,540,580
"2021","Swindon 006","E02003217",5770,3380,2442,2432,10,10,928,892,36,2390,1400,77,114,445,354
"2021","Swindon 007","E02003218",5145,2813,2095,2075,20,5,713,682,31,2332,1451,67,121,424,269
"2021","Swindon 008","E02003219",9860,7146,5367,5315,52,11,1768,1694,74,2714,1766,55,131,440,322
"2021","Swindon 009","E02003220",8550,5444,4342,4314,28,2,1100,1056,44,3106,1803,62,124,541,576
"2021","Swindon 010","E02003221",5888,3285,2519,2505,14,1,765,732,33,2603,1542,215,107,451,288
"2021","Swindon 011","E02003222",4852,3204,2458,2448,10,4,742,718,24,1648,1037,40,85,331,155
"2021","Swindon 012","E02003223",8788,5260,3706,3674,32,14,1540,1480,60,3528,2265,168,177,583,335
"2021","Swindon 013","E02003224",7236,4695,3688,3675,13,5,1002,970,32,2541,1345,56,105,480,555
"2021","Swindon 014","E02003225",5268,3354,2573,2558,15,3,778,746,32,1914,1215,54,104,345,196
"2021","Swindon 015","E02003226",8532,4447,3782,3771,11,13,652,596,56,4085,2521,678,173,416,297
"2021","Swindon 016","E02003227",5289,2540,1894,1888,6,8,638,608,30,2749,1770,112,121,500,246
"2021","Swindon 017","E02003228",6219,3837,3162,3140,22,4,671,640,31,2382,1488,186,96,309,303
"2021","Swindon 018","E02003229",4586,2952,2266,2256,10,4,682,662,20,1634,1026,46,70,319,173
"2021","Swindon 019","E02003230",7105,3787,2502,2488,14,5,1280,1194,86,3318,2114,301,148,543,212
"2021","Swindon 020","E02003231",6523,3407,2605,2590,15,8,794,758,36,3116,1927,136,168,511,374
"2021","Swindon 021","E02003232",6851,4250,3189,3175,14,7,1054,1004,50,2601,1738,82,108,420,253
"2021","Swindon 022","E02003233",6997,4025,3080,3053,27,13,932,898,34,2972,1709,109,162,600,392
"2021","Swindon 023","E02003234",6961,4188,3270,3248,22,4,914,886,28,2773,1637,75,108,510,443
"2021","Swindon 024","E02003235",7607,4852,3815,3803,12,5,1032,984,48,2755,1620,80,104,453,498
"2021","Swindon 025","E02003236",10333,6826,5386,5364,22,16,1424,1364,60,3507,1969,77,161,653,647
"2021","Swindon 026","E02006847",7315,4926,3630,3609,21,8,1288,1228,60,2389,1623,44,146,430,146
"2021","Swindon 027","E02006848",6323,3914,2642,2618,24,8,1264,1210,54,2409,1549,101,180,451,128
"2021","Swindon 028","E02006849",7985,5568,4226,4206,20,16,1326,1278,48,2417,1577,69,122,423,226
"2021","Cornwall 010","E02003892",5741,3806,3024,2994,30,4,778,756,22,1935,983,34,96,443,379
"2021","Cornwall 012","E02003893",5657,3815,3031,3003,28,8,776,740,36,1842,995,45,85,335,382
"2021","Cornwall 013","E02003894",6939,4380,3352,3328,24,4,1024,982,42,2559,1375,50,114,530,490
"2021","Cornwall 016","E02003895",7658,4914,3582,3556,26,14,1318,1254,64,2744,1474,72,125,583,490
"2021","Cornwall 017","E02003896",4873,2710,1986,1962,24,1,723,694,29,2163,1185,36,132,458,352
"2021","Cornwall 022","E02003897",4502,3191,2610,2593,17,7,574,546,28,1311,705,27,80,268,231
"2021","Cornwall 023","E02003898",5792,3956,3290,3266,24,8,658,630,28,1836,968,44,71,355,398
"2021","Cornwall 025","E02003899",4333,2688,2098,2082,16,2,588,568,20,1645,830,25,89,368,333
"2021","Cornwall 026","E02003900",5798,3536,2749,2729,20,13,774,722,52,2262,1192,37,115,498,420
"2021","Cornwall 028","E02003901",7033,4567,3634,3615,19,7,926,884,42,2466,1275,66,112,480,533
"2021","Cornwall 029","E02003902",4325,2505,1905,1897,8,3,597,566,31,1820,952,25,99,435,309
"2021","Cornwall 034","E02003903",5274,3433,2763,2749,14,2,668,638,30,1841,938,44,95,394,370
"2021","Cornwall 037","E02003904",4415,2764,2176,2158,18,6,582,550,32,1651,795,63,88,390,315
"2021","Cornwall 032","E02003905",5762,3774,2892,2866,26,4,878,848,30,1988,1147,40,92,409,300
"2021","Cornwall 033","E02003906",5180,3264,2448,2432,16,6,810,778,32,1916,1049,44,106,359,358
"2021","Cornwall 040","E02003907",6892,4398,3334,3314,20,6,1058,1020,38,2494,1345,55,95,525,474
"2021","Cornwall 042","E02003908",6902,4040,3050,3014,36,8,982,926,56,2862,1666,54,102,558,482
"2021","Cornwall 043","E02003909",8538,5131,3704,3680,24,9,1418,1352,66,3407,2045,77,154,612,519
"2021","Cornwall 044","E02003910",5715,3144,2187,2139,48,5,952,898,54,2571,1426,53,116,535,441
"2021","Cornwall 047","E02003911",7684,5219,4225,4204,21,2,992,964,28,2465,1323,58,92,441,551
"2021","Cornwall 048","E02003912",6947,4446,3553,3539,14,3,890,856,34,2501,1313,66,102,494,526
"2021","Cornwall 056","E02003913",5103,3448,2898,2882,16,2,548,536,12,1655,863,51,51,312,378
"2021","Cornwall 060","E02003914",6825,3421,2230,2214,16,4,1187,1135,52,3404,2449,49,100,495,311
"2021","Cornwall 062","E02003915",6895,2947,1927,1909,18,3,1017,978,39,3948,2897,42,108,517,384
"2021","Cornwall 063","E02003916",5958,2622,1896,1872,24,2,724,674,50,3336,2471,49,74,376,366
"2021","Cornwall 064","E02003917",6865,4302,3232,3214,18,8,1062,1012,50,2563,1543,44,92,468,416
"2021","Cornwall 045","E02003918",6025,3904,2916,2900,16,6,982,942,40,2121,1124,41,76,448,432
"2021","Cornwall 046","E02003919",5978,3348,2300,2284,16,8,1040,996,44,2630,1462,61,137,590,380
"2021","Cornwall 049","E02003920",6686,4134,2827,2799,28,3,1304,1262,42,2552,1431,43,117,560,401
"2021","Cornwall 050","E02003921",5221,3310,2516,2482,34,0,794,772,22,1911,1027,37,74,409,364
"2021","Cornwall 051","E02003922",7262,4536,3185,3167,18,9,1342,1304,38,2726,1551,39,166,600,370
"2021","Cornwall 052","E02003923",7419,4308,2834,2818,16,6,1468,1400,68,3111,1912,53,137,639,370
"2021","Cornwall 053","E02003924",6117,3494,2619,2610,9,5,870,836,34,2623,1368,63,115,592,485
"2021","Cornwall 055","E02003925",5868,3553,2624,2590,34,6,923,899,24,2315,1370,34,92,446,373
"2021","Cornwall 059","E02003926",6927,4749,3700,3676,24,7,1042,990,52,2178,1269,52,96,382,379
"2021","Cornwall 066","E02003927",7934,5378,4197,4161,36,11,1170,1136,34,2556,1377,57,91,489,542
"2021","Cornwall 071","E02003928",9619,6098,4762,4730,32,10,1326,1284,42,3521,1887,68,179,824,563
"2021","Cornwall 072","E02003929",5890,3830,3009,2991,18,5,816,754,62,2060,1056,70,77,428,429
"2021","Cornwall 073","E02003930",7396,4802,3852,3822,30,4,946,914,32,2594,1396,63,91,504,540
"2021","Cornwall 001","E02003931",8687,5302,3992,3968,24,4,1306,1248,58,3385,1759,83,182,687,674
"2021","Cornwall 002","E02003932",6122,4316,3425,3391,34,9,882,858,24,1806,977,63,81,312,373
"2021","Cornwall 003","E02003933",5976,3882,3002,2978,24,8,872,844,28,2094,1053,59,88,453,441
"2021","Cornwall 004","E02003934",5922,3915,3089,3065,24,4,822,788,34,2007,1121,52,83,383,368
"2021","Cornwall 005","E02003935",8061,4917,3475,3429,46,10,1432,1382,50,3144,1823,65,188,630,438
"2021","Cornwall 006","E02003936",7009,4854,4004,3976,28,4,846,820,26,2155,1131,60,82,404,478
"2021","Cornwall 007","E02003937",4417,2836,2250,2238,12,0,586,568,18,1581,828,61,63,287,342
"2021","Cornwall 008","E02003938",5538,3603,2720,2698,22,6,877,848,29,1935,1055,69,100,383,328
"2021","Cornwall 009","E02003939",5700,3448,2628,2616,12,0,820,778,42,2252,1155,46,78,511,462
"2021","Cornwall 011","E02003940",5449,3660,2989,2976,13,12,659,648,11,1789,940,52,56,363,378
"2021","Cornwall 014","E02003941",7124,4436,3158,3140,18,4,1274,1228,46,2688,1641,43,119,468,417
"2021","Cornwall 015","E02003942",6332,3610,2381,2365,16,5,1224,1184,40,2722,1567,47,145,596,367
"2021","Cornwall 054","E02003943",5841,3332,2483,2453,30,5,844,814,30,2509,1322,69,107,569,442
"2021","Cornwall 057","E02003944",8418,5038,3704,3662,42,9,1325,1279,46,3380,1864,72,144,717,583
"2021","Cornwall 058","E02003945",5081,3238,2635,2607,28,3,600,576,24,1843,975,34,83,395,356
"2021","Cornwall 061","E02003946",7784,5034,3870,3822,48,14,1150,1102,48,2750,1466,84,100,595,505
"2021","Cornwall 065","E02003947",5478,3486,2748,2694,54,4,734,682,52,1992,1099,53,78,399,363
"2021","Cornwall 067","E02003948",6919,3769,2759,2740,19,6,1004,958,46,3150,1768,41,113,767,461
"2021","Cornwall 068","E02003949",5628,2430,1595,1565,30,1,834,794,40,3198,1724,50,151,836,437
"2021","Cornwall 069","E02003950",4578,2778,2188,2158,30,0,590,580,10,1800,982,36,62,419,301
"2021","Cornwall 070","E02003951",4977,2843,2202,2178,24,2,639,608,31,2134,1085,48,88,483,430
"2021","Cornwall 018","E02003952",7744,4868,3419,3393,26,11,1438,1378,60,2876,1672,78,123,582,421
"2021","Cornwall 019","E02003953",8721,5647,4160,4108,52,3,1484,1430,54,3074,1744,61,155,589,525
"2021","Cornwall 020","E02003954",6412,3538,2364,2350,14,10,1164,1114,50,2874,1789,58,118,576,333
"2021","Cornwall 021","E02003955",8315,4865,3543,3528,15,12,1310,1258,52,3450,2102,70,137,649,492
"2021","Cornwall 024","E02003956",6314,3986,2935,2923,12,5,1046,996,50,2328,1351,49,108,432,388
"2021","Cornwall 027","E02003957",9044,5854,4178,4128,50,12,1664,1610,54,3190,1786,54,161,681,508
"2021","Cornwall 030","E02003958",6700,4248,3194,3172,22,4,1050,994,56,2452,1399,41,103,478,431
"2021","Cornwall 031","E02003959",5594,3378,2453,2435,18,11,914,878,36,2216,1217,35,108,483,373
"2021","Cornwall 035","E02003960",4893,3110,2482,2464,18,2,626,606,20,1783,924,42,73,377,367
"2021","Cornwall 036","E02003961",7998,5212,4108,4094,14,2,1102,1058,44,2786,1535,67,100,524,560
"2021","Cornwall 038","E02003962",5911,3590,2636,2612,24,2,952,892,60,2321,1359,40,110,483,329
"2021","Cornwall 039","E02003963",8090,4460,3156,3134,22,4,1300,1184,116,3630,2015,62,173,761,619
"2021","Cornwall 041","E02003964",6905,4528,3705,3681,24,7,816,786,30,2377,1161,56,110,473,577
"2021","Isles of Scilly 001","E02006781",1705,1151,889,889,0,2,260,260,0,554,282,29,28,93,122
"2021","Wiltshire 012","E02006634",7073,4780,4047,4027,20,11,722,696,26,2293,1277,59,104,421,432
"2021","Wiltshire 019","E02006635",6641,3956,3166,3158,8,2,788,768,20,2685,1399,85,127,556,518
"2021","Wiltshire 024","E02006636",5948,3830,3116,3096,20,10,704,688,16,2118,1094,56,95,443,430
"2021","Wiltshire 025","E02006637",8959,5631,4111,4079,32,8,1512,1460,52,3328,1909,52,163,685,519
"2021","Wiltshire 026","E02006638",5490,3150,2484,2472,12,6,660,634,26,2340,1199,38,103,501,499
"2021","Wiltshire 028","E02006639",6842,4635,3834,3810,24,4,797,765,32,2207,1210,54,104,398,441
"2021","Wiltshire 029","E02006640",6073,4209,3516,3508,8,10,683,660,23,1864,1046,43,87,356,332
"2021","Wiltshire 034","E02006641",6526,4334,3504,3482,22,6,824,800,24,2192,1222,56,115,451,348
"2021","Wiltshire 038","E02006642",4712,3248,2682,2660,22,4,562,550,12,1464,787,25,88,311,253
"2021","Wiltshire 001","E02006644",5702,3824,3161,3145,16,5,658,636,22,1878,1009,38,72,382,377
"2021","Wiltshire 002","E02006645",6313,3972,3133,3117,16,5,834,810,24,2341,1357,60,117,445,362
"2021","Wiltshire 003","E02006646",6415,4504,3569,3543,26,5,930,898,32,1911,1089,53,109,326,334
"2021","Wiltshire 004","E02006647",5098,3739,3158,3150,8,2,579,552,27,1359,794,51,54,212,248
"2021","Wiltshire 005","E02006648",5093,3556,3004,2988,16,6,546,524,22,1537,843,42,72,263,317
"2021","Wiltshire 006","E02006649",6252,3782,2924,2914,10,6,852,816,36,2470,1383,42,160,499,386
"2021","Wiltshire 007","E02006650",9713,6770,5642,5606,36,14,1114,1078,36,2943,1640,80,151,541,531
"2021","Wiltshire 008","E02006651",5900,4166,3475,3459,16,3,688,668,20,1734,935,66,81,301,351
"2021","Wiltshire 009","E02006652",7841,5013,3860,3839,21,7,1146,1114,32,2828,1828,37,142,486,335
"2021","Wiltshire 010","E02006653",8074,5156,4019,3993,26,3,1134,1104,30,2918,1784,59,125,552,398
"2021","Wiltshire 011","E02006654",7920,4414,3270,3242,28,11,1133,1078,55,3506,1943,112,180,701,570
"2021","Wiltshire 013","E02006655",6715,4794,3804,3770,34,2,988,952,36,1921,1117,48,81,334,341
"2021","Wiltshire 014","E02006656",5578,3615,2833,2815,18,9,773,745,28,1963,1246,20,91,416,190
"2021","Wiltshire 015","E02006657",8561,5374,3944,3906,38,10,1420,1370,50,3187,1914,54,145,665,409
"2021","Wiltshire 016","E02006658",6613,4352,3342,3310,32,4,1006,970,36,2261,1245,33,94,524,365
"2021","Wiltshire 017","E02006659",6505,4506,3587,3565,22,7,912,874,38,1999,1119,74,93,378,335
"2021","Wiltshire 018","E02006660",10822,6886,5491,5449,42,7,1388,1320,68,3936,2161,87,181,840,667
"2021","Wiltshire 045","E02006661",6288,4766,4044,4008,36,14,708,672,36,1522,888,64,105,266,199
"2021","Wiltshire 046","E02006662",5722,3894,3177,3161,16,11,706,688,18,1828,1018,38,130,368,274
"2021","Wiltshire 048","E02006663",10262,6508,4918,4898,20,14,1576,1516,60,3754,2158,76,233,711,576
"2021","Wiltshire 049","E02006664",5367,3747,3163,3151,12,1,583,560,23,1620,880,38,70,291,341
"2021","Wiltshire 050","E02006665",5741,3822,3056,3042,14,0,766,746,20,1919,977,65,86,370,421
"2021","Wiltshire 051","E02006666",5363,3372,2637,2621,16,7,728,710,18,1991,1181,40,87,384,299
"2021","Wiltshire 052","E02006667",5756,3397,2297,2290,7,4,1096,1062,34,2359,1481,46,161,447,224
"2021","Wiltshire 053","E02006668",4919,3070,2591,2574,17,12,467,453,14,1849,1036,34,84,331,364
"2021","Wiltshire 054","E02006669",8786,5767,4623,4583,40,7,1137,1094,43,3019,1584,65,156,598,616
"2021","Wiltshire 055","E02006670",5717,3231,2244,2220,24,1,986,948,38,2486,1452,72,117,550,295
"2021","Wiltshire 056","E02006671",5086,2758,1944,1924,20,2,812,766,46,2328,1284,62,110,521,351
"2021","Wiltshire 057","E02006672",7279,4808,3826,3796,30,6,976,930,46,2471,1472,64,152,412,371
"2021","Wiltshire 058","E02006673",4328,2408,1848,1834,14,2,558,534,24,1920,987,65,76,368,424
"2021","Wiltshire 059","E02006674",4723,2852,2276,2262,14,8,568,540,28,1871,1100,50,82,390,249
"2021","Wiltshire 060","E02006675",6799,4835,4084,4068,16,4,747,706,41,1964,1145,32,64,310,413
"2021","Wiltshire 061","E02006676",5202,3440,2851,2829,22,7,582,560,22,1762,890,53,112,333,374
"2021","Wiltshire 062","E02006677",6604,4523,3804,3788,16,4,715,696,19,2081,1145,49,82,365,440
"2021","Wiltshire 020","E02006678",6326,3924,2909,2895,14,3,1012,984,28,2402,1423,49,110,456,364
"2021","Wiltshire 021","E02006679",9919,6849,5421,5393,28,13,1415,1376,39,3070,1792,55,139,585,499
"2021","Wiltshire 022","E02006680",6249,3664,2782,2766,16,5,877,844,33,2585,1359,53,111,549,513
"2021","Wiltshire 023","E02006681",4918,3360,2874,2850,24,4,482,464,18,1558,793,46,48,314,357
"2021","Wiltshire 027","E02006682",8582,5438,4382,4344,38,10,1046,990,56,3144,1646,56,134,676,632
"2021","Wiltshire 030","E02006683",6499,4254,3382,3362,20,8,864,842,22,2245,1331,37,94,446,337
"2021","Wiltshire 031","E02006684",5666,3092,2087,2061,26,7,998,944,54,2574,1536,74,128,495,341
"2021","Wiltshire 032","E02006685",7938,5114,3904,3892,12,10,1200,1156,44,2824,1639,80,138,543,424
"2021","Wiltshire 033","E02006686",4414,2648,2060,2050,10,6,582,560,22,1766,1102,30,81,265,288
"2021","Wiltshire 035","E02006687",6541,3986,2834,2816,18,8,1144,1088,56,2555,1558,60,120,532,285
"2021","Wiltshire 036","E02006688",4664,2733,1978,1968,10,5,750,716,34,1931,1117,32,100,394,288
"2021","Wiltshire 037","E02006689",5742,3936,3169,3161,8,5,762,744,18,1806,993,44,76,321,372
"2021","Wiltshire 039","E02006690",5910,4014,3167,3155,12,9,838,804,34,1896,1042,35,89,357,373
"2021","Wiltshire 042","E02006692",4275,2781,2229,2215,14,4,548,524,24,1494,795,24,81,302,292
"2021","Wiltshire 043","E02006693",5406,3368,2537,2531,6,5,826,812,14,2038,1150,28,97,408,355
"2021","Wiltshire 044","E02006694",5112,2976,2280,2268,12,6,690,650,40,2136,1081,44,109,490,412
"2021","Wiltshire 047","E02006695",5383,3718,3099,3079,20,11,608,594,14,1665,842,50,70,320,383
"2021","Wiltshire 063","E02007023",6123,3967,2849,2831,18,6,1112,1084,28,2156,1326,33,126,398,273
"2021","Wiltshire 064","E02007024",5659,3406,2430,2400,30,0,976,936,40,2253,1301,27,104,490,331
"2021","Wiltshire 065","E02007025",6070,3978,3081,3053,28,3,894,822,72,2092,1256,49,148,396,243
"2021","Wiltshire 066","E02007026",5351,3872,3224,3200,24,10,638,600,38,1479,946,53,118,273,89
"2021","Bournemouth, Christchurch and Poole 003","E02003172",5324,3074,2244,2224,20,4,826,780,46,2250,1296,53,103,398,400
"2021","Bournemouth, Christchurch and Poole 005","E02003173",5705,3440,2517,2495,22,3,920,876,44,2265,1231,44,80,475,435
"2021","Bournemouth, Christchurch and Poole 006","E02003174",6910,4350,3470,3439,31,3,877,845,32,2560,1420,50,103,488,499
"2021","Bournemouth, Christchurch and Poole 007","E02003175",7273,4556,3453,3437,16,5,1098,1064,34,2717,1573,38,128,578,400
"2021","Bournemouth, Christchurch and Poole 010","E02003176",5852,2932,2032,2022,10,4,896,864,32,2920,1850,47,121,575,327
"2021","Bournemouth, Christchurch and Poole 009","E02003177",6625,4284,3407,3369,38,15,862,812,50,2341,1471,52,93,407,318
"2021","Bournemouth, Christchurch and Poole 011","E02003178",7066,3798,2862,2826,36,6,930,890,40,3268,2120,47,119,589,393
"2021","Bournemouth, Christchurch and Poole 012","E02003179",5219,2888,2241,2221,20,3,644,606,38,2331,1315,45,106,493,372
"2021","Bournemouth, Christchurch and Poole 015","E02003180",8387,3374,2313,2285,28,7,1054,996,58,5013,3994,81,154,539,245
"2021","Bournemouth, Christchurch and Poole 017","E02003181",7097,4060,3143,3079,64,13,904,856,48,3037,2104,63,114,460,296
"2021","Bournemouth, Christchurch and Poole 020","E02003182",5280,3436,2814,2782,32,2,620,596,24,1844,1095,64,62,343,280
"2021","Bournemouth, Christchurch and Poole 028","E02003183",6183,3244,2519,2487,32,3,722,664,58,2939,2209,79,73,311,267
"2021","Bournemouth, Christchurch and Poole 027","E02003184",6661,3071,1955,1918,37,8,1108,1022,86,3590,2705,101,111,504,169
"2021","Bournemouth, Christchurch and Poole 026","E02003185",6091,3740,2838,2800,38,12,890,834,56,2351,1439,37,101,471,303
"2021","Bournemouth, Christchurch and Poole 025","E02003186",7546,3663,2389,2346,43,14,1260,1178,82,3883,2786,114,160,631,192
"2021","Bournemouth, Christchurch and Poole 035","E02003187",7679,3923,2693,2669,24,9,1221,1156,65,3756,2473,87,154,687,355
"2021","Bournemouth, Christchurch and Poole 038","E02003188",9501,4462,2451,2373,78,5,2006,1832,174,5039,3372,155,227,879,406
"2021","Bournemouth, Christchurch and Poole 036","E02003189",7086,3822,2813,2745,68,9,1000,938,62,3264,1857,57,159,724,467
"2021","Bournemouth, Christchurch and Poole 037","E02003190",8584,3778,2085,2039,46,13,1680,1586,94,4806,3156,141,234,1008,267
"2021","Bournemouth, Christchurch and Poole 039","E02003191",7097,4480,3598,3548,50,6,876,832,44,2617,1295,61,113,554,594
"2021","Bournemouth, Christchurch and Poole 041","E02003192",8871,4246,2584,2532,52,10,1652,1534,118,4625,3125,155,206,774,365
"2021","Bournemouth, Christchurch and Poole 001","E02003194",4953,3488,3024,3014,10,2,462,444,18,1465,770,34,44,234,383
"2021","Bournemouth, Christchurch and Poole 008","E02003195",4744,3128,2338,2326,12,2,788,762,26,1616,1030,27,71,269,219
"2021","Bournemouth, Christchurch and Poole 004","E02003196",8696,5998,5301,5265,36,7,690,662,28,2698,1468,50,93,397,690
"2021","Bournemouth, Christchurch and Poole 013","E02003197",5547,3490,2739,2731,8,3,748,726,22,2057,1197,37,86,449,288
"2021","Bournemouth, Christchurch and Poole 016","E02003198",5994,3786,2788,2770,18,12,986,960,26,2208,1368,34,87,435,284
"2021","Bournemouth, Christchurch and Poole 021","E02003199",7767,4936,3645,3611,34,5,1286,1248,38,2831,1592,55,104,586,494
"2021","Bournemouth, Christchurch and Poole 022","E02003200",8328,4798,3392,3354,38,8,1398,1330,68,3530,2131,78,152,651,518
"2021","Bournemouth, Christchurch and Poole 023","E02003201",9026,5174,3696,3632,64,8,1470,1370,100,3852,2348,95,168,758,483
"2021","Bournemouth, Christchurch and Poole 029","E02003202",4975,2913,2167,2125,42,7,739,686,53,2062,1241,69,67,419,266
"2021","Bournemouth, Christchurch and Poole 032","E02003203",6200,3839,2681,2626,55,6,1152,1090,62,2361,1416,48,100,506,291
"2021","Bournemouth, Christchurch and Poole 030","E02003204",7587,4482,3304,3272,32,6,1172,1122,50,3105,1786,57,139,644,479
"2021","Bournemouth, Christchurch and Poole 034","E02003205",6950,4474,3591,3579,12,3,880,846,34,2476,1460,48,91,433,444
"2021","Bournemouth, Christchurch and Poole 043","E02003206",8153,5130,3890,3830,60,10,1230,1166,64,3023,1816,77,126,648,356
"2021","Bournemouth, Christchurch and Poole 042","E02003207",5747,3470,2512,2494,18,8,950,916,34,2277,1371,40,114,457,295
"2021","Bournemouth, Christchurch and Poole 044","E02003208",9337,4690,3260,3222,38,8,1422,1328,94,4647,2569,137,201,1007,733
"2021","Bournemouth, Christchurch and Poole 046","E02003209",5572,3343,2430,2411,19,7,906,878,28,2229,1241,40,90,493,365
"2021","Bournemouth, Christchurch and Poole 047","E02003210",8103,5008,3924,3892,32,4,1080,1020,60,3095,1621,62,131,664,617
"2021","Bournemouth, Christchurch and Poole 048","E02003211",7426,4672,3946,3856,90,0,726,678,48,2754,1210,115,117,544,768
"2021","Bournemouth, Christchurch and Poole 002","E02004236",5272,3466,2830,2810,20,10,626,604,22,1806,952,39,74,367,374
"2021","Bournemouth, Christchurch and Poole 014","E02004237",6539,4068,3364,3344,20,8,696,676,20,2471,1433,35,108,422,473
"2021","Bournemouth, Christchurch and Poole 019","E02004238",6628,4230,3621,3590,31,7,602,574,28,2398,1002,68,80,463,785
"2021","Bournemouth, Christchurch and Poole 018","E02004239",5318,3572,2967,2949,18,5,600,574,26,1746,863,28,52,350,453
"2021","Bournemouth, Christchurch and Poole 024","E02004240",4913,2597,1853,1837,16,9,735,705,30,2316,1393,27,116,481,299
"2021","Bournemouth, Christchurch and Poole 031","E02004241",7745,4373,3275,3249,26,7,1091,1043,48,3372,1670,60,148,840,654
"2021","Bournemouth, Christchurch and Poole 033","E02004242",5670,3776,3230,3208,22,4,542,514,28,1894,848,51,81,406,508
"2021","Bournemouth, Christchurch and Poole 040","E02006883",5031,2420,1461,1395,66,5,954,876,78,2611,1551,61,103,541,355
"2021","Bournemouth, Christchurch and Poole 045","E02006885",6375,3340,2133,2055,78,1,1206,1078,128,3035,1855,91,136,542,411
"2021","Dorset 007","E02004243",5387,3736,3062,3054,8,6,668,650,18,1651,905,43,90,313,300
"2021","Dorset 010","E02004244",6415,4430,3592,3578,14,8,830,796,34,1985,1051,50,85,362,437
"2021","Dorset 012","E02004245",6157,4236,3361,3345,16,7,868,836,32,1921,1079,44,80,328,390
"2021","Dorset 015","E02004246",6826,4911,4213,4188,25,8,690,670,20,1915,949,54,76,309,527
"2021","Dorset 013","E02004247",5104,3578,3006,2997,9,6,566,542,24,1526,853,46,79,260,288
"2021","Dorset 016","E02004248",6537,4346,3656,3634,22,3,687,660,27,2191,961,52,71,434,673
"2021","Dorset 017","E02004249",4993,3508,2957,2947,10,1,550,534,16,1485,835,35,50,285,280
"2021","Dorset 018","E02004250",6630,4040,3369,3341,28,7,664,644,20,2590,1198,73,108,537,674
"2021","Dorset 020","E02004251",5327,3610,2934,2918,16,8,668,650,18,1717,852,38,60,332,435
"2021","Dorset 021","E02004252",6580,3636,2761,2743,18,5,870,852,18,2944,1463,58,193,688,542
"2021","Dorset 024","E02004253",8370,5788,4917,4893,24,9,862,818,44,2582,1278,57,65,463,719
"2021","Dorset 025","E02004254",8596,5689,4666,4652,14,10,1013,978,35,2907,1601,45,112,554,595
"2021","Dorset 001","E02004255",6129,3734,2916,2890,26,6,812,778,34,2395,1182,38,141,507,527
"2021","Dorset 002","E02004256",7632,5269,4240,4220,20,7,1022,994,28,2363,1270,64,127,449,453
"2021","Dorset 003","E02004257",7410,4488,3214,3178,36,6,1268,1226,42,2922,1604,67,140,634,477
"2021","Dorset 005","E02004258",8834,5798,4703,4689,14,1,1094,1050,44,3036,1482,73,130,602,749
"2021","Dorset 006","E02004259",5521,3840,3253,3227,26,11,576,556,20,1681,861,50,106,284,380
"2021","Dorset 009","E02004260",6357,4522,3661,3637,24,5,856,832,24,1835,987,67,79,378,324
"2021","Dorset 011","E02004261",8376,5138,3867,3840,27,5,1266,1224,42,3238,1716,53,170,724,575
"2021","Dorset 014","E02004262",6695,4752,3833,3797,36,7,912,892,20,1943,1077,47,106,349,364
"2021","Dorset 027","E02004263",4840,3236,2645,2629,16,3,588,560,28,1604,848,23,89,331,313
"2021","Dorset 028","E02004264",7122,4630,3571,3555,16,5,1054,1026,28,2492,1371,56,106,481,478
"2021","Dorset 033","E02004265",7148,4444,3556,3544,12,10,878,860,18,2704,1425,44,120,534,581
"2021","Dorset 035","E02004266",6504,4334,3471,3451,20,9,854,828,26,2170,1206,55,103,418,388
"2021","Dorset 039","E02004267",4389,2979,2497,2469,28,3,479,452,27,1410,753,50,62,222,323
"2021","Dorset 042","E02004268",8078,4969,4040,4008,32,12,917,899,18,3109,1533,84,136,691,665
"2021","Dorset 004","E02004269",7882,4520,3532,3494,38,8,980,924,56,3362,1577,96,154,789,746
"2021","Dorset 008","E02004270",6620,4685,3949,3919,30,0,736,704,32,1935,994,52,85,354,450
"2021","Dorset 019","E02004271",8627,5844,4736,4692,44,10,1098,1058,40,2783,1392,73,143,550,625
"2021","Dorset 022","E02004272",10152,6939,5634,5586,48,4,1301,1236,65,3213,1650,78,137,647,701
"2021","Dorset 023","E02004273",6222,4022,3374,3346,28,8,640,622,18,2200,1041,61,115,464,519
"2021","Dorset 026","E02004274",5461,3260,2498,2486,12,4,758,722,36,2201,1119,43,95,487,457
"2021","Dorset 029","E02004275",6627,4457,3696,3653,43,5,756,730,26,2170,1133,49,102,407,479
"2021","Dorset 030","E02004276",4835,2859,2252,2231,21,5,602,588,14,1976,981,47,87,465,396
"2021","Dorset 034","E02004278",7326,4566,3678,3654,24,6,882,846,36,2760,1445,54,134,569,558
"2021","Dorset 036","E02004279",6774,4656,3802,3788,14,4,850,822,28,2118,1090,49,101,408,470
"2021","Dorset 037","E02004280",7049,4604,3618,3598,20,10,976,950,26,2445,1256,60,98,506,525
"2021","Dorset 038","E02004281",6244,3638,2511,2487,24,2,1125,1080,45,2606,1487,23,127,614,355
"2021","Dorset 040","E02004282",7716,5241,4407,4379,28,4,830,792,38,2475,1192,50,97,471,665
"2021","Dorset 041","E02004283",7461,4691,3635,3617,18,7,1049,1004,45,2770,1497,51,105,520,597
"2021","Dorset 044","E02004284",8193,3912,2584,2572,12,8,1320,1254,66,4281,2278,168,222,996,617
"2021","Dorset 043","E02004285",6463,3640,2578,2564,14,2,1060,996,64,2823,1519,63,122,640,479
"2021","Dorset 045","E02004286",4171,2609,2012,1998,14,0,597,571,26,1562,918,23,74,301,246
"2021","Dorset 046","E02004287",4652,2918,2114,2098,16,4,800,692,108,1734,935,26,83,378,312
"2021","Dorset 047","E02004288",4277,2333,1679,1659,20,1,653,632,21,1944,1084,37,103,464,256
"2021","Dorset 048","E02004289",6122,3871,2967,2948,19,6,898,870,28,2251,1170,38,97,523,423
"2021","Dorset 031","E02007006",4849,2595,1875,1849,26,2,718,680,38,2254,1083,70,107,503,491
"2021","Dorset 032","E02007007",5503,3258,2622,2604,18,6,630,604,26,2245,1299,50,120,415,361
"2021","East Devon 001","E02004129",5069,3554,2844,2820,24,7,703,678,25,1515,825,47,66,286,291
"2021","East Devon 002","E02004130",5200,2975,2151,2132,19,4,820,788,32,2225,1090,64,112,482,477
"2021","East Devon 003","E02004131",4595,2999,2343,2328,15,2,654,644,10,1596,851,45,76,310,314
"2021","East Devon 004","E02004132",7386,5185,4209,4187,22,0,976,946,30,2201,1240,51,111,373,426
"2021","East Devon 005","E02004133",8138,5160,3958,3938,20,6,1196,1154,42,2978,1584,56,153,616,569
"2021","East Devon 007","E02004135",7171,4880,4118,4100,18,4,758,736,22,2291,1184,65,87,400,555
"2021","East Devon 008","E02004136",7706,5160,4214,4194,20,12,934,894,40,2546,1375,42,110,479,540
"2021","East Devon 009","E02004137",4663,3174,2642,2624,18,4,528,512,16,1489,723,36,62,279,389
"2021","East Devon 010","E02004138",6669,4164,3370,3338,32,4,790,760,30,2505,1074,66,112,594,659
"2021","East Devon 011","E02004139",5958,3710,3044,3024,20,4,662,624,38,2248,1132,50,88,459,519
"2021","East Devon 012","E02004140",4689,2902,2462,2436,26,0,440,404,36,1787,655,71,81,365,615
"2021","East Devon 013","E02004141",5155,3495,2790,2778,12,3,702,676,26,1660,890,33,72,300,365
"2021","East Devon 014","E02004142",4700,3364,2781,2757,24,5,578,552,26,1336,704,39,66,271,256
"2021","East Devon 015","E02004143",5300,3600,3028,3026,2,2,570,546,24,1700,877,32,66,332,393
"2021","East Devon 016","E02004144",5768,3796,3032,3014,18,8,756,736,20,1972,992,41,96,405,438
"2021","East Devon 017","E02004145",5342,3506,2980,2968,12,4,522,498,24,1836,813,44,64,383,532
"2021","East Devon 018","E02004146",6130,3816,2915,2903,12,9,892,864,28,2314,1332,38,115,479,350
"2021","East Devon 019","E02004147",5895,3122,2015,2003,12,5,1102,1052,50,2773,1543,77,155,701,297
"2021","East Devon 020","E02004148",6483,3967,3174,3149,25,1,792,758,34,2516,1146,74,119,521,656
"2021","East Devon 021","E02007027",8665,5806,4308,4286,22,12,1486,1406,80,2859,1771,71,130,492,395
"2021","East Devon 022","E02007028",4271,3036,1805,1779,26,3,1228,1158,70,1235,849,32,86,226,42
"2021","Exeter 001","E02004149",5426,3221,2612,2604,8,5,604,576,28,2205,1511,57,57,300,280
"2021","Exeter 002","E02004150",5870,2730,1894,1882,12,10,826,776,50,3140,2372,42,107,403,216
"2021","Exeter 003","E02004151",7976,5070,3830,3798,32,8,1232,1190,42,2906,1829,59,118,437,463
"2021","Exeter 004","E02004152",7894,1880,1123,1107,16,3,754,710,44,6014,5450,61,64,307,132
"2021","Exeter 005","E02004153",6035,3523,2387,2373,14,12,1124,1060,64,2512,1595,55,121,486,255
"2021","Exeter 006","E02004154",6810,3030,2057,2037,20,7,966,902,64,3780,2941,73,84,418,264
"2021","Exeter 007","E02004155",6041,3522,2621,2610,11,2,899,851,48,2519,1511,40,112,464,392
"2021","Exeter 008","E02004156",8225,2932,1509,1479,30,1,1422,1314,108,5293,4052,87,140,698,316
"2021","Exeter 009","E02004157",5204,2873,2071,2036,35,2,800,744,56,2331,1514,54,100,436,227
"2021","Exeter 010","E02004158",6667,3630,2384,2358,26,10,1236,1168,68,3037,1932,60,141,582,322
"2021","Exeter 011","E02004159",10231,6648,4976,4950,26,6,1666,1572,94,3583,2336,73,170,588,416
"2021","Exeter 012","E02004160",5886,3698,2880,2848,32,0,818,780,38,2188,1265,45,76,415,387
"2021","Exeter 013","E02004161",6692,3677,2637,2616,21,2,1038,994,44,3015,1890,77,131,508,409
"2021","Exeter 014","E02004162",5774,3330,2279,2251,28,5,1046,990,56,2444,1489,36,107,468,344
"2021","Exeter 015","E02004163",6856,4202,3225,3193,32,3,974,934,40,2654,1398,63,93,577,523
"2021","Mid Devon 001","E02004164",5692,3984,3281,3255,26,7,696,678,18,1708,920,35,77,291,385
"2021","Mid Devon 002","E02004165",7414,5101,3936,3908,28,6,1159,1125,34,2313,1260,48,117,396,492
"2021","Mid Devon 003","E02004166",5518,3678,2924,2908,16,4,750,732,18,1840,1043,36,95,322,344
"2021","Mid Devon 004","E02004167",5517,3164,2174,2158,16,2,988,936,52,2353,1368,38,128,473,346
"2021","Mid Devon 005","E02004168",5095,2810,2034,2006,28,4,772,746,26,2285,1293,50,128,459,355
"2021","Mid Devon 006","E02004169",6188,4143,3288,3275,13,7,848,824,24,2045,1154,47,100,368,376
"2021","Mid Devon 007","E02004170",7060,4422,3263,3241,22,13,1146,1108,38,2638,1453,54,164,557,410
"2021","Mid Devon 008","E02004171",6965,4656,3655,3631,24,9,992,948,44,2309,1304,55,103,439,408
"2021","Mid Devon 009","E02004172",5428,3712,3025,3001,24,7,680,660,20,1716,988,43,90,284,311
"2021","Mid Devon 010","E02004173",6167,4182,3352,3322,30,2,828,802,26,1985,1093,68,103,340,381
"2021","Mid Devon 011","E02004174",6560,3902,2842,2808,34,2,1058,1024,34,2658,1488,57,152,510,451
"2021","North Devon 001","E02004175",4223,2234,1546,1528,18,4,684,666,18,1989,1125,31,91,466,276
"2021","North Devon 002","E02004176",4690,3078,2488,2456,32,2,588,576,12,1612,817,45,71,321,358
"2021","North Devon 003","E02004177",4829,2778,2051,2035,16,5,722,694,28,2051,1189,40,92,425,305
"2021","North Devon 004","E02004178",4345,2970,2489,2471,18,3,478,460,18,1375,781,43,56,230,265
"2021","North Devon 005","E02004179",7172,4648,3686,3672,14,6,956,906,50,2524,1294,47,128,516,539
"2021","North Devon 006","E02004180",5335,3705,2999,2991,8,6,700,686,14,1630,931,43,68,271,317
"2021","North Devon 007","E02004181",4676,2774,2071,2064,7,0,703,678,25,1902,1024,41,88,393,356
"2021","North Devon 008","E02004182",5144,2590,1767,1763,4,7,816,788,28,2554,1472,45,147,546,344
"2021","North Devon 009","E02004183",4950,3012,2369,2353,16,7,636,602,34,1938,1044,41,83,360,410
"2021","North Devon 010","E02004184",6753,4018,2867,2852,15,3,1148,1110,38,2735,1652,52,150,525,356
"2021","North Devon 011","E02004185",5640,3892,3198,3178,20,4,690,664,26,1748,847,43,103,292,463
"2021","North Devon 012","E02004186",8287,5504,4095,4069,26,5,1404,1352,52,2783,1511,41,142,538,551
"2021","North Devon 013","E02004187",8708,5662,4379,4353,26,5,1278,1232,46,3046,1676,69,164,555,582
"2021","North Devon 014","E02004188",5990,4055,3181,3159,22,4,870,836,34,1935,1001,51,79,367,437
"2021","South Hams 001","E02004189",5015,3370,2625,2591,34,3,742,704,38,1645,953,24,95,341,232
"2021","South Hams 002","E02004190",7251,4848,3879,3829,50,5,964,938,26,2403,1308,55,108,502,430
"2021","South Hams 003","E02004191",7604,4091,2996,2954,42,4,1091,1040,51,3513,1989,70,145,802,507
"2021","South Hams 004","E02004192",6634,4582,3792,3750,42,6,784,754,30,2052,1040,56,68,420,468
"2021","South Hams 005","E02004193",9649,6386,5036,5022,14,8,1342,1308,34,3263,1823,41,146,670,583
"2021","South Hams 006","E02004194",5996,3854,3067,3047,20,1,786,754,32,2142,1215,60,106,436,325
"2021","South Hams 007","E02004195",4411,2679,2067,2044,23,3,609,595,14,1732,872,46,95,380,339
"2021","South Hams 008","E02004196",6679,4596,3802,3770,32,0,794,768,26,2083,1042,70,94,447,430
"2021","South Hams 009","E02004197",6109,4240,3510,3496,14,0,730,696,34,1869,953,63,79,383,391
"2021","South Hams 010","E02004198",5251,3138,2375,2355,20,5,758,736,22,2113,1062,40,103,480,428
"2021","South Hams 011","E02004199",5005,3460,2854,2834,20,0,606,584,22,1545,749,48,77,295,376
"2021","South Hams 012","E02004200",4464,2927,2349,2341,8,4,574,560,14,1537,730,46,84,341,336
"2021","Teignbridge 001","E02004201",4665,3228,2606,2598,8,4,618,588,30,1437,726,42,59,286,324
"2021","Teignbridge 002","E02004202",7104,4683,3557,3519,38,6,1120,1088,32,2421,1278,39,121,525,458
"2021","Teignbridge 003","E02004203",4904,3354,2671,2649,22,5,678,646,32,1550,810,46,58,319,317
"2021","Teignbridge 004","E02004204",8150,5284,4179,4159,20,3,1102,1060,42,2866,1433,54,160,638,581
"2021","Teignbridge 005","E02004205",7102,4514,3524,3492,32,6,984,940,44,2588,1434,63,128,523,440
"2021","Teignbridge 006","E02004206",5781,3408,2676,2644,32,4,728,699,29,2373,1113,46,142,545,527
"2021","Teignbridge 007","E02004207",5612,3743,2839,2814,25,10,894,880,14,1869,995,39,86,388,361
"2021","Teignbridge 008","E02004208",7026,4672,3771,3743,28,7,894,868,26,2354,1235,56,96,471,496
"2021","Teignbridge 009","E02004209",7547,4768,3536,3520,16,2,1230,1178,52,2779,1543,44,120,591,481
"2021","Teignbridge 010","E02004210",5433,2750,1912,1874,38,4,834,788,46,2683,1359,67,167,642,448
"2021","Teignbridge 011","E02004211",5657,3825,3183,3171,12,5,637,606,31,1832,918,55,75,384,400
"2021","Teignbridge 012","E02004212",5040,3148,2358,2346,12,8,782,734,48,1892,1105,26,88,362,311
"2021","Teignbridge 013","E02004213",6618,4632,3266,3240,26,4,1362,1296,66,1986,1202,26,92,416,250
"2021","Teignbridge 014","E02004214",5003,2551,1609,1594,15,2,940,896,44,2452,1346,42,149,587,328
"2021","Teignbridge 015","E02004215",4755,2740,2028,2014,14,7,705,669,36,2015,1135,40,102,449,289
"2021","Teignbridge 016","E02004216",4697,3068,2364,2354,10,4,700,670,30,1629,883,34,58,301,353
"2021","Teignbridge 017","E02004217",6399,3742,2796,2780,16,8,938,916,22,2657,1443,64,130,586,434
"2021","Teignbridge 018","E02004218",5174,3366,2713,2697,16,7,646,626,20,1808,955,28,70,403,352
"2021","Teignbridge 019","E02004219",4725,3216,2651,2619,32,9,556,538,18,1509,793,34,58,289,335
"2021","Torridge 001","E02004220",5198,3182,2486,2472,14,2,694,656,38,2016,922,33,88,500,473
"2021","Torridge 002","E02004221",5464,3596,2967,2939,28,13,616,590,26,1868,881,40,86,395,466
"2021","Torridge 003","E02004222",4802,2633,1924,1914,10,2,707,665,42,2169,1173,44,111,514,327
"2021","Torridge 004","E02004223",10314,6272,4422,4386,36,12,1838,1776,62,4042,2252,64,239,890,597
"2021","Torridge 005","E02004224",5501,3836,3073,3047,26,5,758,734,24,1665,894,40,73,300,358
"2021","Torridge 006","E02004225",4673,2860,2090,2074,16,2,768,736,32,1813,989,35,94,341,354
"2021","Torridge 007","E02004226",6300,4359,3559,3539,20,11,789,757,32,1941,1009,43,92,366,431
"2021","Torridge 008","E02004227",8399,5548,4385,4351,34,5,1158,1128,30,2851,1552,61,149,516,573
"2021","Torridge 009","E02004228",6173,4290,3456,3428,28,4,830,792,38,1883,1013,61,96,298,415
"2021","West Devon 001","E02004229",8132,5478,4314,4284,30,18,1146,1094,52,2654,1522,74,141,468,449
"2021","West Devon 002","E02004230",6335,3713,2815,2804,11,6,892,854,38,2622,1385,56,147,561,473
"2021","West Devon 003","E02004231",5553,3744,2926,2900,26,8,810,782,28,1809,957,74,86,342,350
"2021","West Devon 004","E02004232",5844,4116,3363,3339,24,1,752,716,36,1728,985,59,65,288,331
"2021","West Devon 005","E02004233",10424,6484,5245,5227,18,11,1228,1188,40,3940,1967,71,177,884,841
"2021","West Devon 006","E02004234",5254,3618,2986,2966,20,6,626,602,24,1636,863,35,64,338,336
"2021","West Devon 007","E02004235",5503,3645,3009,2990,19,4,632,606,26,1858,914,53,87,384,420
"2021","Cheltenham 001","E02004600",4576,2808,2087,2071,16,5,716,680,36,1768,1067,34,66,330,271
"2021","Cheltenham 002","E02004601",4846,3358,2764,2746,18,2,592,584,8,1488,745,28,53,272,390
"2021","Cheltenham 003","E02004602",5235,3002,1972,1956,16,0,1030,990,40,2233,1415,48,89,418,263
"2021","Cheltenham 004","E02004603",6510,2836,1668,1662,6,2,1166,1110,56,3674,2835,70,97,430,242
"2021","Cheltenham 005","E02004604",6268,3180,2106,2096,10,2,1072,1030,42,3088,2058,66,154,541,269
"2021","Cheltenham 006","E02004605",4583,2522,1762,1750,12,4,756,724,32,2061,1311,45,85,361,259
"2021","Cheltenham 007","E02004606",8682,4865,3057,3009,48,6,1802,1728,74,3817,2635,82,146,560,394
"2021","Cheltenham 008","E02004607",8304,4490,2873,2839,34,3,1614,1532,82,3814,2611,93,146,634,330
"2021","Cheltenham 009","E02004608",7863,3890,2398,2364,34,2,1490,1390,100,3973,2601,112,155,714,391
"2021","Cheltenham 010","E02004609",5885,3754,2921,2905,16,13,820,790,30,2131,1272,38,82,369,370
"2021","Cheltenham 011","E02004610",6146,3634,2782,2770,12,0,852,816,36,2512,1355,51,106,508,492
"2021","Cheltenham 012","E02004611",9418,6217,5046,5027,19,11,1160,1126,34,3201,1976,49,123,568,485
"2021","Cheltenham 013","E02004612",7688,4932,3872,3848,24,4,1056,1028,28,2756,1536,45,96,551,528
"2021","Cheltenham 014","E02004613",5238,3534,2992,2984,8,6,536,510,26,1704,939,39,54,314,358
"2021","Cheltenham 015","E02004614",4346,2988,2550,2531,19,1,437,412,25,1358,689,30,54,258,327
"2021","Cotswold 001","E02004615",7390,4995,4172,4132,40,2,821,794,27,2395,1209,56,94,509,527
"2021","Cotswold 002","E02004616",8479,5469,4215,4163,52,9,1245,1196,49,3010,1497,86,146,614,667
"2021","Cotswold 003","E02004617",7783,5210,4158,4130,28,6,1046,1012,34,2573,1417,73,114,504,465
"2021","Cotswold 004","E02004618",6020,4236,3536,3502,34,6,694,676,18,1784,1029,66,77,316,296
"2021","Cotswold 005","E02004619",6081,4137,3349,3330,19,2,786,744,42,1944,1056,58,95,362,373
"2021","Cotswold 006","E02004620",6856,4499,3601,3577,24,3,895,855,40,2357,1471,31,96,402,357
"2021","Cotswold 007","E02004621",5068,2632,1946,1914,32,5,681,645,36,2436,1252,52,99,546,487
"2021","Cotswold 008","E02004622",6116,3682,2812,2794,18,0,870,822,48,2434,1495,43,104,417,375
"2021","Cotswold 009","E02004623",7645,5188,4249,4237,12,5,934,898,36,2457,1271,56,143,463,524
"2021","Cotswold 010","E02004624",5419,3802,3204,3180,24,4,594,584,10,1617,934,44,72,280,287
"2021","Cotswold 011","E02004625",8454,5594,4435,4409,26,7,1152,1106,46,2860,1540,65,147,579,529
"2021","Forest of Dean 001","E02004626",7613,5224,4347,4315,32,5,872,846,26,2389,1380,59,89,405,456
"2021","Forest of Dean 002","E02004627",5258,3219,2464,2446,18,9,746,716,30,2039,1140,50,73,403,373
"2021","Forest of Dean 003","E02004628",6501,4156,3248,3228,20,2,906,876,30,2345,1310,46,113,410,466
"2021","Forest of Dean 004","E02004629",10633,6494,4762,4732,30,4,1728,1676,52,4139,2356,63,204,832,684
"2021","Forest of Dean 005","E02004630",5454,3562,2830,2804,26,8,724,706,18,1892,1098,46,71,334,343
"2021","Forest of Dean 006","E02004631",4380,2984,2425,2407,18,1,558,538,20,1396,748,22,54,271,301
"2021","Forest of Dean 007","E02004632",8974,5579,4159,4138,21,8,1412,1364,48,3395,1860,46,163,686,640
"2021","Forest of Dean 008","E02004633",7035,4649,3659,3634,25,6,984,964,20,2386,1379,37,98,435,437
"2021","Forest of Dean 009","E02004634",9326,5800,4197,4171,26,3,1600,1544,56,3526,2027,64,160,654,621
"2021","Forest of Dean 010","E02004635",5973,4176,3398,3374,24,12,766,728,38,1797,950,48,88,315,396
"2021","Gloucester 001","E02004636",6417,4283,3398,3384,14,3,882,860,22,2134,1256,27,77,376,398
"2021","Gloucester 002","E02004637",7441,3760,2773,2755,18,5,982,936,46,3681,2450,102,144,572,413
"2021","Gloucester 003","E02004638",4721,3050,2400,2388,12,2,648,622,26,1671,1050,28,50,292,251
"2021","Gloucester 004","E02004639",9497,4318,2565,2527,38,3,1750,1588,162,5179,3573,150,209,802,445
"2021","Gloucester 005","E02004640",6567,3311,2503,2485,18,16,792,734,58,3256,2183,199,145,472,257
"2021","Gloucester 006","E02004641",6233,4028,3273,3255,18,7,748,726,22,2205,1162,36,90,398,519
"2021","Gloucester 007","E02004642",9615,5865,4436,4417,19,13,1416,1370,46,3750,2398,70,164,652,466
"2021","Gloucester 008","E02004643",6275,3239,2132,2124,8,6,1101,1049,52,3036,2104,75,144,449,264
"2021","Gloucester 009","E02004644",7252,3986,2797,2779,18,3,1186,1138,48,3266,2148,71,126,574,347
"2021","Gloucester 010","E02004645",7467,5014,3892,3868,24,2,1120,1076,44,2453,1459,31,106,487,370
"2021","Gloucester 011","E02004646",7160,3884,2706,2680,26,6,1172,1142,30,3276,2026,56,160,622,412
"2021","Gloucester 012","E02004647",4962,2999,2298,2289,9,7,694,674,20,1963,1243,34,76,297,313
"2021","Gloucester 013","E02004648",4733,2970,2316,2304,12,2,652,618,34,1763,944,28,75,332,384
"2021","Gloucester 014","E02004649",5806,3789,2671,2647,24,8,1110,1036,74,2017,1351,33,105,377,151
"2021","Gloucester 015","E02004650",11001,6883,4765,4742,23,10,2108,2006,102,4118,2737,90,214,751,326
"2021","Stroud 001","E02004651",8733,5894,4273,4253,20,25,1596,1530,66,2839,1803,58,134,508,336
"2021","Stroud 002","E02004652",5608,3846,3321,3297,24,7,518,498,20,1762,875,53,53,348,433
"2021","Stroud 003","E02004653",6247,4349,3372,3350,22,9,968,926,42,1898,1087,54,109,327,321
"2021","Stroud 004","E02004654",9406,5772,4343,4309,34,9,1420,1382,38,3634,2117,57,181,718,561
"2021","Stroud 005","E02004655",6547,3936,2895,2875,20,9,1032,998,34,2611,1532,55,121,490,413
"2021","Stroud 006","E02004656",9422,5062,3497,3457,40,7,1558,1496,62,4360,2700,70,194,906,490
"2021","Stroud 007","E02004657",5597,3706,2865,2841,24,7,834,794,40,1891,1104,36,86,359,306
"2021","Stroud 008","E02004658",5226,3551,2888,2874,14,6,657,638,19,1675,984,26,63,302,300
"2021","Stroud 009","E02004659",5898,4040,3255,3231,24,1,784,750,34,1858,1040,44,90,348,336
"2021","Stroud 010","E02004660",5513,3696,3104,3072,32,6,586,548,38,1817,889,45,66,356,461
"2021","Stroud 011","E02004661",7154,4714,3646,3634,12,8,1060,1022,38,2440,1297,39,100,482,522
"2021","Stroud 012","E02004662",5422,3600,2733,2709,24,5,862,842,20,1822,1054,20,78,332,338
"2021","Stroud 013","E02004663",5304,3314,2615,2583,32,9,690,656,34,1990,1069,29,108,441,343
"2021","Stroud 014","E02004664",5941,3713,2701,2683,18,9,1003,966,37,2228,1297,47,126,430,328
"2021","Stroud 015","E02004665",7097,4630,3802,3778,24,2,826,812,14,2467,1409,38,111,465,444
"2021","Tewkesbury 001","E02004666",9633,6382,4709,4673,36,11,1662,1610,52,3251,1971,55,152,628,445
"2021","Tewkesbury 002","E02004667",8960,5481,4114,4086,28,9,1358,1300,58,3479,1821,71,131,742,714
"2021","Tewkesbury 003","E02004668",7670,5247,4368,4343,25,5,874,844,30,2423,1232,53,112,490,536
"2021","Tewkesbury 004","E02004669",6194,4449,3666,3650,16,3,780,752,28,1745,986,44,77,273,365
"2021","Tewkesbury 006","E02004671",5886,4110,3233,3221,12,6,871,841,30,1776,1075,49,77,290,285
"2021","Tewkesbury 007","E02004672",9904,6384,5192,5170,22,2,1190,1142,48,3520,1914,50,162,733,661
"2021","Tewkesbury 008","E02004673",6187,4050,3047,3031,16,13,990,938,52,2137,1202,36,93,402,404
"2021","Tewkesbury 009","E02004674",9587,6090,4327,4303,24,5,1758,1674,84,3497,2121,63,157,702,454
"2021","Tewkesbury 010","E02007034",6255,4162,2958,2942,16,6,1198,1152,46,2093,1223,30,104,485,251
"2021","Tewkesbury 011","E02007035",6466,4136,3291,3271,20,5,840,802,38,2330,1185,45,92,438,570
"2021","Mendip 001","E02006047",7287,4911,3905,3887,18,6,1000,968,32,2376,1354,61,124,448,389
"2021","Mendip 002","E02006048",5774,3846,3064,3042,22,2,780,760,20,1928,1142,37,78,325,346
"2021","Mendip 003","E02006049",6018,4087,3241,3226,15,2,844,814,30,1931,1044,26,98,392,371
"2021","Mendip 004","E02006050",6941,3796,2573,2545,28,5,1218,1188,30,3145,1852,55,175,697,366
"2021","Mendip 005","E02006051",6877,4546,3680,3646,34,6,860,820,40,2331,1271,76,100,411,473
"2021","Mendip 006","E02006052",6382,4215,3303,3274,29,3,909,871,38,2167,1215,52,97,427,376
"2021","Mendip 007","E02006053",8699,5477,3762,3727,35,5,1710,1660,50,3222,1895,58,169,650,450
"2021","Mendip 008","E02006054",7131,4090,3138,3118,20,4,948,902,46,3041,1505,57,149,677,653
"2021","Mendip 009","E02006055",7333,4555,3160,3138,22,4,1391,1346,45,2778,1663,65,140,563,347
"2021","Mendip 010","E02006056",6438,4342,3385,3353,32,11,946,922,24,2096,1219,48,102,374,353
"2021","Mendip 011","E02006057",6406,3474,2485,2439,46,1,988,948,40,2932,1622,40,162,707,401
"2021","Mendip 012","E02006058",6533,4370,3517,3498,19,2,851,823,28,2163,1272,51,97,369,374
"2021","Mendip 013","E02006059",5864,4010,3264,3244,20,6,740,722,18,1854,1085,59,76,309,325
"2021","Mendip 014","E02006060",6692,3736,2634,2612,22,0,1102,1040,62,2956,1631,84,178,591,472
"2021","Sedgemoor 001","E02006061",7662,4918,3961,3943,18,1,956,920,36,2744,1427,72,165,557,523
"2021","Sedgemoor 002","E02006062",9367,6355,5208,5187,21,13,1134,1096,38,3012,1596,76,137,536,667
"2021","Sedgemoor 003","E02006063",5854,4143,3488,3462,26,6,649,634,15,1711,955,36,82,267,371
"2021","Sedgemoor 004","E02006064",6581,3788,2882,2866,16,8,898,832,66,2793,1294,65,151,602,681
"2021","Sedgemoor 005","E02006065",7227,4234,3094,3076,18,4,1136,1100,36,2993,1678,67,179,598,471
"2021","Sedgemoor 006","E02006066",7171,4807,3715,3691,24,10,1082,1050,32,2364,1268,69,90,428,509
"2021","Sedgemoor 007","E02006067",5835,3891,3157,3137,20,2,732,716,16,1944,971,51,95,382,445
"2021","Sedgemoor 008","E02006068",6128,3366,2183,2179,4,3,1180,1124,56,2762,1808,65,129,448,312
"2021","Sedgemoor 009","E02006069",8540,4343,2726,2711,15,11,1606,1534,72,4197,2524,210,219,801,443
"2021","Sedgemoor 010","E02006070",7087,4642,3150,3130,20,8,1484,1422,62,2445,1446,60,147,458,334
"2021","Sedgemoor 011","E02006071",7754,5076,3945,3923,22,5,1126,1084,42,2678,1560,83,137,456,442
"2021","Sedgemoor 012","E02006072",8051,5586,4568,4530,38,8,1010,968,42,2465,1360,68,96,415,526
"2021","Sedgemoor 013","E02006073",6049,3168,2080,2070,10,6,1082,1040,42,2881,1765,98,184,496,338
"2021","Sedgemoor 014","E02006074",9168,6184,4568,4532,36,12,1604,1544,60,2984,1745,91,157,561,430
"2021","South Somerset 001","E02006075",4128,2648,2178,2168,10,2,468,440,28,1480,847,24,67,297,245
"2021","South Somerset 002","E02006076",7657,5056,4128,4104,24,12,916,888,28,2601,1426,46,112,473,544
"2021","South Somerset 003","E02006077",5160,3342,2578,2564,14,0,764,734,30,1818,939,33,73,341,432
"2021","South Somerset 004","E02006078",5272,3470,2742,2726,16,5,723,699,24,1802,996,43,77,346,340
"2021","South Somerset 005","E02006079",6858,4476,3456,3444,12,2,1018,990,28,2382,1291,57,124,473,437
"2021","South Somerset 006","E02006080",4830,3270,2666,2656,10,4,600,580,20,1560,858,47,67,282,306
"2021","South Somerset 007","E02006081",4854,3308,2728,2692,36,4,576,566,10,1546,837,33,77,281,318
"2021","South Somerset 008","E02006082",5856,3847,2979,2956,23,2,866,832,34,2009,1128,32,97,423,329
"2021","South Somerset 009","E02006083",4794,3047,2373,2357,16,0,674,658,16,1747,925,20,87,369,346
"2021","South Somerset 010","E02006084",6348,4316,3482,3456,26,4,830,804,26,2032,1007,57,92,449,427
"2021","South Somerset 011","E02006085",6243,4151,3085,3077,8,5,1061,1012,49,2092,1184,46,99,426,337
"2021","South Somerset 012","E02006086",6125,4094,3186,3174,12,11,897,874,23,2031,1249,43,77,344,318
"2021","South Somerset 013","E02006087",4701,2694,1815,1804,11,1,878,850,28,2007,1150,42,101,427,287
"2021","South Somerset 014","E02006088",6171,3406,2370,2356,14,2,1034,988,46,2765,1705,85,143,507,325
"2021","South Somerset 015","E02006089",5891,2879,1874,1852,22,3,1002,946,56,3012,1845,124,161,607,275
"2021","South Somerset 016","E02006090",5753,3618,2556,2550,6,6,1056,1008,48,2135,1234,59,106,424,312
"2021","South Somerset 017","E02006091",8450,5660,4579,4553,26,5,1076,1038,38,2790,1459,53,147,574,557
"2021","South Somerset 018","E02006092",5459,3652,2801,2785,16,1,850,808,42,1807,1002,40,75,358,332
"2021","South Somerset 019","E02006093",7248,4670,3651,3635,16,7,1012,982,30,2578,1277,37,128,539,597
"2021","South Somerset 020","E02006094",4588,3074,2483,2465,18,7,584,554,30,1514,780,17,68,292,357
"2021","South Somerset 021","E02006095",7014,4384,3300,3276,24,6,1078,1034,44,2630,1373,42,140,574,501
"2021","South Somerset 022","E02006096",5991,3836,2808,2800,8,8,1020,980,40,2155,1158,54,109,443,391
"2021","South Somerset 023","E02006097",5610,3244,2278,2272,6,2,964,918,46,2366,1336,45,110,455,420
"2021","South Somerset 024","E02006098",6447,4508,3693,3673,20,13,802,776,26,1939,1036,59,84,332,428
"2021","Somerset West and Taunton 006","E02006099",5821,3908,3057,3045,12,5,846,818,28,1913,1108,44,86,377,298
"2021","Somerset West and Taunton 007","E02006100",6273,4040,3048,3026,22,14,978,944,34,2233,1283,55,102,419,374
"2021","Somerset West and Taunton 013","E02006101",4818,3094,2480,2460,20,2,612,580,32,1724,943,50,66,359,306
"2021","Somerset West and Taunton 010","E02006102",5599,3116,2270,2252,18,8,838,804,34,2483,1409,51,115,518,390
"2021","Somerset West and Taunton 009","E02006103",6697,4485,3667,3649,18,10,808,788,20,2212,1155,56,91,415,495
"2021","Somerset West and Taunton 008","E02006104",8402,5415,3918,3892,26,3,1494,1402,92,2987,1793,63,141,637,353
"2021","Somerset West and Taunton 011","E02006105",9280,5050,3227,3187,40,9,1814,1716,98,4230,2622,136,234,814,424
"2021","Somerset West and Taunton 012","E02006106",7665,4956,3665,3649,16,11,1280,1240,40,2709,1607,50,145,545,362
"2021","Somerset West and Taunton 014","E02006107",6489,3437,2436,2421,15,7,994,946,48,3052,1856,53,148,627,368
"2021","Somerset West and Taunton 015","E02006108",7213,3796,2883,2863,20,5,908,846,62,3417,1797,112,177,680,651
"2021","Somerset West and Taunton 016","E02006109",6535,4345,3638,3622,16,0,707,682,25,2190,1146,76,85,398,485
"2021","Somerset West and Taunton 018","E02006110",8323,4967,3577,3545,32,5,1385,1348,37,3356,1803,90,186,768,509
"2021","Somerset West and Taunton 017","E02006111",8830,5924,4841,4803,38,5,1078,1034,44,2906,1484,74,144,550,654
"2021","Somerset West and Taunton 019","E02006112",6747,4659,3799,3777,22,7,853,824,29,2088,1135,58,82,394,419
"2021","Somerset West and Taunton 001","E02006113",6180,3564,2674,2662,12,2,888,856,32,2616,1347,73,116,507,573
"2021","Somerset West and Taunton 002","E02006114",5373,3454,2721,2687,34,7,726,680,46,1919,923,38,98,388,472
"2021","Somerset West and Taunton 003","E02006115",6405,3965,3100,3082,18,3,862,828,34,2440,1181,44,113,572,530
"2021","Somerset West and Taunton 004","E02006116",6939,4775,3825,3787,38,3,947,913,34,2164,1092,62,84,415,511
"2021","Somerset West and Taunton 005","E02006117",4938,3252,2584,2570,14,2,666,640,26,1686,818,51,71,331,415
"2021","Isle of Anglesey 001","W02000001",7010,4236,3218,3202,16,4,1014,966,48,2774,1589,72,130,519,464
"2021","Isle of Anglesey 002","W02000002",5447,3462,2843,2835,8,7,612,574,38,1985,1004,74,63,358,486
"2021","Isle of Anglesey 003","W02000003",8268,4036,2748,2730,18,2,1286,1230,56,4232,2625,77,186,779,565
"2021","Isle of Anglesey 004","W02000004",6239,3906,3142,3128,14,4,760,740,20,2333,1244,60,103,419,507
"2021","Isle of Anglesey 005","W02000005",6932,4370,3530,3518,12,0,840,790,50,2562,1324,75,101,525,537
"2021","Isle of Anglesey 006","W02000006",5556,3155,2317,2316,1,4,834,812,22,2401,1428,49,86,431,407
"2021","Isle of Anglesey 007","W02000007",5459,3298,2464,2444,20,2,832,800,32,2161,1257,46,97,378,383
"2021","Isle of Anglesey 008","W02000008",4969,2887,2274,2270,4,4,609,579,30,2082,1175,49,52,389,417
"2021","Isle of Anglesey 009","W02000009",6576,4054,3169,3145,24,11,874,844,30,2522,1485,66,75,461,435
"2021","Gwynedd 001","W02000010",5660,1786,1050,1046,4,2,734,656,78,3874,3214,70,58,312,220
"2021","Gwynedd 002","W02000011",6530,3503,2497,2479,18,4,1002,950,52,3027,2096,81,108,390,352
"2021","Gwynedd 003","W02000012",6591,3772,2647,2629,18,5,1120,1062,58,2819,1806,46,86,453,428
"2021","Gwynedd 004","W02000013",5209,3146,2242,2232,10,4,900,858,42,2063,1286,48,62,328,339
"2021","Gwynedd 005","W02000014",5507,3092,2106,2088,18,7,979,944,35,2415,1568,47,95,388,317
"2021","Gwynedd 006","W02000015",6596,3556,2493,2479,14,3,1060,1014,46,3040,1924,57,108,520,431
"2021","Gwynedd 007","W02000016",5099,3016,2258,2248,10,0,758,724,34,2083,1280,65,83,345,310
"2021","Gwynedd 008","W02000017",6131,3664,2612,2606,6,2,1050,1012,38,2467,1492,55,88,423,409
"2021","Gwynedd 009","W02000018",4934,2673,1873,1862,11,2,798,768,30,2261,1390,48,102,398,323
"2021","Gwynedd 010","W02000019",5473,3167,2316,2299,17,7,844,810,34,2306,1296,82,96,387,445
"2021","Gwynedd 011","W02000020",5299,3260,2561,2539,22,5,694,658,36,2039,1171,72,75,311,410
"2021","Gwynedd 012","W02000021",6341,3653,2683,2671,12,2,968,938,30,2688,1586,56,103,465,478
"2021","Gwynedd 013","W02000022",4723,2848,2243,2218,25,0,605,565,40,1875,986,39,75,352,423
"2021","Gwynedd 014","W02000023",4414,2722,2138,2126,12,2,582,564,18,1692,991,58,49,227,367
"2021","Gwynedd 015","W02000024",4705,2766,2112,2094,18,2,652,630,22,1939,1159,32,74,319,355
"2021","Gwynedd 016","W02000025",5076,2959,2226,2210,16,2,731,706,25,2117,1253,53,76,381,354
"2021","Gwynedd 017","W02000026",6015,3580,2807,2785,22,1,772,732,40,2435,1204,103,103,468,557
"2021","Conwy 001","W02000027",7016,3453,2546,2521,25,1,906,842,64,3563,1918,91,159,751,644
"2021","Conwy 002","W02000028",5472,3010,2338,2326,12,2,670,628,42,2462,1422,49,83,445,463
"2021","Conwy 003","W02000029",5013,3210,2596,2586,10,2,612,574,38,1803,885,46,65,361,446
"2021","Conwy 004","W02000030",5018,2878,2367,2351,16,5,506,472,34,2140,975,74,89,475,527
"2021","Conwy 005","W02000031",6780,3978,2998,2978,20,3,977,906,71,2802,1547,84,148,470,553
"2021","Conwy 006","W02000032",6996,4285,3445,3424,21,2,838,800,38,2711,1379,78,106,546,602
"2021","Conwy 007","W02000033",5417,2659,1855,1845,10,2,802,762,40,2758,1685,63,146,566,298
"2021","Conwy 008","W02000034",6197,3779,2932,2910,22,4,843,798,45,2418,1357,48,113,504,396
"2021","Conwy 009","W02000035",7076,4042,3041,3013,28,5,996,964,32,3034,1800,75,129,580,450
"2021","Conwy 010","W02000036",9450,5656,4372,4332,40,0,1284,1224,60,3794,1935,93,190,759,817
"2021","Conwy 011","W02000037",5858,3487,2490,2476,14,8,989,940,49,2371,1383,56,95,442,395
"2021","Conwy 012","W02000038",5253,3222,2481,2463,18,3,738,708,30,2031,1163,43,73,390,362
"2021","Conwy 013","W02000039",6492,3704,2746,2714,32,2,956,926,30,2788,1575,57,138,540,478
"2021","Conwy 014","W02000040",5516,3618,2897,2881,16,3,718,698,20,1898,1183,36,77,265,337
"2021","Conwy 015","W02000041",7047,4340,3258,3224,34,2,1080,1040,40,2707,1581,55,89,478,504
"2021","Denbighshire 001","W02000042",4895,2848,2162,2144,18,2,684,646,38,2047,1049,45,75,443,435
"2021","Denbighshire 002","W02000043",4303,2417,1852,1844,8,3,562,536,26,1886,1081,30,91,358,326
"2021","Denbighshire 003","W02000044",4480,2603,2099,2085,14,2,502,480,22,1877,1004,36,74,372,391
"2021","Denbighshire 004","W02000045",7248,3300,2334,2318,16,8,958,906,52,3948,2321,75,233,808,511
"2021","Denbighshire 006","W02000047",4092,1908,1285,1283,2,3,620,596,24,2184,1464,45,97,365,213
"2021","Denbighshire 008","W02000049",5396,3384,2556,2542,14,2,826,784,42,2012,1196,41,99,360,316
"2021","Denbighshire 009","W02000050",5250,3128,2382,2370,12,6,740,710,30,2122,1192,47,93,395,395
"2021","Denbighshire 010","W02000051",4361,2650,2049,2035,14,1,600,580,20,1711,953,31,87,352,288
"2021","Denbighshire 011","W02000052",3897,1922,1341,1327,14,3,578,550,28,1975,1219,27,107,384,238
"2021","Denbighshire 012","W02000053",5157,3270,2620,2602,18,4,646,616,30,1887,1111,37,69,299,371
"2021","Denbighshire 013","W02000054",5119,3427,2820,2813,7,1,606,582,24,1692,985,41,69,319,278
"2021","Denbighshire 014","W02000055",4574,2654,1951,1935,16,1,702,670,32,1920,1061,49,88,346,376
"2021","Denbighshire 015","W02000056",4249,2755,2148,2132,16,0,607,580,27,1494,872,32,67,270,253
"2021","Denbighshire 016","W02000057",5185,3139,2439,2425,14,2,698,658,40,2046,1120,47,87,398,394
"2021","Denbighshire 017","W02000419",9163,5404,3921,3889,32,9,1474,1402,72,3759,2115,51,169,739,685
"2021","Flintshire 001","W02000058",4361,2658,2008,1996,12,2,648,620,28,1703,934,39,76,328,326
"2021","Flintshire 002","W02000059",5337,3306,2584,2566,18,4,718,694,24,2031,1220,37,84,346,344
"2021","Flintshire 003","W02000060",8507,4575,3250,3237,13,16,1309,1246,63,3932,2417,65,195,704,551
"2021","Flintshire 004","W02000061",6028,3134,1972,1962,10,2,1160,1098,62,2894,1651,63,140,610,430
"2021","Flintshire 005","W02000062",4975,3208,2510,2504,6,6,692,668,24,1767,1106,31,71,308,251
"2021","Flintshire 006","W02000063",6972,4568,3709,3689,20,9,850,818,32,2404,1357,58,88,435,466
"2021","Flintshire 007","W02000064",4944,2590,1809,1801,8,3,778,746,32,2354,1444,52,98,428,332
"2021","Flintshire 008","W02000065",5938,3714,2770,2754,16,4,940,904,36,2224,1335,50,102,388,349
"2021","Flintshire 009","W02000066",7855,4208,2891,2865,26,9,1308,1226,82,3647,2197,108,141,716,485
"2021","Flintshire 010","W02000067",5484,3740,3041,3029,12,3,696,662,34,1744,1011,45,73,284,331
"2021","Flintshire 011","W02000068",4342,2412,1782,1770,12,8,622,604,18,1930,1032,43,105,438,312
"2021","Flintshire 012","W02000069",5208,3438,2738,2720,18,5,695,682,13,1770,985,44,78,335,328
"2021","Flintshire 013","W02000070",8753,5790,4692,4676,16,0,1098,1060,38,2963,1732,67,107,507,550
"2021","Flintshire 014","W02000071",5902,3836,3094,3072,22,8,734,704,30,2066,1075,42,73,398,478
"2021","Flintshire 015","W02000072",9464,5762,4074,4042,32,12,1676,1604,72,3702,2255,84,172,685,506
"2021","Flintshire 016","W02000073",8250,4748,3625,3597,28,7,1116,1082,34,3502,2015,54,156,656,621
"2021","Flintshire 017","W02000074",7972,4728,3394,3371,23,9,1325,1250,75,3244,1911,53,142,641,497
"2021","Flintshire 018","W02000075",5179,3614,2848,2834,14,2,764,738,26,1565,893,30,60,323,259
"2021","Flintshire 019","W02000076",6196,3990,3152,3140,12,14,824,798,26,2206,1267,49,86,375,429
"2021","Flintshire 020","W02000077",4954,3103,2440,2428,12,7,656,632,24,1851,1064,40,81,333,333
"2021","Wrexham 003","W02000080",6275,3793,2786,2772,14,3,1004,954,50,2482,1465,48,111,431,427
"2021","Wrexham 004","W02000081",4478,2754,2005,1997,8,7,742,712,30,1724,1084,33,78,295,234
"2021","Wrexham 005","W02000082",6058,3552,2448,2422,26,2,1102,1050,52,2506,1574,50,103,466,313
"2021","Wrexham 006","W02000083",6830,4037,2787,2773,14,0,1250,1186,64,2793,1705,63,125,507,393
"2021","Wrexham 008","W02000085",7335,4308,3224,3208,16,4,1080,1026,54,3027,1690,101,128,532,576
"2021","Wrexham 010","W02000087",4978,2269,1430,1424,6,4,835,799,36,2709,1761,65,108,469,306
"2021","Wrexham 011","W02000088",7028,3814,2541,2513,28,5,1268,1192,76,3214,2073,118,150,536,337
"2021","Wrexham 012","W02000089",6798,3422,2260,2244,16,4,1158,1110,48,3376,2148,81,172,627,348
"2021","Wrexham 013","W02000090",4611,2810,2135,2121,14,1,674,642,32,1801,1114,37,84,315,251
"2021","Wrexham 014","W02000091",5086,3187,2409,2407,2,2,776,750,26,1899,1186,28,73,295,317
"2021","Wrexham 015","W02000092",5354,2853,1967,1956,11,0,886,836,50,2501,1557,33,86,477,348
"2021","Wrexham 016","W02000093",5376,3312,2553,2531,22,7,752,724,28,2064,1222,33,80,410,319
"2021","Wrexham 017","W02000094",7039,3974,2801,2783,18,3,1170,1130,40,3065,1907,42,123,557,436
"2021","Wrexham 018","W02000095",5374,3554,2915,2899,16,7,632,616,16,1820,1003,46,77,330,364
"2021","Wrexham 019","W02000096",5259,3122,2390,2374,16,2,730,692,38,2137,1208,48,95,401,385
"2021","Wrexham 021","W02000424",5678,3712,3039,3033,6,7,666,634,32,1966,1065,42,70,363,426
"2021","Wrexham 022","W02000425",5619,3782,3069,3053,16,5,708,690,18,1837,1045,42,78,325,347
"2021","Wrexham 023","W02000426",8191,5010,3919,3905,14,7,1084,1028,56,3181,1813,61,96,588,623
"2021","Ceredigion 001","W02000116",6093,3772,2834,2802,32,4,934,900,34,2321,1386,64,98,398,375
"2021","Ceredigion 002","W02000117",5883,2111,1192,1168,24,3,916,828,88,3772,3095,70,55,308,244
"2021","Ceredigion 003","W02000118",4865,2600,1722,1700,22,6,872,828,44,2265,1427,56,83,409,290
"2021","Ceredigion 005","W02000120",6061,3736,2944,2924,20,6,786,764,22,2325,1300,62,89,396,478
"2021","Ceredigion 007","W02000122",5461,3633,2950,2935,15,5,678,656,22,1828,1019,46,57,324,382
"2021","Ceredigion 008","W02000123",6245,3779,2900,2874,26,3,876,842,34,2466,1397,70,97,459,443
"2021","Ceredigion 009","W02000124",7243,4077,3168,3150,18,8,901,866,35,3166,1735,55,119,621,636
"2021","Ceredigion 010","W02000125",6318,3966,3067,3036,31,1,898,860,38,2352,1291,57,89,440,475
"2021","Ceredigion 011","W02000421",9596,6136,4803,4767,36,3,1330,1260,70,3460,2005,93,129,563,670
"2021","Pembrokeshire 001","W02000126",6902,4287,3331,3313,18,10,946,908,38,2615,1500,76,99,454,486
"2021","Pembrokeshire 002","W02000127",8013,4720,3644,3624,20,2,1074,1008,66,3293,1818,74,144,630,627
"2021","Pembrokeshire 003","W02000128",5982,3726,3032,3014,18,8,686,646,40,2256,1225,53,98,407,473
"2021","Pembrokeshire 004","W02000129",5913,3904,3163,3143,20,5,736,712,24,2009,1126,68,91,338,386
"2021","Pembrokeshire 005","W02000130",5316,2603,1900,1876,24,7,696,668,28,2713,1654,71,134,511,343
"2021","Pembrokeshire 006","W02000131",5762,3285,2412,2394,18,4,869,836,33,2477,1403,35,111,484,444
"2021","Pembrokeshire 007","W02000132",5799,3614,2876,2856,20,2,736,704,32,2185,1234,47,97,386,421
"2021","Pembrokeshire 008","W02000133",6702,4385,3548,3536,12,5,832,796,36,2317,1228,66,95,444,484
"2021","Pembrokeshire 009","W02000134",6910,4499,3573,3553,20,4,922,884,38,2411,1331,60,99,456,465
"2021","Pembrokeshire 010","W02000135",5899,3298,2408,2388,20,0,890,852,38,2601,1455,39,138,501,468
"2021","Pembrokeshire 011","W02000136",7023,4476,3644,3620,24,6,826,794,32,2547,1240,63,99,517,628
"2021","Pembrokeshire 012","W02000137",5902,3242,2301,2285,16,5,936,888,48,2660,1565,57,101,491,446
"2021","Pembrokeshire 013","W02000138",7735,4092,2923,2904,19,7,1162,1114,48,3643,2156,61,204,700,522
"2021","Pembrokeshire 014","W02000139",6535,4358,3641,3625,16,7,710,692,18,2177,1132,54,72,384,535
"2021","Pembrokeshire 015","W02000140",5777,3222,2426,2406,20,4,792,752,40,2555,1472,52,138,500,393
"2021","Pembrokeshire 016","W02000141",4831,2734,2124,2116,8,4,606,594,12,2097,1068,51,77,489,412
"2021","Carmarthenshire 001","W02000142",4633,2908,2199,2193,6,5,704,674,30,1725,983,52,63,307,320
"2021","Carmarthenshire 002","W02000143",4615,2901,2312,2290,22,4,585,565,20,1714,922,54,68,297,373
"2021","Carmarthenshire 003","W02000144",6457,4046,3260,3226,34,12,774,732,42,2411,1350,85,95,428,453
"2021","Carmarthenshire 004","W02000145",5871,3610,2940,2900,40,6,664,632,32,2261,1273,64,81,384,459
"2021","Carmarthenshire 005","W02000146",5580,3718,3053,3031,22,3,662,636,26,1862,1061,42,66,312,381
"2021","Carmarthenshire 006","W02000147",6662,4003,3056,3034,22,2,945,898,47,2659,1658,53,90,475,383
"2021","Carmarthenshire 007","W02000148",4220,2356,1650,1648,2,0,706,678,28,1864,1139,37,91,336,261
"2021","Carmarthenshire 008","W02000149",5334,2909,2195,2189,6,2,712,678,34,2425,1313,53,92,475,492
"2021","Carmarthenshire 010","W02000151",6026,3541,2677,2663,14,3,861,824,37,2485,1442,44,94,474,431
"2021","Carmarthenshire 011","W02000152",6944,4332,3496,3474,22,10,826,782,44,2612,1442,46,102,519,503
"2021","Carmarthenshire 012","W02000153",7279,4757,3790,3771,19,9,958,898,60,2522,1387,62,88,455,530
"2021","Carmarthenshire 013","W02000154",6341,3598,2774,2748,26,8,816,774,42,2743,1589,44,110,513,487
"2021","Carmarthenshire 015","W02000156",6857,4232,3298,3290,8,0,934,884,50,2625,1551,61,119,446,448
"2021","Carmarthenshire 016","W02000157",8180,5267,4088,4060,28,9,1170,1128,42,2913,1591,53,118,592,559
"2021","Carmarthenshire 017","W02000158",4823,3114,2390,2364,26,2,722,692,30,1709,954,42,71,330,312
"2021","Carmarthenshire 018","W02000159",5035,2968,2317,2301,16,5,646,604,42,2067,1154,26,97,410,380
"2021","Carmarthenshire 019","W02000160",6257,3985,3282,3274,8,5,698,668,30,2272,1260,37,70,395,510
"2021","Carmarthenshire 020","W02000161",4080,2184,1648,1628,20,13,523,504,19,1896,1094,37,85,376,304
"2021","Carmarthenshire 021","W02000162",6964,4117,3224,3200,24,3,890,850,40,2847,1550,63,116,562,556
"2021","Carmarthenshire 022","W02000163",4232,2266,1686,1680,6,6,574,540,34,1966,1144,32,103,387,300
"2021","Carmarthenshire 023","W02000164",6126,3673,2742,2722,20,7,924,882,42,2453,1420,50,112,455,416
"2021","Carmarthenshire 024","W02000165",5191,2875,2150,2128,22,5,720,692,28,2316,1397,48,96,464,311
"2021","Carmarthenshire 025","W02000166",7177,4240,3070,3054,16,0,1170,1114,56,2937,1779,69,130,522,437
"2021","Carmarthenshire 026","W02000167",8187,4094,2800,2756,44,0,1294,1186,108,4093,2381,105,204,880,523
"2021","Carmarthenshire 027","W02000418",10152,6450,5127,5111,16,7,1316,1280,36,3702,1981,119,181,714,707
"2021","Swansea 001","W02000168",5182,2928,2199,2191,8,7,722,696,26,2254,1400,41,96,393,324
"2021","Swansea 002","W02000169",7418,4198,3270,3238,32,6,922,868,54,3220,1852,80,164,590,534
"2021","Swansea 003","W02000170",7213,4230,3380,3364,16,0,850,808,42,2983,1834,47,110,468,524
"2021","Swansea 004","W02000171",6802,4322,3405,3385,20,7,910,880,30,2480,1521,51,110,447,351
"2021","Swansea 005","W02000172",8232,4510,3341,3313,28,3,1166,1116,50,3722,2176,42,185,736,583
"2021","Swansea 006","W02000173",6243,4004,2941,2925,16,3,1060,1016,44,2239,1350,64,117,436,272
"2021","Swansea 007","W02000174",7904,4903,3833,3817,16,6,1064,1034,30,3001,1712,52,109,545,583
"2021","Swansea 008","W02000175",5985,3056,2154,2132,22,2,900,848,52,2929,1758,50,131,577,413
"2021","Swansea 009","W02000176",7272,4090,3072,3056,16,6,1012,948,64,3182,1844,58,148,557,575
"2021","Swansea 010","W02000177",5595,3295,2470,2452,18,8,817,775,42,2300,1417,57,95,426,305
"2021","Swansea 011","W02000178",6564,2976,2085,2077,8,5,886,842,44,3588,2465,62,191,556,314
"2021","Swansea 012","W02000179",5368,3224,2603,2589,14,3,618,600,18,2144,1232,41,85,431,355
"2021","Swansea 013","W02000180",6228,3082,2222,2198,24,6,854,826,28,3146,2019,66,147,514,400
"2021","Swansea 014","W02000181",5881,3006,2068,2052,16,8,930,880,50,2875,1842,53,124,492,364
"2021","Swansea 015","W02000182",6165,3302,2446,2432,14,4,852,806,46,2863,1818,37,139,472,397
"2021","Swansea 016","W02000183",7677,3626,2395,2365,30,7,1224,1132,92,4051,2496,145,197,752,461
"2021","Swansea 017","W02000184",5571,3001,2282,2248,34,2,717,687,30,2570,1507,92,107,453,411
"2021","Swansea 018","W02000185",4261,2714,2246,2236,10,2,466,454,12,1547,880,29,64,251,323
"2021","Swansea 019","W02000186",6407,2728,1739,1727,12,9,980,932,48,3679,2431,61,228,610,349
"2021","Swansea 021","W02000188",6693,3214,2156,2126,30,6,1052,982,70,3479,2371,71,184,453,400
"2021","Swansea 022","W02000189",6776,3750,2996,2986,10,6,748,712,36,3026,1671,58,138,654,505
"2021","Swansea 024","W02000191",7581,3080,2236,2194,42,6,838,788,50,4501,3568,90,114,412,317
"2021","Swansea 025","W02000192",7385,2605,1536,1504,32,5,1064,986,78,4780,3285,198,161,786,350
"2021","Swansea 026","W02000193",7943,1938,1257,1243,14,1,680,636,44,6005,5053,104,110,449,289
"2021","Swansea 027","W02000194",4611,2943,2510,2492,18,6,427,397,30,1668,978,39,45,219,387
"2021","Swansea 028","W02000195",4884,3171,2821,2811,10,5,345,307,38,1713,840,40,62,310,461
"2021","Swansea 029","W02000196",5240,2953,2382,2369,13,3,568,522,46,2287,1162,31,114,504,476
"2021","Swansea 030","W02000197",5099,3348,2895,2881,14,3,450,428,22,1751,929,61,51,260,450
"2021","Swansea 031","W02000198",6110,3820,3271,3243,28,1,548,524,24,2290,1198,59,87,450,496
"2021","Swansea 032","W02000428",8435,5326,4400,4392,8,4,922,912,10,3109,1686,53,96,584,690
"2021","Neath Port Talbot 002","W02000200",4196,2425,1933,1913,20,0,492,476,16,1771,1013,25,91,326,316
"2021","Neath Port Talbot 003","W02000201",4320,2496,1893,1879,14,9,594,568,26,1824,1053,36,83,303,349
"2021","Neath Port Talbot 004","W02000202",10059,6006,4583,4555,28,9,1414,1368,46,4053,2416,60,157,760,660
"2021","Neath Port Talbot 006","W02000204",5613,3528,2922,2910,12,4,602,568,34,2085,1160,44,66,394,421
"2021","Neath Port Talbot 007","W02000205",4817,2733,2182,2166,16,1,550,520,30,2084,1152,37,75,442,378
"2021","Neath Port Talbot 008","W02000206",5429,2544,1844,1826,18,0,700,642,58,2885,1598,39,128,672,448
"2021","Neath Port Talbot 009","W02000207",4390,2852,2324,2302,22,2,526,504,22,1538,852,26,67,299,294
"2021","Neath Port Talbot 010","W02000208",8468,4962,3653,3619,34,7,1302,1232,70,3506,2128,56,155,689,478
"2021","Neath Port Talbot 012","W02000210",4930,2677,2017,2003,14,2,658,618,40,2253,1489,37,91,383,253
"2021","Neath Port Talbot 013","W02000211",6258,3184,2276,2262,14,6,902,842,60,3074,1859,49,161,591,414
"2021","Neath Port Talbot 014","W02000212",6375,3694,2839,2827,12,3,852,814,38,2681,1579,34,105,516,447
"2021","Neath Port Talbot 015","W02000213",5623,3534,2762,2738,24,6,766,732,34,2089,1205,35,70,362,417
"2021","Neath Port Talbot 016","W02000214",7588,3824,2893,2867,26,5,926,874,52,3764,2212,67,167,715,603
"2021","Neath Port Talbot 017","W02000215",7613,3802,2830,2794,36,4,968,934,34,3811,2289,51,179,757,535
"2021","Neath Port Talbot 018","W02000216",5856,3281,2433,2415,18,10,838,806,32,2575,1552,35,117,502,369
"2021","Neath Port Talbot 019","W02000217",5162,3004,2332,2326,6,2,670,652,18,2158,1324,22,96,370,346
"2021","Neath Port Talbot 020","W02000417",8315,4678,3470,3438,32,10,1198,1134,64,3637,2114,69,156,705,593
"2021","Neath Port Talbot 021","W02000427",9036,5034,3807,3775,32,3,1224,1150,74,4002,2391,58,205,678,670
"2021","Bridgend 001","W02000218",5286,2867,1967,1953,14,6,894,854,40,2419,1520,43,98,379,379
"2021","Bridgend 002","W02000219",5971,3289,2551,2531,20,2,736,696,40,2682,1611,49,97,499,426
"2021","Bridgend 003","W02000220",6403,3642,2611,2607,4,6,1025,972,53,2761,1676,58,125,477,425
"2021","Bridgend 004","W02000221",6184,3458,2453,2437,16,0,1005,958,47,2726,1720,29,119,455,403
"2021","Bridgend 005","W02000222",5113,3071,2458,2454,4,5,608,578,30,2042,1211,41,52,332,406
"2021","Bridgend 006","W02000223",4870,2876,2151,2137,14,5,720,686,34,1994,1198,29,87,390,290
"2021","Bridgend 007","W02000224",5263,3054,2220,2192,28,8,826,792,34,2209,1321,35,100,423,330
"2021","Bridgend 008","W02000225",7150,4018,2993,2975,18,9,1016,970,46,3132,1879,43,119,578,513
"2021","Bridgend 009","W02000226",8263,5159,4071,4057,14,9,1079,1027,52,3104,1799,53,141,552,559
"2021","Bridgend 010","W02000227",5850,3306,2414,2404,10,6,886,852,34,2544,1531,39,109,482,383
"2021","Bridgend 011","W02000228",8310,5750,3938,3898,40,8,1804,1714,90,2560,1542,55,137,442,384
"2021","Bridgend 012","W02000229",5011,2814,2095,2087,8,3,716,674,42,2197,1193,43,119,495,347
"2021","Bridgend 013","W02000230",4663,3218,2607,2587,20,11,600,576,24,1445,826,37,49,229,304
"2021","Bridgend 014","W02000231",6803,3534,2486,2472,14,4,1044,980,64,3269,1861,86,166,694,462
"2021","Bridgend 015","W02000232",4701,2981,2273,2251,22,5,703,668,35,1720,1055,24,66,330,245
"2021","Bridgend 016","W02000233",4914,2828,2129,2119,10,1,698,672,26,2086,1257,38,101,447,243
"2021","Bridgend 017","W02000234",8450,5377,4356,4326,30,3,1018,956,62,3073,1860,54,143,580,436
"2021","Bridgend 018","W02000235",7746,4779,3958,3938,20,5,816,774,42,2967,1438,68,107,600,754
"2021","Bridgend 019","W02000236",5948,3522,2812,2790,22,0,710,672,38,2426,1276,40,94,528,488
"2021","Vale of Glamorgan 001","W02000237",5065,3580,3083,3061,22,1,496,468,28,1485,866,23,47,245,304
"2021","Vale of Glamorgan 002","W02000238",5390,3606,3185,3159,26,2,419,397,22,1784,859,38,81,322,484
"2021","Vale of Glamorgan 003","W02000239",6649,4672,3887,3851,36,7,778,732,46,1977,1201,44,59,302,371
"2021","Vale of Glamorgan 004","W02000240",7116,4262,3332,3294,38,10,920,860,60,2854,1730,54,106,509,455
"2021","Vale of Glamorgan 005","W02000241",8213,4826,3639,3579,60,9,1178,1082,96,3387,1845,87,147,805,503
"2021","Vale of Glamorgan 006","W02000242",6756,4360,3536,3494,42,0,824,782,42,2396,1270,53,90,414,569
"2021","Vale of Glamorgan 007","W02000243",7129,3672,2593,2555,38,3,1076,1026,50,3457,2232,52,146,570,457
"2021","Vale of Glamorgan 008","W02000244",8151,5206,4313,4293,20,7,886,838,48,2945,1592,77,117,561,598
"2021","Vale of Glamorgan 009","W02000245",6614,3736,2758,2734,24,10,968,948,20,2878,1819,58,149,536,316
"2021","Vale of Glamorgan 010","W02000246",4596,3047,2615,2603,12,3,429,419,10,1549,839,30,62,270,348
"2021","Vale of Glamorgan 011","W02000247",7059,4340,3490,3470,20,8,842,806,36,2719,1436,55,114,512,602
"2021","Vale of Glamorgan 012","W02000248",8345,4260,2836,2804,32,10,1414,1320,94,4085,2635,55,203,736,456
"2021","Vale of Glamorgan 013","W02000249",6823,3598,2448,2422,26,6,1144,1088,56,3225,1942,59,140,688,396
"2021","Vale of Glamorgan 014","W02000250",9022,5806,4404,4372,32,10,1392,1330,62,3216,1913,72,144,611,476
"2021","Vale of Glamorgan 015","W02000251",8911,5057,3489,3423,66,6,1562,1450,112,3854,2272,70,232,764,516
"2021","Cardiff 001","W02000367",5025,3424,2945,2927,18,5,474,450,24,1601,971,30,50,242,308
"2021","Cardiff 002","W02000368",4717,2980,2320,2300,20,4,656,632,24,1737,1116,28,54,334,205
"2021","Cardiff 003","W02000369",7704,4940,3582,3538,44,10,1348,1274,74,2764,1973,103,92,417,179
"2021","Cardiff 004","W02000370",5471,3493,3009,2983,26,3,481,443,38,1978,1023,36,61,320,538
"2021","Cardiff 005","W02000371",7268,3912,2966,2930,36,8,938,898,40,3356,1999,82,145,577,553
"2021","Cardiff 006","W02000372",6548,4432,3650,3630,20,6,776,728,48,2116,1288,27,110,351,340
"2021","Cardiff 007","W02000373",5336,2620,1944,1928,16,6,670,640,30,2716,1894,35,110,405,272
"2021","Cardiff 008","W02000374",4695,3098,2733,2723,10,3,362,346,16,1597,948,50,44,231,324
"2021","Cardiff 009","W02000375",5380,2696,1946,1926,20,4,746,714,32,2684,1828,81,117,434,224
"2021","Cardiff 010","W02000376",5340,3085,2402,2382,20,0,683,648,35,2255,1351,46,82,414,362
"2021","Cardiff 011","W02000377",5933,3455,2422,2408,14,9,1024,952,72,2478,1601,47,122,473,235
"2021","Cardiff 012","W02000378",6048,3912,3249,3238,11,1,662,632,30,2136,1260,34,67,367,408
"2021","Cardiff 013","W02000379",4652,2057,1388,1378,10,11,658,608,50,2595,1770,47,124,455,199
"2021","Cardiff 014","W02000380",6453,4437,3627,3592,35,4,806,760,46,2016,1265,37,65,353,296
"2021","Cardiff 015","W02000381",5100,2618,1844,1828,16,6,768,730,38,2482,1501,62,131,405,383
"2021","Cardiff 016","W02000382",4411,1944,1406,1398,8,0,538,526,12,2467,1702,40,100,377,248
"2021","Cardiff 017","W02000383",5709,2783,2072,2064,8,9,702,674,28,2926,1878,57,155,482,354
"2021","Cardiff 018","W02000384",4622,3164,2609,2597,12,3,552,524,28,1458,905,33,48,198,274
"2021","Cardiff 019","W02000385",4888,3169,2784,2772,12,4,381,353,28,1719,1035,79,46,259,300
"2021","Cardiff 020","W02000386",6173,3989,3335,3308,27,8,646,608,38,2184,1273,30,85,362,434
"2021","Cardiff 021","W02000387",4607,2920,2305,2290,15,1,614,580,34,1687,994,36,66,269,322
"2021","Cardiff 022","W02000388",4726,2793,2181,2159,22,6,606,566,40,1933,1200,46,70,292,325
"2021","Cardiff 023","W02000389",6653,3516,2541,2503,38,9,966,908,58,3137,2029,75,114,579,340
"2021","Cardiff 024","W02000390",4688,2969,2551,2538,13,2,416,392,24,1719,978,78,47,245,371
"2021","Cardiff 025","W02000391",5365,2324,1566,1538,28,2,756,704,52,3041,2500,72,68,264,137
"2021","Cardiff 026","W02000392",6948,4394,3506,3484,22,6,882,826,56,2554,1485,59,87,455,468
"2021","Cardiff 027","W02000393",5164,2588,1746,1736,10,2,840,802,38,2576,1692,64,88,449,283
"2021","Cardiff 028","W02000394",8451,1583,847,839,8,3,733,656,77,6868,6483,87,25,171,102
"2021","Cardiff 029","W02000395",5331,3097,2269,2249,20,4,824,742,82,2234,1502,55,72,331,274
"2021","Cardiff 030","W02000396",6455,2458,1367,1347,20,7,1084,1004,80,3997,3362,110,85,251,189
"2021","Cardiff 031","W02000397",5257,2668,1976,1956,20,12,680,624,56,2589,1582,23,113,479,392
"2021","Cardiff 032","W02000398",8746,1423,712,700,12,0,711,637,74,7323,6882,141,37,171,92
"2021","Cardiff 033","W02000399",8906,3141,1563,1532,31,4,1574,1428,146,5765,4886,113,118,427,221
"2021","Cardiff 034","W02000400",5418,2924,1810,1752,58,0,1114,1032,82,2494,1795,49,111,367,172
"2021","Cardiff 035","W02000401",4860,2897,1974,1936,38,3,920,846,74,1963,1285,34,73,324,247
"2021","Cardiff 036","W02000402",7486,3024,1826,1798,28,4,1194,1058,136,4462,3439,198,150,457,218
"2021","Cardiff 037","W02000403",5895,2757,1779,1747,32,9,969,911,58,3138,2199,114,148,424,253
"2021","Cardiff 038","W02000404",5087,2239,1307,1267,40,6,926,864,62,2848,2048,96,106,372,226
"2021","Cardiff 039","W02000405",5361,2226,1493,1479,14,1,732,686,46,3135,2254,49,158,425,249
"2021","Cardiff 040","W02000406",8037,4294,2695,2639,56,9,1590,1452,138,3743,2697,86,150,511,299
"2021","Cardiff 041","W02000407",4864,2269,1617,1615,2,5,647,612,35,2595,1731,51,156,389,268
"2021","Cardiff 042","W02000408",5773,2514,1765,1753,12,9,740,626,114,3259,2336,202,144,369,208
"2021","Cardiff 043","W02000409",4690,2388,1723,1707,16,5,660,632,28,2302,1528,31,104,356,283
"2021","Cardiff 044","W02000410",6408,3053,2217,2193,24,15,821,752,69,3355,2472,175,143,333,232
"2021","Cardiff 045","W02000411",5061,2411,1637,1631,6,8,766,748,18,2650,1786,37,108,409,310
"2021","Cardiff 046","W02000412",5311,2586,1812,1796,16,6,768,702,66,2725,1891,120,91,370,253
"2021","Cardiff 048","W02000422",6657,3308,1538,1480,58,6,1764,1578,186,3349,2705,100,104,348,92
"2021","Cardiff 049","W02000423",7325,3282,1752,1714,38,10,1520,1354,166,4043,3054,137,146,452,254
"2021","Rhondda Cynon Taf 001","W02000252",7338,4185,3168,3122,46,9,1008,960,48,3153,1983,53,141,470,506
"2021","Rhondda Cynon Taf 002","W02000253",5539,3074,2232,2188,44,4,838,804,34,2465,1535,42,104,437,347
"2021","Rhondda Cynon Taf 003","W02000254",6480,3846,2866,2844,22,0,980,934,46,2634,1606,35,99,455,439
"2021","Rhondda Cynon Taf 004","W02000255",5654,3394,2662,2650,12,4,728,696,32,2260,1390,27,93,388,362
"2021","Rhondda Cynon Taf 005","W02000256",7990,4408,3053,3023,30,5,1350,1304,46,3582,2221,54,158,578,571
"2021","Rhondda Cynon Taf 006","W02000257",5947,3258,2348,2322,26,4,906,876,30,2689,1657,58,100,457,417
"2021","Rhondda Cynon Taf 007","W02000258",4597,2361,1721,1706,15,2,638,616,22,2236,1283,34,99,432,388
"2021","Rhondda Cynon Taf 008","W02000259",4476,2358,1659,1653,6,5,694,666,28,2118,1382,36,107,317,276
"2021","Rhondda Cynon Taf 009","W02000260",4688,2426,1762,1754,8,2,662,640,22,2262,1392,42,77,354,397
"2021","Rhondda Cynon Taf 010","W02000261",6279,3543,2539,2513,26,0,1004,960,44,2736,1678,41,118,445,454
"2021","Rhondda Cynon Taf 011","W02000262",4262,2376,1686,1674,12,2,688,634,54,1886,1134,45,89,324,294
"2021","Rhondda Cynon Taf 012","W02000263",5109,2736,1946,1936,10,10,780,746,34,2373,1509,39,90,401,334
"2021","Rhondda Cynon Taf 013","W02000264",4571,2292,1540,1520,20,2,750,702,48,2279,1509,29,96,326,319
"2021","Rhondda Cynon Taf 014","W02000265",7416,4034,2836,2814,22,6,1192,1132,60,3382,2205,61,132,486,498
"2021","Rhondda Cynon Taf 015","W02000266",6000,3351,2469,2462,7,4,878,846,32,2649,1705,37,104,400,403
"2021","Rhondda Cynon Taf 016","W02000267",5098,2746,1900,1890,10,0,846,810,36,2352,1519,48,87,328,370
"2021","Rhondda Cynon Taf 017","W02000268",7349,4048,2895,2879,16,5,1148,1094,54,3301,2034,44,132,565,526
"2021","Rhondda Cynon Taf 018","W02000269",6641,3607,2602,2586,16,3,1002,968,34,3034,1901,60,111,507,455
"2021","Rhondda Cynon Taf 019","W02000270",5387,3174,2286,2274,12,0,888,836,52,2213,1375,37,89,390,322
"2021","Rhondda Cynon Taf 020","W02000271",4413,2375,1664,1649,15,1,710,668,42,2038,1239,30,70,360,339
"2021","Rhondda Cynon Taf 021","W02000272",8161,4724,3331,3287,44,9,1384,1310,74,3437,2120,49,149,608,511
"2021","Rhondda Cynon Taf 022","W02000273",8072,3419,2207,2184,23,4,1208,1134,74,4653,3514,110,132,532,365
"2021","Rhondda Cynon Taf 023","W02000274",8140,4843,3562,3546,16,7,1274,1216,58,3297,2103,62,138,501,493
"2021","Rhondda Cynon Taf 024","W02000275",4971,2826,2086,2074,12,8,732,700,32,2145,1350,37,77,402,279
"2021","Rhondda Cynon Taf 025","W02000276",5276,3290,2520,2518,2,0,770,746,24,1986,1100,37,82,322,445
"2021","Rhondda Cynon Taf 026","W02000277",5719,3264,2334,2310,24,8,922,886,36,2455,1446,39,114,477,379
"2021","Rhondda Cynon Taf 027","W02000278",7233,4902,3868,3848,20,6,1028,1000,28,2331,1420,38,100,386,387
"2021","Rhondda Cynon Taf 028","W02000279",6234,3784,2741,2717,24,9,1034,984,50,2450,1490,44,105,438,373
"2021","Rhondda Cynon Taf 029","W02000280",7555,5016,3671,3637,34,5,1340,1276,64,2539,1620,47,111,427,334
"2021","Rhondda Cynon Taf 030","W02000281",6097,3820,3014,2992,22,4,802,764,38,2277,1299,44,79,463,392
"2021","Rhondda Cynon Taf 031","W02000282",9118,5956,4663,4629,34,9,1284,1226,58,3162,1827,57,148,590,540
"2021","Caerphilly 001","W02000290",6981,3652,2549,2535,14,7,1096,1052,44,3329,2042,56,145,561,525
"2021","Caerphilly 002","W02000291",5729,3057,2170,2158,12,3,884,824,60,2672,1695,42,107,438,390
"2021","Caerphilly 003","W02000292",4633,2534,1798,1784,14,2,734,700,34,2099,1299,43,87,358,312
"2021","Caerphilly 004","W02000293",4817,2518,1793,1783,10,7,718,682,36,2299,1431,35,109,407,317
"2021","Caerphilly 005","W02000294",4643,2875,2195,2181,14,0,680,650,30,1768,1089,27,70,286,296
"2021","Caerphilly 006","W02000295",7601,4780,3667,3655,12,1,1112,1066,46,2821,1715,35,121,475,475
"2021","Caerphilly 007","W02000296",6033,3342,2488,2478,10,6,848,810,38,2691,1632,45,97,470,447
"2021","Caerphilly 008","W02000297",6194,3666,2800,2778,22,6,860,826,34,2528,1541,50,95,427,415
"2021","Caerphilly 009","W02000298",5830,3584,2646,2634,12,4,934,886,48,2246,1394,29,101,367,355
"2021","Caerphilly 010","W02000299",5099,3010,2299,2279,20,1,710,678,32,2089,1251,31,79,366,362
"2021","Caerphilly 011","W02000300",6821,4104,3034,3022,12,8,1062,1022,40,2717,1625,43,115,468,466
"2021","Caerphilly 012","W02000301",6382,3892,2823,2811,12,3,1066,1032,34,2490,1598,43,103,397,349
"2021","Caerphilly 013","W02000302",8091,4890,3736,3716,20,6,1148,1116,32,3201,1873,63,105,588,572
"2021","Caerphilly 014","W02000303",5788,3517,2522,2502,20,0,995,950,45,2271,1372,32,114,415,338
"2021","Caerphilly 015","W02000304",4501,2663,1933,1911,22,3,727,686,41,1838,1090,39,90,334,285
"2021","Caerphilly 016","W02000305",5032,2863,2116,2104,12,8,739,712,27,2169,1339,34,88,373,335
"2021","Caerphilly 017","W02000306",4246,2376,1753,1745,8,3,620,580,40,1870,1099,29,71,349,322
"2021","Caerphilly 018","W02000307",5066,2796,1901,1891,10,3,892,834,58,2270,1467,24,109,396,274
"2021","Caerphilly 019","W02000308",7106,4004,2980,2962,18,12,1012,960,52,3102,1906,52,113,573,458
"2021","Caerphilly 020","W02000309",5524,3274,2537,2523,14,3,734,702,32,2250,1321,39,90,385,415
"2021","Caerphilly 021","W02000310",4217,2584,1982,1960,22,10,592,550,42,1633,1000,30,65,275,263
"2021","Caerphilly 022","W02000311",7847,4404,3252,3232,20,10,1142,1076,66,3443,2065,50,126,723,479
"2021","Caerphilly 023","W02000312",5963,3498,2663,2647,16,5,830,802,28,2465,1437,37,84,471,436
"2021","Caerphilly 024","W02000313",8450,5466,4138,4110,28,6,1322,1254,68,2984,1769,47,134,538,496
"2021","Blaenau Gwent 001","W02000314",5389,3132,2358,2350,8,0,774,740,34,2257,1343,41,85,379,409
"2021","Blaenau Gwent 002","W02000315",4263,2306,1656,1636,20,2,648,622,26,1957,1158,37,91,374,297
"2021","Blaenau Gwent 003","W02000316",5508,3102,2316,2302,14,6,780,758,22,2406,1455,40,122,366,423
"2021","Blaenau Gwent 004","W02000317",6375,3585,2567,2555,12,5,1013,972,41,2790,1679,42,124,500,445
"2021","Blaenau Gwent 005","W02000318",7383,4178,3027,3015,12,3,1148,1086,62,3205,1912,54,155,533,551
"2021","Blaenau Gwent 006","W02000319",6641,3570,2512,2496,16,0,1058,1024,34,3071,1862,60,135,565,449
"2021","Blaenau Gwent 007","W02000320",6686,3728,2534,2520,14,8,1186,1122,64,2958,1818,46,139,528,427
"2021","Blaenau Gwent 008","W02000321",7032,3878,2846,2832,14,4,1028,982,46,3154,1904,44,134,554,518
"2021","Blaenau Gwent 009","W02000322",5531,2952,2045,2029,16,1,906,858,48,2579,1566,57,116,467,373
"2021","Torfaen 001","W02000323",4795,2734,1867,1851,16,7,860,798,62,2061,1264,33,86,331,347
"2021","Torfaen 002","W02000324",5582,3209,2226,2220,6,4,979,911,68,2373,1414,44,107,397,411
"2021","Torfaen 003","W02000325",5679,3138,2148,2138,10,4,986,940,46,2541,1638,38,129,385,351
"2021","Torfaen 004","W02000326",7196,4062,2922,2896,26,6,1134,1078,56,3134,1871,52,160,578,473
"2021","Torfaen 005","W02000327",5009,3233,2613,2593,20,5,615,572,43,1776,949,29,62,351,385
"2021","Torfaen 006","W02000328",6114,3790,2895,2869,26,7,888,844,44,2324,1399,40,93,426,366
"2021","Torfaen 007","W02000329",6541,3775,2724,2710,14,5,1046,976,70,2766,1653,35,106,559,413
"2021","Torfaen 008","W02000330",5901,3496,2692,2680,12,6,798,760,38,2405,1249,33,91,494,538
"2021","Torfaen 009","W02000331",4959,2648,1806,1792,14,0,842,804,38,2311,1471,25,101,426,288
"2021","Torfaen 010","W02000332",6080,3244,2219,2207,12,1,1024,964,60,2836,1657,35,109,592,443
"2021","Torfaen 011","W02000333",5059,3051,2347,2324,23,8,696,660,36,2008,1240,27,88,378,275
"2021","Torfaen 012","W02000334",5483,3506,2809,2795,14,3,694,670,24,1977,1173,34,70,392,308
"2021","Torfaen 013","W02000335",6156,4022,3117,3089,28,13,892,860,32,2134,1230,37,84,387,396
"2021","Monmouthshire 001","W02000336",7215,4410,3563,3535,28,3,844,798,46,2805,1427,82,126,606,564
"2021","Monmouthshire 002","W02000337",6215,3342,2497,2475,22,5,840,804,36,2873,1608,54,129,580,502
"2021","Monmouthshire 003","W02000338",7033,4656,3755,3725,30,5,896,858,38,2377,1309,52,99,393,524
"2021","Monmouthshire 004","W02000339",8975,5334,4215,4199,16,5,1114,1084,30,3641,1886,86,165,786,718
"2021","Monmouthshire 005","W02000340",6021,4158,3495,3474,21,6,657,640,17,1863,1002,57,80,312,412
"2021","Monmouthshire 006","W02000341",6845,4588,3810,3786,24,6,772,730,42,2257,1222,59,95,398,483
"2021","Monmouthshire 007","W02000342",7789,5535,4663,4626,37,7,865,838,27,2254,1249,53,102,404,446
"2021","Monmouthshire 008","W02000343",6769,3698,2636,2610,26,2,1060,1018,42,3071,1716,58,145,697,455
"2021","Monmouthshire 009","W02000344",7100,4956,4063,4047,16,3,890,856,34,2144,1164,53,101,405,421
"2021","Monmouthshire 010","W02000345",6524,3866,2942,2926,16,2,922,912,10,2658,1476,54,116,522,490
"2021","Monmouthshire 011","W02000346",6404,4298,3462,3444,18,8,828,808,20,2106,1259,29,86,372,360
"2021","Newport 001","W02000347",6604,4120,3355,3335,20,1,764,732,32,2484,1392,47,104,493,448
"2021","Newport 002","W02000348",6243,3744,2888,2874,14,0,856,822,34,2499,1451,49,86,427,486
"2021","Newport 003","W02000349",6509,3164,2175,2149,26,7,982,940,42,3345,2234,75,129,491,416
"2021","Newport 004","W02000350",7989,5480,4204,4164,40,10,1266,1192,74,2509,1560,68,96,376,409
"2021","Newport 005","W02000351",4912,2742,2006,1994,12,2,734,692,42,2170,1316,40,94,396,324
"2021","Newport 006","W02000352",5332,2714,1839,1825,14,3,872,806,66,2618,1704,53,98,477,286
"2021","Newport 007","W02000353",5851,3241,2304,2288,16,8,929,904,25,2610,1655,94,128,414,319
"2021","Newport 008","W02000354",4812,2736,2095,2075,20,7,634,602,32,2076,1184,70,82,330,410
"2021","Newport 009","W02000355",8023,5516,4379,4365,14,9,1128,1078,50,2507,1539,49,92,376,451
"2021","Newport 010","W02000356",4016,1971,1361,1357,4,3,607,580,27,2045,1351,35,77,282,300
"2021","Newport 011","W02000357",6604,3668,2545,2523,22,7,1116,1046,70,2936,1882,143,134,508,269
"2021","Newport 012","W02000358",5372,3454,2793,2767,26,7,654,628,26,1918,1124,132,60,264,338
"2021","Newport 013","W02000359",9036,4791,3231,3191,40,15,1545,1450,95,4245,2901,246,214,576,308
"2021","Newport 014","W02000360",5702,2610,1735,1703,32,5,870,804,66,3092,2007,189,121,535,240
"2021","Newport 015","W02000361",9112,4905,3435,3415,20,20,1450,1392,58,4207,2777,106,240,524,560
"2021","Newport 016","W02000362",5618,3516,2752,2732,20,2,762,732,30,2102,1205,30,89,418,360
"2021","Newport 017","W02000363",4754,2658,1913,1901,12,5,740,684,56,2096,1243,39,78,372,364
"2021","Newport 018","W02000364",6519,3203,2375,2353,22,15,813,765,48,3316,2154,218,177,497,270
"2021","Newport 019","W02000365",6421,3418,2379,2365,14,5,1034,978,56,3003,1981,55,133,521,313
"2021","Newport 020","W02000366",6634,4429,3563,3533,30,15,851,792,59,2205,1377,50,81,393,304
"2021","Powys 001","W02000097",7824,5076,4003,3961,42,7,1066,1034,32,2748,1554,78,98,470,548
"2021","Powys 002","W02000098",5311,3538,2822,2816,6,0,716,686,30,1773,980,42,73,298,380
"2021","Powys 003","W02000099",5380,2931,1972,1954,18,0,959,942,17,2449,1377,52,127,505,388
"2021","Powys 004","W02000100",5246,3286,2501,2481,20,7,778,728,50,1960,1152,52,65,346,345
"2021","Powys 005","W02000101",4705,3102,2422,2400,22,2,678,652,26,1603,865,53,59,288,338
"2021","Powys 006","W02000102",5194,3439,2711,2705,6,7,721,702,19,1755,1012,40,51,312,340
"2021","Powys 007","W02000103",4862,3334,2624,2600,24,4,706,690,16,1528,873,41,70,210,334
"2021","Powys 008","W02000104",5177,2948,2148,2130,18,4,796,772,24,2229,1262,51,107,444,365
"2021","Powys 009","W02000105",3884,2021,1338,1334,4,1,682,654,28,1863,1145,42,99,350,227
"2021","Powys 010","W02000106",5476,3480,2654,2648,6,6,820,800,20,1996,1053,57,115,367,404
"2021","Powys 011","W02000107",8419,5368,4228,4200,28,2,1138,1086,52,3051,1640,73,150,547,641
"2021","Powys 012","W02000108",6097,3936,3062,3050,12,8,866,834,32,2161,1134,48,108,377,494
"2021","Powys 013","W02000109",4670,2602,1892,1882,10,4,706,676,30,2068,1138,38,97,407,388
"2021","Powys 014","W02000110",5769,3590,2800,2776,24,0,790,766,24,2179,1202,54,125,394,404
"2021","Powys 015","W02000111",7177,4390,3318,3292,26,0,1072,1024,48,2787,1464,76,120,583,544
"2021","Powys 017","W02000113",6483,3694,2769,2759,10,3,922,892,30,2789,1502,72,129,577,509
"2021","Powys 018","W02000114",5920,3930,3296,3278,18,4,630,602,28,1990,1020,52,82,399,437
"2021","Powys 020","W02000414",5065,3472,2852,2816,36,2,618,592,26,1593,889,38,78,255,333
"2021","Powys 021","W02000416",8504,5014,3920,3902,18,2,1092,1032,60,3490,1930,86,152,626,696
"2021","Merthyr Tydfil 002","W02000284",7619,4166,2971,2955,16,11,1184,1136,48,3453,2198,42,162,531,520
"2021","Merthyr Tydfil 003","W02000285",6711,4122,3276,3262,14,6,840,800,40,2589,1567,57,101,435,429
"2021","Merthyr Tydfil 004","W02000286",5443,2585,1885,1871,14,3,697,662,35,2858,1797,52,126,523,360
"2021","Merthyr Tydfil 005","W02000287",6769,3876,2879,2863,16,7,990,958,32,2893,1791,50,106,462,484
"2021","Merthyr Tydfil 006","W02000288",6529,3567,2475,2464,11,4,1088,1038,50,2962,1801,62,131,482,486
"2021","Merthyr Tydfil 007","W02000289",7062,4318,3245,3219,26,1,1072,1028,44,2744,1708,51,122,432,431
"2021","Merthyr Tydfil 008","W02000415",7108,3470,2524,2522,2,10,936,894,42,3638,2446,77,154,516,445
