"date","geography","geography code","Sex: All persons; measures: Value","Sex: Female; measures: Value","Sex: Male; measures: Value"
"2021","Darlington","E06000005",107799,55129,52670
"2021","County Durham","E06000047",522068,266764,255304
"2021","Hartlepool","E06000001",92338,47653,44685
"2021","Middlesbrough","E06000002",143924,73040,70884
"2021","Northumberland","E06000057",320567,163989,156578
"2021","Redcar and Cleveland","E06000003",136531,70446,66085
"2021","Stockton-on-Tees","E06000004",196595,100072,96523
"2021","Gateshead","E08000037",196151,99952,96199
"2021","Newcastle upon Tyne","E08000021",300125,151802,148323
"2021","North Tyneside","E08000022",208967,107630,101337
"2021","South Tyneside","E08000023",147776,76062,71714
"2021","Sunderland","E08000024",274171,141078,133093
"2021","Blackburn with Darwen","E06000008",154739,78043,76696
"2021","Blackpool","E06000009",141036,71410,69626
"2021","Cheshire East","E06000049",398772,203195,195577
"2021","Cheshire West and Chester","E06000050",357150,182842,174308
"2021","Halton","E06000006",128478,65547,62931
"2021","Warrington","E06000007",210974,106529,104445
"2021","Cumbria","E10000006",499846,253704,246142
"2021","Bolton","E08000001",295963,150056,145907
"2021","Bury","E08000002",193851,98741,95110
"2021","Manchester","E08000003",551938,277877,274061
"2021","Oldham","E08000004",242089,123766,118323
"2021","Rochdale","E08000005",223773,114055,109718
"2021","Salford","E08000006",269923,134389,135534
"2021","Stockport","E08000007",294773,151373,143400
"2021","Tameside","E08000008",231073,117797,113276
"2021","Trafford","E08000009",235052,120644,114408
"2021","Wigan","E08000010",329330,166333,162997
"2021","Lancashire","E10000017",1235354,628381,606973
"2021","Knowsley","E08000011",154517,80668,73849
"2021","Liverpool","E08000012",486088,249460,236628
"2021","Sefton","E08000014",279233,143990,135243
"2021","St. Helens","E08000013",183248,93334,89914
"2021","Wirral","E08000015",320199,165122,155077
"2021","East Riding of Yorkshire","E06000011",342215,174368,167847
"2021","Kingston upon Hull, City of","E06000010",267014,133781,133233
"2021","North East Lincolnshire","E06000012",156966,80154,76812
"2021","North Lincolnshire","E06000013",169680,85970,83710
"2021","York","E06000014",202821,105298,97523
"2021","North Yorkshire","E10000023",615491,313811,301680
"2021","Barnsley","E08000016",244572,124293,120279
"2021","Doncaster","E08000017",308106,155280,152826
"2021","Rotherham","E08000018",265807,135547,130260
"2021","Sheffield","E08000019",556521,282327,274194
"2021","Bradford","E08000032",546412,278968,267444
"2021","Calderdale","E08000033",206631,105901,100730
"2021","Kirklees","E08000034",433216,220870,212346
"2021","Leeds","E08000035",811953,415579,396374
"2021","Wakefield","E08000036",353370,179539,173831
"2021","Derby","E06000015",261364,131854,129510
"2021","Leicester","E06000016",368572,186460,182112
"2021","Nottingham","E06000018",323632,164628,159004
"2021","Rutland","E06000017",41049,19977,21072
"2021","Derbyshire","E10000007",794636,404853,389783
"2021","Leicestershire","E10000018",712366,360613,351753
"2021","Lincolnshire","E10000019",768364,391934,376430
"2021","Nottinghamshire","E10000024",824822,420034,404788
"2021","North Northamptonshire","E06000061",359522,182452,177070
"2021","West Northamptonshire","E06000062",425725,215060,210665
"2021","Herefordshire, County of","E06000019",187034,95180,91854
"2021","Shropshire","E06000051",323606,163923,159683
"2021","Stoke-on-Trent","E06000021",258369,129893,128476
"2021","Telford and Wrekin","E06000020",185541,94206,91335
"2021","Staffordshire","E10000028",876104,442702,433402
"2021","Warwickshire","E10000031",596773,302775,293998
"2021","Birmingham","E08000025",1144919,584496,560423
"2021","Coventry","E08000026",345324,173137,172187
"2021","Dudley","E08000027",323488,164471,159017
"2021","Sandwell","E08000028",341832,173577,168255
"2021","Solihull","E08000029",216240,111280,104960
"2021","Walsall","E08000030",284124,145467,138657
"2021","Wolverhampton","E08000031",263727,134175,129552
"2021","Worcestershire","E10000034",603676,307911,295765
"2021","Bedford","E06000055",185225,94101,91124
"2021","Central Bedfordshire","E06000056",294252,149123,145129
"2021","Luton","E06000032",225262,112438,112824
"2021","Peterborough","E06000031",215673,109067,106606
"2021","Southend-on-Sea","E06000033",180686,92773,87913
"2021","Thurrock","E06000034",176000,89787,86213
"2021","Cambridgeshire","E10000003",678849,343381,335468
"2021","Essex","E10000012",1503521,771189,732332
"2021","Hertfordshire","E10000015",1198798,613393,585405
"2021","Norfolk","E10000020",916120,466869,449251
"2021","Suffolk","E10000029",760688,385976,374712
"2021","Camden","E09000007",210136,110652,99484
"2021","City of London","E09000001",8583,3861,4722
"2021","Hackney","E09000012",259146,135303,123843
"2021","Hammersmith and Fulham","E09000013",183157,97214,85943
"2021","Haringey","E09000014",264238,136994,127244
"2021","Islington","E09000019",216589,113291,103298
"2021","Kensington and Chelsea","E09000020",143375,76312,67063
"2021","Lambeth","E09000022",317654,163713,153941
"2021","Lewisham","E09000023",300553,157820,142733
"2021","Newham","E09000025",351036,175723,175313
"2021","Southwark","E09000028",307637,158633,149004
"2021","Tower Hamlets","E09000030",310306,154437,155869
"2021","Wandsworth","E09000032",327506,172253,155253
"2021","Westminster","E09000033",204236,105327,98909
"2021","Barking and Dagenham","E09000002",218869,112288,106581
"2021","Barnet","E09000003",389344,200799,188545
"2021","Bexley","E09000004",246472,127970,118502
"2021","Brent","E09000005",339816,173121,166695
"2021","Bromley","E09000006",329991,171733,158258
"2021","Croydon","E09000008",390719,203086,187633
"2021","Ealing","E09000009",367115,186205,180910
"2021","Enfield","E09000010",329984,172473,157511
"2021","Greenwich","E09000011",289068,148570,140498
"2021","Harrow","E09000015",261203,132406,128797
"2021","Havering","E09000016",262052,135668,126384
"2021","Hillingdon","E09000017",305909,154860,151049
"2021","Hounslow","E09000018",288181,144979,143202
"2021","Kingston upon Thames","E09000021",168063,87047,81016
"2021","Merton","E09000024",215187,110531,104656
"2021","Redbridge","E09000026",310260,156929,153331
"2021","Richmond upon Thames","E09000027",195278,101317,93961
"2021","Sutton","E09000029",209639,108156,101483
"2021","Waltham Forest","E09000031",278425,141951,136474
"2021","Bracknell Forest","E06000036",124607,63163,61444
"2021","Brighton and Hove","E06000043",277103,141540,135563
"2021","Isle of Wight","E06000046",140459,72370,68089
"2021","Medway","E06000035",279773,142646,137127
"2021","Milton Keynes","E06000042",287060,145486,141574
"2021","Portsmouth","E06000044",208003,104840,103163
"2021","Reading","E06000038",174224,87382,86842
"2021","Slough","E06000039",158500,80005,78495
"2021","Southampton","E06000045",248922,123953,124969
"2021","West Berkshire","E06000037",161447,81746,79701
"2021","Windsor and Maidenhead","E06000040",153496,78080,75416
"2021","Wokingham","E06000041",177502,90281,87221
"2021","Buckinghamshire","E06000060",553078,282683,270395
"2021","East Sussex","E10000011",545847,283700,262147
"2021","Hampshire","E10000014",1400899,716116,684783
"2021","Kent","E10000016",1576069,807683,768386
"2021","Oxfordshire","E10000025",725291,367126,358165
"2021","Surrey","E10000030",1203108,616067,587041
"2021","West Sussex","E10000032",882676,453958,428718
"2021","Bath and North East Somerset","E06000022",193409,99019,94390
"2021","Bristol, City of","E06000023",472465,237942,234523
"2021","Cornwall","E06000052",570305,293685,276620
"2021","Isles of Scilly","E06000053",2054,1050,1004
"2021","North Somerset","E06000024",216728,111422,105306
"2021","Plymouth","E06000026",264695,134784,129911
"2021","Bournemouth, Christchurch and Poole","E06000058",400196,204826,195370
"2021","South Gloucestershire","E06000025",290424,146655,143769
"2021","Swindon","E06000030",233410,117347,116063
"2021","Torbay","E06000027",139324,71493,67831
"2021","Wiltshire","E06000054",510330,258626,251704
"2021","Devon","E10000008",811640,417600,394040
"2021","Dorset","E06000059",379579,195166,184413
"2021","Gloucestershire","E10000013",645076,329832,315244
"2021","Somerset","E10000027",571547,292100,279447
"2021","Isle of Anglesey","W06000001",68878,35219,33659
"2021","Gwynedd","W06000002",117393,59868,57525
"2021","Conwy","W06000003",114741,59156,55585
"2021","Denbighshire","W06000004",95818,49209,46609
"2021","Flintshire","W06000005",154962,79059,75903
"2021","Wrexham","W06000006",135117,68241,66876
"2021","Powys","W06000023",133169,67467,65702
"2021","Ceredigion","W06000008",71475,36512,34963
"2021","Pembrokeshire","W06000009",123360,63289,60071
"2021","Carmarthenshire","W06000010",187897,96212,91685
"2021","Swansea","W06000011",238490,120966,117524
"2021","Neath Port Talbot","W06000012",142289,72410,69879
"2021","Bridgend","W06000013",145488,73625,71863
"2021","Vale of Glamorgan","W06000014",131939,68345,63594
"2021","Cardiff","W06000015",362310,185460,176850
"2021","Rhondda Cynon Taff","W06000016",237651,121321,116330
"2021","Merthyr Tydfil","W06000024",58839,30086,28753
"2021","Caerphilly","W06000018",175952,89987,85965
"2021","Blaenau Gwent","W06000019",66904,34065,32839
"2021","Torfaen","W06000020",92276,47409,44867
"2021","Monmouthshire","W06000021",92957,47417,45540
"2021","Newport","W06000022",159587,81166,78421
