date,geography,geography code,Provision of unpaid care: Total: All usual residents aged 5 and over,Provision of unpaid care: Provides no unpaid care,Provision of unpaid care: Provides 19 hours or less unpaid care a week,Provision of unpaid care: Provides 9 hours or less unpaid care a week,Provision of unpaid care: Provides 10 to 19 hours unpaid care a week,Provision of unpaid care: Provides 20 to 49 hours unpaid care a week,Provision of unpaid care: Provides 20 to 34 hours unpaid care a week,Provision of unpaid care: Provides 35 to 49 hours unpaid care a week,Provision of unpaid care: Provides 50 or more hours unpaid care a week
2021,City of London 001,E02000001,8372,7876,336,263,73,81,42,39,79
2021,Barking and Dagenham 001,E02000002,7628,7072,198,126,72,168,67,101,190
2021,Barking and Dagenham 002,E02000003,10588,9855,327,220,107,178,94,84,228
2021,Barking and Dagenham 003,E02000004,6245,5719,260,163,97,99,50,49,167
2021,Barking and Dagenham 004,E02000005,10108,9419,283,182,101,160,72,88,246
2021,Barking and Dagenham 006,E02000007,9414,8725,282,182,100,186,93,93,221
2021,Barking and Dagenham 007,E02000008,12356,11376,346,222,124,264,118,146,370
2021,Barking and Dagenham 008,E02000009,11837,11000,343,232,111,233,104,129,261
2021,Barking and Dagenham 009,E02000010,8801,8089,252,150,102,213,82,131,247
2021,Barking and Dagenham 010,E02000011,6522,6063,192,129,63,134,62,72,133
2021,Barking and Dagenham 011,E02000012,10768,10025,340,226,114,192,101,91,211
2021,Barking and Dagenham 012,E02000013,8702,8038,256,171,85,181,80,101,227
2021,Barking and Dagenham 013,E02000014,9189,8474,260,164,96,205,84,121,250
2021,Barking and Dagenham 014,E02000015,7549,6981,220,135,85,190,103,87,158
2021,Barking and Dagenham 015,E02000016,9549,9102,168,103,65,153,57,96,126
2021,Barking and Dagenham 016,E02000017,8472,7923,237,132,105,163,84,79,149
2021,Barking and Dagenham 017,E02000018,8791,8175,197,130,67,195,78,117,224
2021,Barking and Dagenham 018,E02000019,8831,8181,199,123,76,196,89,107,255
2021,Barking and Dagenham 019,E02000020,12763,11974,277,191,86,213,100,113,299
2021,Barking and Dagenham 020,E02000021,8134,7556,215,134,81,162,76,86,201
2021,Barking and Dagenham 021,E02000022,6903,6504,162,105,57,126,54,72,111
2021,Barking and Dagenham 022,E02000023,7352,6865,172,97,75,145,60,85,170
2021,Barnet 001,E02000024,10278,9438,517,385,132,125,67,58,198
2021,Barnet 002,E02000025,8084,7423,398,303,95,102,45,57,161
2021,Barnet 003,E02000026,6049,5469,321,230,91,98,46,52,161
2021,Barnet 004,E02000027,9115,8275,399,268,131,193,78,115,248
2021,Barnet 005,E02000028,6153,5637,303,227,76,92,43,49,121
2021,Barnet 006,E02000029,8931,8153,434,326,108,142,69,73,202
2021,Barnet 007,E02000030,9026,8188,476,334,142,147,79,68,215
2021,Barnet 008,E02000031,7834,7244,329,241,88,117,57,60,144
2021,Barnet 009,E02000032,7635,6859,432,289,143,158,61,97,186
2021,Barnet 010,E02000033,8433,7690,378,274,104,158,66,92,207
2021,Barnet 011,E02000034,8565,7814,427,316,111,142,65,77,182
2021,Barnet 012,E02000035,8077,7506,317,239,78,112,50,62,142
2021,Barnet 013,E02000036,10533,9637,445,322,123,201,108,93,250
2021,Barnet 014,E02000037,10126,9228,504,356,148,157,83,74,237
2021,Barnet 015,E02000038,10185,9374,459,332,127,166,84,82,186
2021,Barnet 016,E02000039,6685,6152,305,228,77,94,55,39,134
2021,Barnet 017,E02000040,8553,7831,385,284,101,146,67,79,191
2021,Barnet 018,E02000041,8894,8156,372,273,99,185,87,98,181
2021,Barnet 019,E02000042,10895,10049,449,316,133,187,93,94,210
2021,Barnet 020,E02000043,7121,6505,376,269,107,112,58,54,128
2021,Barnet 021,E02000044,8281,7565,329,219,110,185,95,90,202
2021,Barnet 022,E02000045,9904,9130,392,264,128,163,84,79,219
2021,Barnet 023,E02000046,6503,6032,268,212,56,102,47,55,101
2021,Barnet 024,E02000047,11528,10698,333,221,112,219,97,122,278
2021,Barnet 025,E02000048,9587,8810,424,311,113,144,72,72,209
2021,Barnet 026,E02000049,9749,9114,257,159,98,185,86,99,193
2021,Barnet 027,E02000050,9820,8914,502,358,144,189,111,78,215
2021,Barnet 028,E02000051,8652,7970,389,290,99,136,66,70,157
2021,Barnet 029,E02000052,9283,8632,378,280,98,134,64,70,139
2021,Barnet 031,E02000054,7198,6671,309,230,79,121,53,68,97
2021,Barnet 032,E02000055,11030,10291,406,286,120,156,81,75,177
2021,Barnet 033,E02000056,8633,8036,381,302,79,111,58,53,105
2021,Barnet 034,E02000057,7342,6815,312,237,75,93,54,39,122
2021,Barnet 035,E02000058,9512,8818,448,349,99,100,54,46,146
2021,Barnet 036,E02000059,10885,10096,360,252,108,180,76,104,249
2021,Barnet 037,E02000060,10408,9600,459,354,105,161,79,82,188
2021,Barnet 038,E02000061,7934,7379,325,251,74,89,41,48,141
2021,Barnet 039,E02000062,6540,6038,207,144,63,142,63,79,153
2021,Barnet 040,E02000063,7142,6581,256,187,69,143,62,81,162
2021,Barnet 041,E02000064,6227,5741,284,200,84,89,46,43,113
2021,Bexley 001,E02000065,7516,6990,185,108,77,183,61,122,158
2021,Bexley 002,E02000066,8854,8206,257,160,97,176,75,101,215
2021,Bexley 003,E02000067,9467,8765,300,203,97,159,79,80,243
2021,Bexley 004,E02000068,7483,6939,238,147,91,148,61,87,158
2021,Bexley 005,E02000069,6712,6176,265,201,64,114,62,52,157
2021,Bexley 006,E02000070,7639,6914,335,215,120,169,68,101,221
2021,Bexley 007,E02000071,7218,6628,301,214,87,115,46,69,174
2021,Bexley 008,E02000072,11915,10997,351,241,110,236,95,141,331
2021,Bexley 009,E02000073,10139,9319,424,305,119,157,86,71,239
2021,Bexley 010,E02000074,8296,7548,315,217,98,173,65,108,260
2021,Bexley 011,E02000075,7614,6890,384,282,102,136,64,72,204
2021,Bexley 013,E02000077,7670,7026,318,232,86,123,53,70,203
2021,Bexley 014,E02000078,7435,6798,348,269,79,108,54,54,181
2021,Bexley 015,E02000079,8254,7590,345,245,100,144,70,74,175
2021,Bexley 016,E02000080,9505,8726,426,303,123,148,71,77,205
2021,Bexley 017,E02000081,7794,7146,320,225,95,140,78,62,188
2021,Bexley 018,E02000082,8774,8097,359,273,86,133,61,72,185
2021,Bexley 019,E02000083,10559,9595,426,324,102,223,113,110,315
2021,Bexley 020,E02000084,10483,9572,512,378,134,154,71,83,245
2021,Bexley 021,E02000085,7471,6887,318,236,82,115,49,66,151
2021,Bexley 022,E02000086,6822,6229,319,229,90,118,56,62,156
2021,Bexley 023,E02000087,7758,7063,377,268,109,116,61,55,202
2021,Bexley 024,E02000088,7306,6642,356,263,93,114,54,60,194
2021,Bexley 025,E02000089,7419,6803,331,248,83,101,50,51,184
2021,Bexley 026,E02000090,9152,8453,424,315,109,112,65,47,163
2021,Bexley 027,E02000091,9615,8787,441,323,118,143,72,71,244
2021,Bexley 028,E02000092,6325,5704,247,165,82,143,69,74,231
2021,Brent 001,E02000093,11205,10333,406,275,131,224,116,108,242
2021,Brent 002,E02000094,9807,9123,293,189,104,174,84,90,217
2021,Brent 003,E02000095,9896,9108,383,263,120,190,103,87,215
2021,Brent 004,E02000096,7192,6414,423,288,135,153,90,63,202
2021,Brent 005,E02000097,8976,8278,334,228,106,178,79,99,186
2021,Brent 006,E02000098,8305,7621,307,190,117,182,101,81,195
2021,Brent 007,E02000099,8831,8228,285,201,84,160,81,79,158
2021,Brent 008,E02000100,7964,7283,372,260,112,145,79,66,164
2021,Brent 009,E02000101,9370,8624,325,224,101,181,90,91,240
2021,Brent 010,E02000102,7711,7164,206,117,89,188,75,113,153
2021,Brent 011,E02000103,9322,8626,285,191,94,206,105,101,205
2021,Brent 012,E02000104,7144,6506,274,169,105,162,79,83,202
2021,Brent 013,E02000105,9168,8527,262,181,81,169,81,88,210
2021,Brent 014,E02000106,9717,9078,236,142,94,199,84,115,204
2021,Brent 015,E02000107,10355,9680,291,206,85,204,83,121,180
2021,Brent 016,E02000108,6825,6361,226,155,71,107,37,70,131
2021,Brent 018,E02000110,7725,7142,266,177,89,167,71,96,150
2021,Brent 019,E02000111,10587,9867,298,171,127,214,99,115,208
2021,Brent 020,E02000112,11141,10486,255,155,100,183,78,105,217
2021,Brent 021,E02000113,9129,8317,360,202,158,224,100,124,228
2021,Brent 022,E02000114,8530,7956,289,201,88,149,72,77,136
2021,Brent 023,E02000115,8204,7713,246,165,81,119,49,70,126
2021,Brent 024,E02000116,7938,7404,222,142,80,157,75,82,155
2021,Brent 025,E02000117,11905,10926,413,268,145,301,140,161,265
2021,Brent 026,E02000118,10678,10003,299,189,110,185,85,100,191
2021,Brent 027,E02000119,9866,9193,252,152,100,213,100,113,208
2021,Brent 028,E02000120,8540,8014,268,200,68,133,61,72,125
2021,Brent 029,E02000121,11462,10772,306,204,102,189,80,109,195
2021,Brent 030,E02000122,7760,7197,307,216,91,112,56,56,144
2021,Brent 031,E02000123,12757,11847,441,281,160,242,111,131,227
2021,Brent 032,E02000124,9285,8715,329,238,91,120,51,69,121
2021,Brent 033,E02000125,9299,8627,354,275,79,136,64,72,182
2021,Brent 034,E02000126,7757,7173,250,187,63,144,78,66,190
2021,Bromley 001,E02000127,8674,7875,357,251,106,186,81,105,256
2021,Bromley 002,E02000128,7268,6705,306,226,80,119,65,54,138
2021,Bromley 004,E02000130,7880,7357,304,218,86,88,40,48,131
2021,Bromley 005,E02000131,9705,9146,325,228,97,117,57,60,117
2021,Bromley 006,E02000132,9193,8562,373,305,68,119,52,67,139
2021,Bromley 007,E02000133,10193,9314,539,422,117,132,75,57,208
2021,Bromley 008,E02000134,10961,10199,420,342,78,159,66,93,183
2021,Bromley 009,E02000135,9259,8574,317,217,100,184,86,98,184
2021,Bromley 010,E02000136,5419,4909,228,178,50,114,55,59,168
2021,Bromley 011,E02000137,7906,7295,378,284,94,97,49,48,136
2021,Bromley 012,E02000138,8030,7449,373,292,81,74,41,33,134
2021,Bromley 013,E02000139,7187,6649,326,248,78,91,48,43,121
2021,Bromley 014,E02000140,8013,7290,280,201,79,176,75,101,267
2021,Bromley 015,E02000141,6707,6215,282,208,74,91,47,44,119
2021,Bromley 016,E02000142,8304,7707,366,268,98,99,54,45,132
2021,Bromley 018,E02000144,9422,8764,406,312,94,122,58,64,130
2021,Bromley 019,E02000145,8153,7463,307,209,98,150,55,95,233
2021,Bromley 020,E02000146,9037,8377,374,277,97,128,55,73,158
2021,Bromley 021,E02000147,7765,7142,376,301,75,92,48,44,155
2021,Bromley 022,E02000148,6359,5809,332,257,75,78,44,34,140
2021,Bromley 023,E02000149,7634,6919,332,238,94,143,64,79,240
2021,Bromley 024,E02000150,8123,7408,415,319,96,116,61,55,184
2021,Bromley 025,E02000151,7061,6451,395,306,89,85,50,35,130
2021,Bromley 026,E02000152,7427,6804,282,194,88,149,77,72,192
2021,Bromley 027,E02000153,7709,7053,402,291,111,96,47,49,158
2021,Bromley 028,E02000154,8039,7394,356,283,73,118,67,51,171
2021,Bromley 029,E02000155,6789,6101,332,242,90,139,66,73,217
2021,Bromley 030,E02000156,11738,10739,623,463,160,154,85,69,222
2021,Bromley 031,E02000157,7994,7268,466,371,95,108,47,61,152
2021,Bromley 032,E02000158,7310,6631,328,247,81,131,52,79,220
2021,Bromley 033,E02000159,6807,6214,345,259,86,98,50,48,150
2021,Bromley 034,E02000160,7768,7105,404,318,86,105,52,53,154
2021,Bromley 035,E02000161,8253,7620,375,278,97,116,54,62,142
2021,Bromley 036,E02000162,6825,6200,314,248,66,120,63,57,191
2021,Bromley 037,E02000163,7333,6635,395,305,90,122,59,63,181
2021,Bromley 039,E02000165,6766,6191,321,236,85,100,53,47,154
2021,Camden 001,E02000166,7417,6705,430,328,102,121,59,62,161
2021,Camden 002,E02000167,6852,6374,344,266,78,61,23,38,73
2021,Camden 003,E02000168,7463,6885,364,287,77,110,52,58,104
2021,Camden 004,E02000169,6728,6309,272,211,61,65,26,39,82
2021,Camden 005,E02000170,7500,7005,272,221,51,113,64,49,110
2021,Camden 006,E02000171,7036,6438,369,282,87,109,61,48,120
2021,Camden 007,E02000172,9474,8670,364,246,118,201,96,105,239
2021,Camden 008,E02000173,7028,6625,238,190,48,85,36,49,80
2021,Camden 009,E02000174,7716,7093,326,247,79,159,81,78,138
2021,Camden 010,E02000175,8638,8116,302,226,76,100,45,55,120
2021,Camden 011,E02000176,5577,5250,220,175,45,57,35,22,50
2021,Camden 012,E02000177,8058,7421,308,209,99,143,67,76,186
2021,Camden 013,E02000178,8425,7848,269,189,80,134,62,72,174
2021,Camden 014,E02000179,5466,5095,207,155,52,88,32,56,76
2021,Camden 015,E02000180,7550,6985,297,227,70,124,59,65,144
2021,Camden 016,E02000181,7615,7143,299,240,59,91,43,48,82
2021,Camden 017,E02000182,6660,6241,194,149,45,111,54,57,114
2021,Camden 018,E02000183,7202,6602,321,242,79,120,52,68,159
2021,Camden 019,E02000184,8535,7920,290,196,94,163,87,76,162
2021,Camden 020,E02000185,8415,7774,301,215,86,182,86,96,158
2021,Camden 021,E02000186,5992,5610,207,154,53,88,41,47,87
2021,Camden 022,E02000187,9285,8506,335,228,107,209,98,111,235
2021,Camden 023,E02000188,6825,6282,240,150,90,145,75,70,158
2021,Camden 026,E02000191,5227,4926,170,127,43,53,26,27,78
2021,Camden 027,E02000192,6407,5895,262,155,107,108,50,58,142
2021,Camden 028,E02000193,5806,5348,254,202,52,97,56,41,107
2021,Croydon 001,E02000194,8584,8078,277,194,83,120,54,66,109
2021,Croydon 002,E02000195,9076,8296,405,265,140,164,91,73,211
2021,Croydon 003,E02000196,7428,6832,308,213,95,123,55,68,165
2021,Croydon 004,E02000197,8549,7818,355,243,112,193,109,84,183
2021,Croydon 005,E02000198,8311,7708,300,204,96,155,73,82,148
2021,Croydon 006,E02000199,7903,7297,290,217,73,161,81,80,155
2021,Croydon 007,E02000200,8451,7810,346,260,86,143,65,78,152
2021,Croydon 008,E02000201,8091,7477,285,200,85,167,73,94,162
2021,Croydon 009,E02000202,8461,7829,278,190,88,151,69,82,203
2021,Croydon 010,E02000203,7425,6821,286,190,96,161,75,86,157
2021,Croydon 011,E02000204,9026,8254,347,201,146,221,100,121,204
2021,Croydon 013,E02000206,9982,9272,332,223,109,173,72,101,205
2021,Croydon 014,E02000207,8372,7679,307,226,81,201,79,122,185
2021,Croydon 015,E02000208,9942,9283,271,186,85,191,86,105,197
2021,Croydon 016,E02000209,8536,7857,314,206,108,168,88,80,197
2021,Croydon 017,E02000210,8146,7541,316,229,87,149,67,82,140
2021,Croydon 018,E02000211,7856,7147,395,305,90,123,65,58,191
2021,Croydon 019,E02000212,8781,8130,241,159,82,197,93,104,213
2021,Croydon 020,E02000213,11677,10939,290,198,92,244,101,143,204
2021,Croydon 021,E02000214,5844,5317,305,222,83,89,37,52,133
2021,Croydon 022,E02000215,10906,10208,351,259,92,145,66,79,202
2021,Croydon 023,E02000216,6702,6233,229,168,61,124,61,63,116
2021,Croydon 024,E02000217,10985,10280,343,236,107,173,77,96,189
2021,Croydon 025,E02000218,6300,5776,255,189,66,119,50,69,150
2021,Croydon 026,E02000219,7329,6575,424,319,105,142,72,70,188
2021,Croydon 028,E02000221,10159,9379,330,230,100,210,97,113,240
2021,Croydon 029,E02000222,7795,7190,376,293,83,106,51,55,123
2021,Croydon 030,E02000223,8016,7338,213,116,97,209,86,123,256
2021,Croydon 031,E02000224,7458,6938,310,223,87,87,44,43,123
2021,Croydon 032,E02000225,7084,6411,276,182,94,164,79,85,233
2021,Croydon 033,E02000226,7266,6556,383,273,110,136,64,72,191
2021,Croydon 034,E02000227,11000,10039,507,382,125,191,105,86,263
2021,Croydon 035,E02000228,7534,6876,401,306,95,103,55,48,154
2021,Croydon 036,E02000229,5866,5272,203,135,68,162,78,84,229
2021,Croydon 037,E02000230,9855,9067,433,326,107,160,84,76,195
2021,Croydon 038,E02000231,7542,6848,415,319,96,99,55,44,180
2021,Croydon 039,E02000232,5909,5328,302,229,73,105,57,48,174
2021,Croydon 040,E02000233,5951,5499,269,192,77,85,43,42,98
2021,Croydon 041,E02000234,8801,8102,363,268,95,135,63,72,201
2021,Croydon 042,E02000235,6499,5951,328,244,84,79,39,40,141
2021,Croydon 043,E02000236,8415,7762,359,265,94,132,70,62,162
2021,Croydon 044,E02000237,7140,6504,321,250,71,120,62,58,195
2021,Ealing 001,E02000238,10089,9426,316,227,89,162,65,97,185
2021,Ealing 002,E02000239,8592,7943,299,197,102,169,84,85,181
2021,Ealing 003,E02000240,10496,9705,327,193,134,214,83,131,250
2021,Ealing 004,E02000241,6957,6502,227,154,73,95,52,43,133
2021,Ealing 005,E02000242,6540,5993,254,157,97,144,61,83,149
2021,Ealing 006,E02000243,8250,7640,273,185,88,166,79,87,171
2021,Ealing 007,E02000244,7438,6922,250,164,86,130,67,63,136
2021,Ealing 008,E02000245,8503,7824,255,157,98,213,84,129,211
2021,Ealing 009,E02000246,8843,8221,238,140,98,165,80,85,219
2021,Ealing 010,E02000247,10429,9663,331,224,107,232,103,129,203
2021,Ealing 011,E02000248,7146,6642,243,173,70,133,65,68,128
2021,Ealing 012,E02000249,7865,7312,240,171,69,148,81,67,165
2021,Ealing 013,E02000250,6170,5737,266,212,54,71,36,35,96
2021,Ealing 014,E02000251,7864,7263,261,169,92,195,83,112,145
2021,Ealing 015,E02000252,11668,10913,349,245,104,207,89,118,199
2021,Ealing 016,E02000253,9714,8938,350,226,124,199,97,102,227
2021,Ealing 017,E02000254,8761,8008,315,186,129,215,118,97,223
2021,Ealing 018,E02000255,9288,8580,377,270,107,155,81,74,176
2021,Ealing 019,E02000256,8706,8127,368,281,87,102,53,49,109
2021,Ealing 021,E02000258,6503,6068,231,169,62,101,54,47,103
2021,Ealing 022,E02000259,6237,5738,263,193,70,98,32,66,138
2021,Ealing 023,E02000260,9319,8669,256,153,103,216,121,95,178
2021,Ealing 024,E02000261,11896,11126,353,237,116,198,99,99,219
2021,Ealing 025,E02000262,8776,8249,273,193,80,135,65,70,119
2021,Ealing 026,E02000263,12934,12014,355,219,136,273,139,134,292
2021,Ealing 027,E02000264,8119,7598,298,221,77,90,43,47,133
2021,Ealing 028,E02000265,10514,9780,399,317,82,146,73,73,189
2021,Ealing 029,E02000266,12279,11209,465,299,166,311,124,187,294
2021,Ealing 030,E02000267,7653,7155,274,197,77,104,42,62,120
2021,Ealing 031,E02000268,8779,8162,358,266,92,127,55,72,132
2021,Ealing 032,E02000269,7654,7157,328,228,100,87,54,33,82
2021,Ealing 033,E02000270,8906,8360,222,156,66,167,64,103,157
2021,Ealing 034,E02000271,6524,6131,262,217,45,56,28,28,75
2021,Ealing 035,E02000272,6383,5917,277,201,76,73,39,34,116
2021,Ealing 038,E02000275,7729,7129,261,154,107,160,77,83,179
2021,Ealing 039,E02000276,6339,5956,244,190,54,48,24,24,91
2021,Enfield 001,E02000277,7038,6423,276,186,90,147,59,88,192
2021,Enfield 002,E02000278,8860,8112,285,164,121,192,79,113,271
2021,Enfield 003,E02000279,11372,10438,370,259,111,262,118,144,302
2021,Enfield 004,E02000280,8049,7353,357,269,88,132,63,69,207
2021,Enfield 005,E02000281,8997,8280,353,240,113,182,69,113,182
2021,Enfield 006,E02000282,9170,8422,279,170,109,220,99,121,249
2021,Enfield 007,E02000283,8014,7399,261,179,82,158,76,82,196
2021,Enfield 008,E02000284,8138,7495,355,271,84,124,62,62,164
2021,Enfield 009,E02000285,6271,5693,327,251,76,109,59,50,142
2021,Enfield 010,E02000286,8190,7563,356,257,99,116,65,51,155
2021,Enfield 011,E02000287,6964,6357,330,250,80,113,56,57,164
2021,Enfield 012,E02000288,11896,10991,351,215,136,247,105,142,307
2021,Enfield 013,E02000289,6451,5831,347,237,110,107,62,45,166
2021,Enfield 014,E02000290,6136,5694,165,108,57,140,52,88,137
2021,Enfield 015,E02000291,9434,8709,393,280,113,151,71,80,181
2021,Enfield 016,E02000292,9198,8461,360,260,100,167,80,87,210
2021,Enfield 017,E02000293,6104,5540,328,235,93,100,58,42,136
2021,Enfield 018,E02000294,8843,8143,284,163,121,183,98,85,233
2021,Enfield 019,E02000295,8155,7548,319,230,89,143,76,67,145
2021,Enfield 020,E02000296,9719,9015,352,260,92,156,80,76,196
2021,Enfield 021,E02000297,8863,8049,429,308,121,136,68,68,249
2021,Enfield 022,E02000298,7790,7213,344,258,86,106,54,52,127
2021,Enfield 023,E02000299,8871,8193,240,169,71,210,101,109,228
2021,Enfield 024,E02000300,8181,7598,257,165,92,171,69,102,155
2021,Enfield 025,E02000301,9569,8858,285,169,116,192,87,105,234
2021,Enfield 026,E02000302,8176,7487,335,202,133,166,61,105,188
2021,Enfield 027,E02000303,7804,7176,232,156,76,185,87,98,211
2021,Enfield 028,E02000304,7620,6910,399,279,120,131,75,56,180
2021,Enfield 029,E02000305,8314,7746,332,245,87,115,57,58,121
2021,Enfield 030,E02000306,8463,7786,258,161,97,224,94,130,195
2021,Enfield 031,E02000307,9512,8766,310,216,94,205,107,98,231
2021,Enfield 032,E02000308,8227,7595,316,215,101,146,67,79,170
2021,Enfield 033,E02000309,10920,10185,300,204,96,216,75,141,219
2021,Enfield 035,E02000311,9900,9103,363,225,138,192,106,86,242
2021,Enfield 036,E02000312,10523,9774,376,257,119,183,91,92,190
2021,Greenwich 001,E02000313,6055,5582,152,106,46,148,72,76,173
2021,Greenwich 002,E02000314,13101,12164,402,272,130,256,119,137,279
2021,Greenwich 003,E02000315,9197,8467,261,175,86,207,103,104,262
2021,Greenwich 005,E02000317,7047,6495,225,166,59,152,73,79,175
2021,Greenwich 006,E02000318,10258,9567,263,173,90,219,99,120,209
2021,Greenwich 007,E02000319,9869,9190,304,208,96,186,95,91,189
2021,Greenwich 008,E02000320,6589,6124,198,134,64,127,63,64,140
2021,Greenwich 009,E02000321,7190,6650,197,145,52,159,73,86,184
2021,Greenwich 011,E02000323,11943,11243,285,180,105,213,93,120,202
2021,Greenwich 012,E02000324,7354,6725,228,159,69,144,55,89,257
2021,Greenwich 014,E02000326,7319,6846,219,169,50,124,52,72,130
2021,Greenwich 015,E02000327,6132,5714,200,134,66,105,49,56,113
2021,Greenwich 016,E02000328,6150,5762,233,189,44,71,39,32,84
2021,Greenwich 017,E02000329,5913,5382,238,167,71,107,53,54,186
2021,Greenwich 019,E02000331,7665,7069,236,143,93,157,82,75,203
2021,Greenwich 020,E02000332,7000,6432,313,248,65,99,50,49,156
2021,Greenwich 021,E02000333,5919,5494,253,210,43,63,29,34,109
2021,Greenwich 022,E02000334,6227,5708,233,154,79,131,56,75,155
2021,Greenwich 023,E02000335,6211,5662,301,232,69,103,51,52,145
2021,Greenwich 025,E02000337,7997,7228,314,207,107,182,81,101,273
2021,Greenwich 027,E02000339,5928,5450,246,178,68,99,52,47,133
2021,Greenwich 028,E02000340,6466,5943,272,203,69,107,45,62,144
2021,Greenwich 029,E02000341,7470,6755,302,196,106,183,83,100,230
2021,Greenwich 030,E02000342,5968,5568,180,129,51,92,42,50,128
2021,Greenwich 031,E02000343,6629,6019,250,172,78,129,58,71,231
2021,Greenwich 032,E02000344,5996,5499,261,199,62,80,41,39,156
2021,Hackney 001,E02000345,7278,6803,232,163,69,126,68,58,117
2021,Hackney 002,E02000346,8696,8176,221,145,76,151,67,84,148
2021,Hackney 003,E02000347,7244,6736,280,186,94,113,59,54,115
2021,Hackney 004,E02000348,7197,6659,257,164,93,127,62,65,154
2021,Hackney 006,E02000350,9486,8891,305,216,89,144,60,84,146
2021,Hackney 007,E02000351,8766,8204,284,210,74,93,44,49,185
2021,Hackney 008,E02000352,6271,5835,216,151,65,117,61,56,103
2021,Hackney 009,E02000353,7349,6808,288,216,72,122,60,62,131
2021,Hackney 010,E02000354,9149,8464,298,208,90,216,75,141,171
2021,Hackney 011,E02000355,7699,7133,333,239,94,120,50,70,113
2021,Hackney 012,E02000356,6667,6246,229,179,50,100,59,41,92
2021,Hackney 013,E02000357,6470,5956,196,137,59,170,89,81,148
2021,Hackney 014,E02000358,10567,9839,368,281,87,153,69,84,207
2021,Hackney 015,E02000359,6233,5756,212,159,53,113,53,60,152
2021,Hackney 016,E02000360,10862,10090,318,217,101,207,95,112,247
2021,Hackney 017,E02000361,7663,7242,203,146,57,111,57,54,107
2021,Hackney 018,E02000362,6642,6131,248,175,73,135,60,75,128
2021,Hackney 019,E02000363,11144,10350,321,218,103,229,97,132,244
2021,Hackney 020,E02000364,8769,8146,334,245,89,135,57,78,154
2021,Hackney 022,E02000366,7917,7278,284,209,75,160,73,87,195
2021,Hackney 023,E02000367,9945,9399,281,223,58,123,54,69,142
2021,Hackney 024,E02000368,9424,8683,316,225,91,203,89,114,222
2021,Hackney 025,E02000369,12735,11973,350,264,86,210,76,134,202
2021,Hackney 026,E02000370,8447,7943,250,186,64,125,55,70,129
2021,Hammersmith and Fulham 001,E02000372,9534,8760,314,210,104,208,96,112,252
2021,Hammersmith and Fulham 002,E02000373,6658,6146,216,125,91,145,75,70,151
2021,Hammersmith and Fulham 003,E02000374,6549,6038,232,157,75,117,57,60,162
2021,Hammersmith and Fulham 004,E02000375,7083,6597,228,159,69,126,51,75,132
2021,Hammersmith and Fulham 005,E02000376,6420,6002,215,149,66,95,42,53,108
2021,Hammersmith and Fulham 006,E02000377,7372,6877,266,209,57,109,44,65,120
2021,Hammersmith and Fulham 007,E02000378,6162,5843,177,131,46,78,33,45,64
2021,Hammersmith and Fulham 008,E02000379,6959,6517,260,198,62,90,47,43,92
2021,Hammersmith and Fulham 009,E02000380,5170,4836,205,156,49,64,23,41,65
2021,Hammersmith and Fulham 010,E02000381,7239,6809,248,191,57,85,30,55,97
2021,Hammersmith and Fulham 011,E02000382,5905,5536,212,157,55,72,36,36,85
2021,Hammersmith and Fulham 012,E02000383,8148,7688,230,178,52,98,43,55,132
2021,Hammersmith and Fulham 013,E02000384,7914,7436,232,170,62,118,64,54,128
2021,Hammersmith and Fulham 014,E02000385,5408,5173,156,120,36,40,19,21,39
2021,Hammersmith and Fulham 015,E02000386,7267,6756,235,172,63,123,63,60,153
2021,Hammersmith and Fulham 016,E02000387,5773,5393,172,129,43,95,43,52,113
2021,Hammersmith and Fulham 017,E02000388,8295,7844,234,168,66,114,53,61,103
2021,Hammersmith and Fulham 018,E02000389,8232,7728,289,212,77,110,52,58,105
2021,Hammersmith and Fulham 019,E02000390,5847,5499,181,138,43,85,41,44,82
2021,Hammersmith and Fulham 020,E02000391,7176,6802,194,153,41,80,36,44,100
2021,Hammersmith and Fulham 021,E02000392,8753,8280,253,191,62,106,52,54,114
2021,Hammersmith and Fulham 022,E02000393,5592,5345,161,118,43,47,18,29,39
2021,Hammersmith and Fulham 023,E02000394,8699,8238,226,160,66,116,45,71,119
2021,Hammersmith and Fulham 024,E02000395,5417,5126,170,132,38,54,26,28,67
2021,Hammersmith and Fulham 025,E02000396,6500,6074,214,154,60,98,53,45,114
2021,Haringey 001,E02000397,7478,6989,228,153,75,133,75,58,128
2021,Haringey 002,E02000398,7050,6535,216,155,61,160,60,100,139
2021,Haringey 004,E02000400,7549,7027,252,183,69,126,54,72,144
2021,Haringey 005,E02000401,6559,5969,209,121,88,175,80,95,206
2021,Haringey 006,E02000402,6109,5639,183,116,67,127,65,62,160
2021,Haringey 007,E02000403,7018,6616,188,129,59,112,56,56,102
2021,Haringey 008,E02000404,6777,6287,190,123,67,152,69,83,148
2021,Haringey 009,E02000405,6122,5676,283,218,65,73,43,30,90
2021,Haringey 010,E02000406,6418,5886,238,167,71,142,66,76,152
2021,Haringey 011,E02000407,7154,6657,221,146,75,124,45,79,152
2021,Haringey 012,E02000408,7738,7072,337,187,150,176,90,86,153
2021,Haringey 013,E02000409,5738,5305,186,129,57,120,54,66,127
2021,Haringey 014,E02000410,6076,5715,234,185,49,64,37,27,63
2021,Haringey 015,E02000411,10753,10121,271,197,74,175,75,100,186
2021,Haringey 016,E02000412,7018,6524,203,129,74,143,65,78,148
2021,Haringey 017,E02000413,7326,6746,331,255,76,103,41,62,146
2021,Haringey 018,E02000414,6653,6244,193,143,50,101,46,55,115
2021,Haringey 019,E02000415,6851,6394,226,163,63,106,40,66,125
2021,Haringey 020,E02000416,7969,7398,294,209,85,148,65,83,129
2021,Haringey 021,E02000417,6261,5840,274,207,67,57,29,28,90
2021,Haringey 022,E02000418,5159,4780,241,183,58,54,28,26,84
2021,Haringey 023,E02000419,8253,7781,243,181,62,115,53,62,114
2021,Haringey 024,E02000420,7544,7043,230,151,79,143,71,72,128
2021,Haringey 025,E02000421,8041,7539,241,160,81,148,41,107,113
2021,Haringey 026,E02000422,6948,6449,207,146,61,123,65,58,169
2021,Haringey 027,E02000423,6572,6173,187,135,52,111,42,69,101
2021,Haringey 028,E02000424,6400,5937,294,220,74,88,37,51,81
2021,Haringey 029,E02000425,7291,6881,192,125,67,106,53,53,112
2021,Haringey 030,E02000426,6173,5778,258,212,46,59,38,21,78
2021,Haringey 031,E02000427,6295,5905,229,179,50,70,32,38,91
2021,Haringey 032,E02000428,7937,7499,200,125,75,116,54,62,122
2021,Haringey 033,E02000429,6423,5985,295,227,68,60,25,35,83
2021,Haringey 034,E02000430,6531,6128,255,212,43,71,26,45,77
2021,Haringey 035,E02000431,5584,5260,209,180,29,53,24,29,62
2021,Haringey 036,E02000432,5826,5436,233,171,62,70,39,31,87
2021,Harrow 001,E02000433,8180,7456,374,254,120,167,84,83,183
2021,Harrow 002,E02000434,9288,8485,436,296,140,158,68,90,209
2021,Harrow 003,E02000435,7724,6978,357,225,132,191,91,100,198
2021,Harrow 004,E02000436,5508,4949,341,257,84,106,58,48,112
2021,Harrow 005,E02000437,8292,7566,341,235,106,175,87,88,210
2021,Harrow 006,E02000438,7999,7259,362,269,93,160,85,75,218
2021,Harrow 007,E02000439,8637,8027,288,197,91,153,70,83,169
2021,Harrow 008,E02000440,9079,8298,480,336,144,151,69,82,150
2021,Harrow 009,E02000441,7026,6448,323,224,99,119,58,61,136
2021,Harrow 010,E02000442,8956,8353,255,162,93,166,84,82,182
2021,Harrow 011,E02000443,10013,9247,341,216,125,199,110,89,226
2021,Harrow 012,E02000444,8195,7483,377,253,124,158,86,72,177
2021,Harrow 013,E02000445,10906,10092,366,263,103,194,90,104,254
2021,Harrow 015,E02000447,7686,6984,399,277,122,132,76,56,171
2021,Harrow 016,E02000448,6663,6070,367,279,88,92,53,39,134
2021,Harrow 017,E02000449,7792,7188,273,166,107,147,77,70,184
2021,Harrow 019,E02000451,6360,5818,323,248,75,113,63,50,106
2021,Harrow 020,E02000452,8799,8230,291,201,90,139,57,82,139
2021,Harrow 021,E02000453,7808,7153,333,234,99,149,71,78,173
2021,Harrow 022,E02000454,6981,6368,380,284,96,106,54,52,127
2021,Harrow 023,E02000455,10766,10075,321,228,93,197,89,108,173
2021,Harrow 024,E02000456,7382,6784,305,232,73,132,58,74,161
2021,Harrow 025,E02000457,6749,6199,280,185,95,129,69,60,141
2021,Harrow 027,E02000459,8707,8093,311,218,93,133,72,61,170
2021,Harrow 028,E02000460,6816,6275,232,156,76,132,65,67,177
2021,Harrow 029,E02000461,6882,6400,272,187,85,92,41,51,118
2021,Harrow 030,E02000462,6593,6074,227,156,71,133,68,65,159
2021,Harrow 031,E02000463,8281,7640,298,189,109,141,65,76,202
2021,Havering 001,E02000464,7259,6637,258,172,86,125,56,69,239
2021,Havering 002,E02000465,8681,8011,297,195,102,159,72,87,214
2021,Havering 003,E02000466,8446,7721,295,201,94,150,76,74,280
2021,Havering 004,E02000467,10609,9737,320,210,110,239,109,130,313
2021,Havering 005,E02000468,8104,7426,318,220,98,158,67,91,202
2021,Havering 006,E02000469,6741,6167,200,136,64,147,69,78,227
2021,Havering 007,E02000470,9132,8367,402,310,92,139,53,86,224
2021,Havering 008,E02000471,7444,6715,397,283,114,131,73,58,201
2021,Havering 009,E02000472,8910,8198,322,232,90,170,82,88,220
2021,Havering 010,E02000473,9824,9080,338,246,92,166,81,85,240
2021,Havering 011,E02000474,8520,7864,317,232,85,136,68,68,203
2021,Havering 012,E02000475,9038,8304,430,307,123,135,68,67,169
2021,Havering 013,E02000476,8631,8070,282,198,84,120,54,66,159
2021,Havering 014,E02000477,9013,8202,446,338,108,143,65,78,222
2021,Havering 015,E02000478,5747,5220,268,195,73,103,49,54,156
2021,Havering 016,E02000479,8747,8092,317,237,80,157,64,93,181
2021,Havering 017,E02000480,12700,11777,414,287,127,223,101,122,286
2021,Havering 018,E02000481,7767,7049,382,298,84,122,56,66,214
2021,Havering 019,E02000482,6303,5730,364,269,95,79,42,37,130
2021,Havering 020,E02000483,7554,6909,312,237,75,119,57,62,214
2021,Havering 021,E02000484,8053,7335,371,269,102,139,69,70,208
2021,Havering 022,E02000485,7979,7287,368,255,113,121,56,65,203
2021,Havering 023,E02000486,6957,6341,334,244,90,104,60,44,178
2021,Havering 024,E02000487,7583,6802,494,367,127,115,62,53,172
2021,Havering 025,E02000488,7187,6538,384,271,113,104,54,50,161
2021,Havering 026,E02000489,8090,7385,318,235,83,153,76,77,234
2021,Havering 027,E02000490,7918,7236,332,244,88,135,75,60,215
2021,Havering 028,E02000491,9889,9037,391,273,118,165,80,85,296
2021,Havering 029,E02000492,6478,5880,293,201,92,116,61,55,189
2021,Havering 030,E02000493,6242,5808,193,129,64,106,48,58,135
2021,Hillingdon 001,E02000494,7590,6890,404,302,102,122,63,59,174
2021,Hillingdon 002,E02000495,9806,8976,438,296,142,166,74,92,226
2021,Hillingdon 003,E02000496,7391,6681,353,268,85,132,63,69,225
2021,Hillingdon 004,E02000497,8982,8202,412,302,110,152,65,87,216
2021,Hillingdon 005,E02000498,5992,5409,331,234,97,91,54,37,161
2021,Hillingdon 006,E02000499,7339,6679,397,310,87,105,45,60,158
2021,Hillingdon 007,E02000500,7892,7175,416,328,88,109,56,53,192
2021,Hillingdon 008,E02000501,7980,7278,419,320,99,112,61,51,171
2021,Hillingdon 009,E02000502,8262,7650,323,232,91,128,63,65,161
2021,Hillingdon 010,E02000503,8098,7464,357,258,99,116,61,55,161
2021,Hillingdon 011,E02000504,7234,6591,385,292,93,88,42,46,170
2021,Hillingdon 013,E02000506,7579,6884,418,321,97,110,52,58,167
2021,Hillingdon 014,E02000507,7717,7039,320,238,82,156,79,77,202
2021,Hillingdon 015,E02000508,11146,10500,335,240,95,130,59,71,181
2021,Hillingdon 016,E02000509,9936,9329,317,229,88,132,53,79,158
2021,Hillingdon 017,E02000510,8603,7877,372,268,104,156,70,86,198
2021,Hillingdon 018,E02000511,9295,8542,347,255,92,223,105,118,183
2021,Hillingdon 019,E02000512,8191,7523,298,203,95,139,62,77,231
2021,Hillingdon 020,E02000513,8965,8370,237,139,98,162,61,101,196
2021,Hillingdon 021,E02000514,9968,9253,288,196,92,184,94,90,243
2021,Hillingdon 022,E02000515,12232,11364,413,305,108,207,92,115,248
2021,Hillingdon 023,E02000516,8100,7508,263,162,101,161,81,80,168
2021,Hillingdon 024,E02000517,9737,8968,311,191,120,175,80,95,283
2021,Hillingdon 025,E02000518,8830,8045,315,231,84,201,98,103,269
2021,Hillingdon 026,E02000519,8969,8182,312,209,103,204,104,100,271
2021,Hillingdon 027,E02000520,13044,12125,361,246,115,275,132,143,283
2021,Hillingdon 028,E02000521,12157,11268,352,240,112,226,90,136,311
2021,Hillingdon 029,E02000522,8899,8240,310,203,107,176,83,93,173
2021,Hillingdon 030,E02000523,10650,9996,268,184,84,200,90,110,186
2021,Hillingdon 031,E02000524,7045,6544,237,166,71,128,61,67,136
2021,Hillingdon 032,E02000525,9354,8709,291,207,84,183,69,114,171
2021,Hounslow 001,E02000526,8235,7718,317,263,54,110,46,64,90
2021,Hounslow 004,E02000529,9074,8303,359,218,141,182,92,90,230
2021,Hounslow 005,E02000530,7540,6951,214,135,79,192,90,102,183
2021,Hounslow 006,E02000531,10877,10162,365,271,94,169,88,81,181
2021,Hounslow 007,E02000532,8479,7899,333,240,93,112,50,62,135
2021,Hounslow 008,E02000533,7951,7407,340,266,74,93,55,38,111
2021,Hounslow 009,E02000534,8053,7433,348,241,107,122,62,60,150
2021,Hounslow 010,E02000535,9494,8701,328,194,134,211,100,111,254
2021,Hounslow 011,E02000536,10196,9378,378,239,139,223,133,90,217
2021,Hounslow 012,E02000537,9299,8601,343,232,111,171,82,89,184
2021,Hounslow 013,E02000538,9510,8865,237,157,80,208,104,104,200
2021,Hounslow 014,E02000539,11416,10574,421,313,108,186,72,114,235
2021,Hounslow 015,E02000540,11225,10547,313,235,78,182,73,109,183
2021,Hounslow 016,E02000541,9896,9097,319,171,148,209,106,103,271
2021,Hounslow 017,E02000542,11413,10630,328,204,124,232,115,117,223
2021,Hounslow 018,E02000543,12877,12122,331,208,123,238,121,117,186
2021,Hounslow 019,E02000544,8131,7540,289,183,106,165,76,89,137
2021,Hounslow 020,E02000545,8634,7954,303,220,83,174,82,92,203
2021,Hounslow 021,E02000546,9798,9033,304,188,116,214,108,106,247
2021,Hounslow 022,E02000547,10275,9540,329,229,100,196,76,120,210
2021,Hounslow 023,E02000548,9853,9059,305,205,100,193,98,95,296
2021,Hounslow 024,E02000549,11840,10991,396,272,124,187,95,92,266
2021,Hounslow 025,E02000550,10010,9353,275,190,85,168,77,91,214
2021,Hounslow 026,E02000551,9058,8379,261,174,87,178,89,89,240
2021,Hounslow 027,E02000552,8641,8014,294,226,68,136,70,66,197
2021,Hounslow 028,E02000553,6665,6089,274,186,88,131,61,70,171
2021,Islington 001,E02000554,8811,8070,353,248,105,185,84,101,203
2021,Islington 002,E02000555,9091,8374,351,259,92,171,79,92,195
2021,Islington 003,E02000556,10822,10072,400,293,107,155,67,88,195
2021,Islington 004,E02000557,8367,7783,296,220,76,140,76,64,148
2021,Islington 005,E02000558,8830,8094,303,190,113,183,77,106,250
2021,Islington 006,E02000559,9043,8400,362,284,78,122,57,65,159
2021,Islington 007,E02000560,7019,6587,223,168,55,103,49,54,106
2021,Islington 008,E02000561,7063,6504,331,264,67,104,43,61,124
2021,Islington 009,E02000562,7465,6891,313,246,67,116,55,61,145
2021,Islington 010,E02000563,8263,7634,264,179,85,165,79,86,200
2021,Islington 011,E02000564,11816,11102,408,291,117,156,80,76,150
2021,Islington 012,E02000565,8123,7563,278,219,59,148,74,74,134
2021,Islington 013,E02000566,8060,7505,307,246,61,132,78,54,116
2021,Islington 014,E02000567,9889,9099,389,278,111,201,83,118,200
2021,Islington 015,E02000568,10794,9951,380,262,118,210,86,124,253
2021,Islington 016,E02000569,9364,8595,364,264,100,179,83,96,226
2021,Islington 017,E02000570,7863,7352,298,233,65,103,49,54,110
2021,Islington 018,E02000571,8309,7741,281,206,75,141,75,66,146
2021,Islington 019,E02000572,8190,7538,280,193,87,162,74,88,210
2021,Islington 020,E02000573,9798,9147,350,266,84,144,61,83,157
2021,Islington 021,E02000574,7539,7029,277,207,70,99,41,58,134
2021,Islington 022,E02000575,10732,10081,339,238,101,141,59,82,171
2021,Islington 023,E02000576,10129,9423,321,214,107,188,89,99,197
2021,Kensington and Chelsea 001,E02000577,7407,6659,306,191,115,221,103,118,221
2021,Kensington and Chelsea 002,E02000578,5670,5123,237,157,80,134,54,80,176
2021,Kensington and Chelsea 003,E02000579,8479,7772,331,228,103,141,75,66,235
2021,Kensington and Chelsea 004,E02000580,7613,6843,452,337,115,151,76,75,167
2021,Kensington and Chelsea 005,E02000581,7095,6352,309,194,115,182,81,101,252
2021,Kensington and Chelsea 006,E02000582,6254,5920,210,171,39,59,26,33,65
2021,Kensington and Chelsea 007,E02000583,6154,5763,254,195,59,59,34,25,78
2021,Kensington and Chelsea 008,E02000584,6833,6440,233,198,35,82,31,51,78
2021,Kensington and Chelsea 009,E02000585,7714,7224,250,191,59,113,71,42,127
2021,Kensington and Chelsea 010,E02000586,6225,5948,180,134,46,42,14,28,55
2021,Kensington and Chelsea 011,E02000587,6213,5856,213,164,49,84,35,49,60
2021,Kensington and Chelsea 012,E02000588,5740,5451,183,145,38,47,24,23,59
2021,Kensington and Chelsea 013,E02000589,6991,6711,166,136,30,60,42,18,54
2021,Kensington and Chelsea 014,E02000590,5748,5373,187,131,56,100,50,50,88
2021,Kensington and Chelsea 015,E02000591,5963,5561,197,155,42,102,43,59,103
2021,Kensington and Chelsea 016,E02000592,5491,5269,146,109,37,38,24,14,38
2021,Kensington and Chelsea 017,E02000593,6996,6643,214,174,40,70,30,40,69
2021,Kensington and Chelsea 018,E02000594,6280,5867,240,184,56,87,57,30,86
2021,Kensington and Chelsea 019,E02000595,5877,5510,214,175,39,62,37,25,91
2021,Kensington and Chelsea 020,E02000596,6382,6057,198,147,51,70,48,22,57
2021,Kensington and Chelsea 021,E02000597,6072,5523,256,188,68,136,61,75,157
2021,Kingston upon Thames 001,E02000598,7733,7191,324,254,70,90,47,43,128
2021,Kingston upon Thames 002,E02000599,6754,6235,310,219,91,103,58,45,106
2021,Kingston upon Thames 003,E02000600,7851,7368,255,199,56,98,42,56,130
2021,Kingston upon Thames 004,E02000601,11130,10450,395,307,88,129,69,60,156
2021,Kingston upon Thames 005,E02000602,9648,9030,305,227,78,150,76,74,163
2021,Kingston upon Thames 006,E02000603,8143,7495,306,215,91,160,81,79,182
2021,Kingston upon Thames 007,E02000604,8655,8105,287,225,62,109,64,45,154
2021,Kingston upon Thames 008,E02000605,8000,7380,347,262,85,110,55,55,163
2021,Kingston upon Thames 009,E02000606,9992,9441,352,288,64,94,46,48,105
2021,Kingston upon Thames 010,E02000607,6415,6015,243,196,47,69,30,39,88
2021,Kingston upon Thames 011,E02000608,6797,6425,222,182,40,69,33,36,81
2021,Kingston upon Thames 012,E02000609,7276,6656,310,221,89,137,69,68,173
2021,Kingston upon Thames 013,E02000610,7500,7004,273,214,59,84,39,45,139
2021,Kingston upon Thames 014,E02000611,7066,6425,370,279,91,105,56,49,166
2021,Kingston upon Thames 015,E02000612,7808,7176,355,265,90,118,61,57,159
2021,Kingston upon Thames 016,E02000613,7525,6953,324,256,68,107,48,59,141
2021,Kingston upon Thames 017,E02000614,8728,8081,343,237,106,145,68,77,159
2021,Kingston upon Thames 018,E02000615,7455,6795,362,272,90,140,67,73,158
2021,Kingston upon Thames 019,E02000616,5702,5255,254,192,62,87,42,45,106
2021,Kingston upon Thames 020,E02000617,8323,7515,438,319,119,139,57,82,231
2021,Lambeth 002,E02000619,8634,7937,332,237,95,168,87,81,197
2021,Lambeth 003,E02000620,9460,8826,368,287,81,139,61,78,127
2021,Lambeth 004,E02000621,12087,11501,308,224,84,131,53,78,147
2021,Lambeth 005,E02000622,8046,7582,282,200,82,85,31,54,97
2021,Lambeth 006,E02000623,7574,7024,264,173,91,144,57,87,142
2021,Lambeth 007,E02000624,9214,8660,282,215,67,136,56,80,136
2021,Lambeth 008,E02000625,8848,8351,228,160,68,139,67,72,130
2021,Lambeth 009,E02000626,7948,7395,293,190,103,134,67,67,126
2021,Lambeth 010,E02000627,9135,8573,289,193,96,155,64,91,118
2021,Lambeth 011,E02000628,10363,9717,309,214,95,151,62,89,186
2021,Lambeth 012,E02000629,8785,8288,268,195,73,129,63,66,100
2021,Lambeth 013,E02000630,7240,6873,222,180,42,66,31,35,79
2021,Lambeth 014,E02000631,9044,8468,314,240,74,127,79,48,135
2021,Lambeth 015,E02000632,9352,8923,238,178,60,101,42,59,90
2021,Lambeth 016,E02000633,8763,8199,272,211,61,161,62,99,131
2021,Lambeth 017,E02000634,6512,6090,212,158,54,111,56,55,99
2021,Lambeth 018,E02000635,9379,8800,321,250,71,143,56,87,115
2021,Lambeth 019,E02000636,7301,6948,200,163,37,77,41,36,76
2021,Lambeth 020,E02000637,8041,7613,268,218,50,85,36,49,75
2021,Lambeth 021,E02000638,9768,9211,287,194,93,114,54,60,156
2021,Lambeth 022,E02000639,7982,7507,210,155,55,134,73,61,131
2021,Lambeth 023,E02000640,8737,8266,264,193,71,102,44,58,105
2021,Lambeth 024,E02000641,8156,7567,272,186,86,158,89,69,159
2021,Lambeth 025,E02000642,9273,8593,355,255,100,163,55,108,162
2021,Lambeth 026,E02000643,8901,8361,306,243,63,122,60,62,112
2021,Lambeth 027,E02000644,7996,7472,319,254,65,99,41,58,106
2021,Lambeth 028,E02000645,8928,8347,306,241,65,130,55,75,145
2021,Lambeth 029,E02000646,9021,8466,292,216,76,111,64,47,152
2021,Lambeth 030,E02000647,8016,7450,319,231,88,116,69,47,131
2021,Lambeth 031,E02000648,7296,6699,295,228,67,156,78,78,146
2021,Lambeth 032,E02000649,11755,11124,344,262,82,160,79,81,127
2021,Lambeth 033,E02000650,7180,6591,322,210,112,115,53,62,152
2021,Lambeth 034,E02000651,8190,7679,254,196,58,123,37,86,134
2021,Lambeth 035,E02000652,7120,6619,227,161,66,138,63,75,136
2021,Lewisham 001,E02000653,11954,11222,365,260,105,182,72,110,185
2021,Lewisham 002,E02000654,8305,7746,212,140,72,187,91,96,160
2021,Lewisham 003,E02000655,9675,9110,307,197,110,129,65,64,129
2021,Lewisham 005,E02000657,9418,8875,278,207,71,132,52,80,133
2021,Lewisham 006,E02000658,8212,7651,301,227,74,129,60,69,131
2021,Lewisham 007,E02000659,7633,7064,337,256,81,112,53,59,120
2021,Lewisham 008,E02000660,7737,7254,288,231,57,104,41,63,91
2021,Lewisham 009,E02000661,6112,5702,255,196,59,75,37,38,80
2021,Lewisham 010,E02000662,7749,7122,329,231,98,146,64,82,152
2021,Lewisham 011,E02000663,6413,5989,245,179,66,93,44,49,86
2021,Lewisham 013,E02000665,7611,7121,243,187,56,104,49,55,143
2021,Lewisham 014,E02000666,6716,6197,285,204,81,100,49,51,134
2021,Lewisham 015,E02000667,6202,5786,212,146,66,84,43,41,120
2021,Lewisham 016,E02000668,6295,5800,280,211,69,107,57,50,108
2021,Lewisham 017,E02000669,7334,6870,256,196,60,85,44,41,123
2021,Lewisham 018,E02000670,6230,5770,214,152,62,137,50,87,109
2021,Lewisham 019,E02000671,8054,7528,299,217,82,107,49,58,120
2021,Lewisham 020,E02000672,9477,8839,300,229,71,162,62,100,176
2021,Lewisham 021,E02000673,7658,7164,281,214,67,113,49,64,100
2021,Lewisham 022,E02000674,7840,7224,342,263,79,132,58,74,142
2021,Lewisham 023,E02000675,7971,7342,320,232,88,153,68,85,156
2021,Lewisham 024,E02000676,7250,6778,268,205,63,96,50,46,108
2021,Lewisham 025,E02000677,6751,6193,308,238,70,117,58,59,133
2021,Lewisham 026,E02000678,6454,5923,224,139,85,137,65,72,170
2021,Lewisham 027,E02000679,7558,6992,289,213,76,134,66,68,143
2021,Lewisham 028,E02000680,6554,6119,226,165,61,109,53,56,100
2021,Lewisham 029,E02000681,7886,7230,294,208,86,164,66,98,198
2021,Lewisham 030,E02000682,8401,7747,298,201,97,156,73,83,200
2021,Lewisham 031,E02000683,6337,5824,214,150,64,136,51,85,163
2021,Lewisham 033,E02000685,7632,7064,301,230,71,135,65,70,132
2021,Lewisham 034,E02000686,7023,6405,255,169,86,185,83,102,178
2021,Lewisham 035,E02000687,7699,7205,243,165,78,111,63,48,140
2021,Merton 001,E02000689,8314,7812,314,230,84,82,41,41,106
2021,Merton 002,E02000690,5305,4924,222,176,46,54,30,24,105
2021,Merton 003,E02000691,6932,6561,241,176,65,57,29,28,73
2021,Merton 004,E02000692,7269,6827,280,221,59,77,42,35,85
2021,Merton 005,E02000693,9252,8752,270,212,58,115,64,51,115
2021,Merton 006,E02000694,8379,7893,291,248,43,75,37,38,120
2021,Merton 007,E02000695,8110,7532,279,197,82,141,66,75,158
2021,Merton 008,E02000696,8103,7593,237,153,84,122,57,65,151
2021,Merton 009,E02000697,8097,7711,232,187,45,81,38,43,73
2021,Merton 010,E02000698,7784,7227,331,260,71,102,55,47,124
2021,Merton 011,E02000699,7625,7158,282,228,54,74,37,37,111
2021,Merton 012,E02000700,8134,7560,257,171,86,137,62,75,180
2021,Merton 013,E02000701,8485,7945,244,166,78,142,72,70,154
2021,Merton 014,E02000702,8641,7984,279,185,94,185,80,105,193
2021,Merton 015,E02000703,7552,6973,342,261,81,96,59,37,141
2021,Merton 016,E02000704,7997,7451,282,203,79,109,46,63,155
2021,Merton 017,E02000705,8829,8153,338,219,119,159,76,83,179
2021,Merton 018,E02000706,9319,8650,251,154,97,211,96,115,207
2021,Merton 019,E02000707,7814,7199,273,179,94,169,79,90,173
2021,Merton 020,E02000708,8328,7713,356,270,86,95,50,45,164
2021,Merton 021,E02000709,7510,6869,346,262,84,95,47,48,200
2021,Merton 022,E02000710,8611,7974,283,201,82,154,61,93,200
2021,Merton 023,E02000711,8843,8209,293,203,90,162,79,83,179
2021,Merton 024,E02000712,9081,8315,348,212,136,189,79,110,229
2021,Merton 025,E02000713,7339,6778,281,197,84,107,61,46,173
2021,Newham 001,E02000714,7149,6629,227,163,64,137,53,84,156
2021,Newham 002,E02000715,6706,6198,181,108,73,137,60,77,190
2021,Newham 003,E02000716,6803,6346,207,128,79,134,59,75,116
2021,Newham 004,E02000717,7748,7230,202,128,74,166,64,102,150
2021,Newham 005,E02000718,6854,6396,169,116,53,128,60,68,161
2021,Newham 006,E02000719,7571,7065,191,143,48,156,73,83,159
2021,Newham 007,E02000720,6933,6432,232,164,68,109,58,51,160
2021,Newham 008,E02000721,8836,8125,264,157,107,204,91,113,243
2021,Newham 009,E02000722,7685,7256,176,116,60,128,50,78,125
2021,Newham 010,E02000723,10343,9394,433,268,165,255,119,136,261
2021,Newham 011,E02000724,9214,8459,309,164,145,262,132,130,184
2021,Newham 012,E02000725,9350,8826,235,166,69,156,69,87,133
2021,Newham 014,E02000727,7918,7401,194,114,80,184,82,102,139
2021,Newham 015,E02000728,7974,7461,208,136,72,173,77,96,132
2021,Newham 016,E02000729,6727,6250,177,104,73,150,64,86,150
2021,Newham 017,E02000730,9048,8397,250,137,113,205,99,106,196
2021,Newham 018,E02000731,9278,8627,269,164,105,161,68,93,221
2021,Newham 019,E02000732,8229,7625,236,129,107,165,65,100,203
2021,Newham 020,E02000733,9490,8809,269,165,104,186,89,97,226
2021,Newham 021,E02000734,6876,6415,172,123,49,152,62,90,137
2021,Newham 022,E02000735,8034,7498,214,140,74,168,75,93,154
2021,Newham 023,E02000736,8560,7973,226,140,86,159,68,91,202
2021,Newham 024,E02000737,9706,9023,257,169,88,212,93,119,214
2021,Newham 025,E02000738,8848,8302,225,151,74,152,78,74,169
2021,Newham 026,E02000739,7196,6707,200,124,76,148,62,86,141
2021,Newham 027,E02000740,6365,5920,196,134,62,119,42,77,130
2021,Newham 028,E02000741,7731,7198,227,150,77,152,68,84,154
2021,Newham 029,E02000742,8083,7525,224,152,72,165,70,95,169
2021,Newham 030,E02000743,9711,9087,237,139,98,208,110,98,179
2021,Newham 031,E02000744,8496,7950,216,134,82,159,66,93,171
2021,Newham 032,E02000745,8073,7543,199,125,74,173,66,107,158
2021,Newham 033,E02000746,8792,8217,199,133,66,177,79,98,199
2021,Newham 034,E02000747,12401,11700,254,182,72,208,85,123,239
2021,Newham 035,E02000748,5905,5500,174,112,62,120,59,61,111
2021,Newham 036,E02000749,8968,8373,223,143,80,168,81,87,204
2021,Redbridge 001,E02000751,10604,9650,557,414,143,146,71,75,251
2021,Redbridge 002,E02000752,8134,7522,256,180,76,149,62,87,207
2021,Redbridge 003,E02000753,6375,5825,229,145,84,140,56,84,181
2021,Redbridge 004,E02000754,6341,5831,268,197,71,104,53,51,138
2021,Redbridge 005,E02000755,5156,4761,201,146,55,76,46,30,118
2021,Redbridge 006,E02000756,13626,12628,509,356,153,217,115,102,272
2021,Redbridge 007,E02000757,11558,10788,465,355,110,130,75,55,175
2021,Redbridge 008,E02000758,6508,5957,252,172,80,138,71,67,161
2021,Redbridge 009,E02000759,12195,11320,437,325,112,218,107,111,220
2021,Redbridge 010,E02000760,7081,6510,282,199,83,121,64,57,168
2021,Redbridge 012,E02000762,6290,5746,268,181,87,140,70,70,136
2021,Redbridge 013,E02000763,7499,6934,298,218,80,120,52,68,147
2021,Redbridge 014,E02000764,11594,10777,484,371,113,156,96,60,177
2021,Redbridge 015,E02000765,6995,6472,234,160,74,121,66,55,168
2021,Redbridge 017,E02000767,8080,7553,252,165,87,153,83,70,122
2021,Redbridge 018,E02000768,5443,5031,262,204,58,68,36,32,82
2021,Redbridge 020,E02000770,7650,7045,306,213,93,134,89,45,165
2021,Redbridge 022,E02000772,7856,7307,246,154,92,153,72,81,150
2021,Redbridge 023,E02000773,9932,9286,260,181,79,170,81,89,216
2021,Redbridge 024,E02000774,7452,6967,230,146,84,115,63,52,140
2021,Redbridge 026,E02000776,6536,6069,230,150,80,115,59,56,122
2021,Redbridge 027,E02000777,5574,5137,241,187,54,77,39,38,119
2021,Redbridge 029,E02000779,7644,7094,222,135,87,176,99,77,152
2021,Redbridge 031,E02000781,15122,14062,471,307,164,277,138,139,312
2021,Redbridge 032,E02000782,10510,9901,253,165,88,187,83,104,169
2021,Redbridge 033,E02000783,6823,6394,181,114,67,109,54,55,139
2021,Richmond upon Thames 001,E02000784,9656,8890,459,358,101,133,69,64,174
2021,Richmond upon Thames 002,E02000785,9223,8608,413,335,78,102,49,53,100
2021,Richmond upon Thames 003,E02000786,10481,9816,416,326,90,114,58,56,135
2021,Richmond upon Thames 004,E02000787,11282,10497,463,359,104,111,59,52,211
2021,Richmond upon Thames 005,E02000788,8470,7966,332,247,85,75,29,46,97
2021,Richmond upon Thames 006,E02000789,5987,5608,234,182,52,65,28,37,80
2021,Richmond upon Thames 007,E02000790,6162,5775,272,212,60,53,25,28,62
2021,Richmond upon Thames 008,E02000791,6087,5722,265,218,47,30,16,14,70
2021,Richmond upon Thames 009,E02000792,6808,6424,266,217,49,52,23,29,66
2021,Richmond upon Thames 010,E02000793,7684,7080,333,239,94,117,61,56,154
2021,Richmond upon Thames 011,E02000794,6593,6149,300,244,56,49,16,33,95
2021,Richmond upon Thames 012,E02000795,6556,6102,269,192,77,69,32,37,116
2021,Richmond upon Thames 013,E02000796,10462,9486,480,339,141,210,96,114,286
2021,Richmond upon Thames 014,E02000797,7353,6880,295,233,62,66,31,35,112
2021,Richmond upon Thames 015,E02000798,10629,9814,458,357,101,137,55,82,220
2021,Richmond upon Thames 016,E02000799,6329,5874,332,264,68,58,31,27,65
2021,Richmond upon Thames 017,E02000800,5110,4667,223,163,60,90,35,55,130
2021,Richmond upon Thames 018,E02000801,6680,6213,321,264,57,58,22,36,88
2021,Richmond upon Thames 019,E02000802,6693,6225,316,253,63,63,30,33,89
2021,Richmond upon Thames 020,E02000803,9190,8384,422,301,121,154,68,86,230
2021,Richmond upon Thames 021,E02000804,6745,6299,307,258,49,49,25,24,90
2021,Richmond upon Thames 022,E02000805,10226,9525,431,342,89,124,54,70,146
2021,Richmond upon Thames 023,E02000806,9756,9023,450,348,102,106,59,47,177
2021,Southwark 001,E02000807,7809,7374,239,176,63,97,43,54,99
2021,Southwark 002,E02000808,9853,9344,279,218,61,110,59,51,120
2021,Southwark 004,E02000810,11295,10554,328,220,108,197,90,107,216
2021,Southwark 006,E02000812,10337,9652,376,297,79,154,77,77,155
2021,Southwark 007,E02000813,9741,9138,272,197,75,144,62,82,187
2021,Southwark 008,E02000814,9716,9189,271,212,59,130,50,80,126
2021,Southwark 009,E02000815,7301,6966,180,137,43,84,45,39,71
2021,Southwark 010,E02000816,9054,8389,281,189,92,165,75,90,219
2021,Southwark 011,E02000817,6474,6018,172,107,65,120,48,72,164
2021,Southwark 012,E02000818,9350,8748,310,216,94,141,69,72,151
2021,Southwark 013,E02000819,8009,7406,275,171,104,158,63,95,170
2021,Southwark 014,E02000820,8846,8278,262,187,75,147,59,88,159
2021,Southwark 015,E02000821,8764,8233,218,161,57,168,83,85,145
2021,Southwark 016,E02000822,6361,5966,179,130,49,100,46,54,116
2021,Southwark 017,E02000823,8304,7720,255,191,64,180,83,97,149
2021,Southwark 018,E02000824,9358,8690,278,189,89,200,86,114,190
2021,Southwark 019,E02000825,9667,8986,288,197,91,203,91,112,190
2021,Southwark 020,E02000826,9327,8745,261,184,77,151,71,80,170
2021,Southwark 021,E02000827,10710,10052,301,224,77,207,104,103,150
2021,Southwark 022,E02000828,8355,7814,248,170,78,123,55,68,170
2021,Southwark 023,E02000829,10289,9601,306,224,82,164,65,99,218
2021,Southwark 024,E02000830,8461,7961,298,227,71,101,56,45,101
2021,Southwark 025,E02000831,8787,8224,303,242,61,131,50,81,129
2021,Southwark 026,E02000832,9104,8342,356,271,85,184,92,92,222
2021,Southwark 027,E02000833,7050,6563,238,166,72,134,55,79,115
2021,Southwark 028,E02000834,8760,8266,291,240,51,98,43,55,105
2021,Southwark 029,E02000835,7087,6574,289,214,75,103,51,52,121
2021,Southwark 030,E02000836,7664,7084,314,244,70,99,38,61,167
2021,Southwark 031,E02000837,8076,7489,367,305,62,94,48,46,126
2021,Southwark 032,E02000838,8861,8203,350,256,94,150,67,83,158
2021,Southwark 033,E02000839,7955,7394,311,237,74,116,55,61,134
2021,Sutton 001,E02000840,8680,7907,303,211,92,194,73,121,276
2021,Sutton 002,E02000841,8634,7751,364,246,118,207,98,109,312
2021,Sutton 003,E02000842,7839,7190,332,253,79,122,62,60,195
2021,Sutton 004,E02000843,8675,8019,367,269,98,122,57,65,167
2021,Sutton 005,E02000844,8144,7463,295,188,107,167,66,101,219
2021,Sutton 006,E02000845,8773,8157,338,255,83,111,53,58,167
2021,Sutton 007,E02000846,7202,6652,306,205,101,88,36,52,156
2021,Sutton 008,E02000847,8856,8097,397,292,105,137,68,69,225
2021,Sutton 009,E02000848,7726,7105,331,247,84,147,73,74,143
2021,Sutton 010,E02000849,7637,7005,333,251,82,124,53,71,175
2021,Sutton 011,E02000850,10225,9272,499,346,153,191,91,100,263
2021,Sutton 012,E02000851,10664,9958,318,228,90,169,86,83,219
2021,Sutton 013,E02000852,7637,7088,294,226,68,92,41,51,163
2021,Sutton 014,E02000853,7640,7045,319,232,87,116,52,64,160
2021,Sutton 015,E02000854,7114,6570,312,239,73,101,63,38,131
2021,Sutton 016,E02000855,7799,7135,383,290,93,130,64,66,151
2021,Sutton 017,E02000856,8773,8057,439,320,119,114,55,59,163
2021,Sutton 018,E02000857,8436,7967,267,192,75,91,37,54,111
2021,Sutton 019,E02000858,8008,7255,279,191,88,202,98,104,272
2021,Sutton 020,E02000859,8079,7371,409,302,107,123,63,60,176
2021,Sutton 021,E02000860,8166,7643,279,216,63,108,46,62,136
2021,Sutton 022,E02000861,7441,6823,360,265,95,104,64,40,154
2021,Sutton 024,E02000863,6418,5808,335,251,84,102,54,48,173
2021,Tower Hamlets 001,E02000864,10553,9821,308,214,94,213,75,138,211
2021,Tower Hamlets 002,E02000865,7502,6890,283,187,96,169,77,92,160
2021,Tower Hamlets 003,E02000866,9967,9279,348,256,92,163,82,81,177
2021,Tower Hamlets 004,E02000867,10728,10098,293,203,90,186,102,84,151
2021,Tower Hamlets 005,E02000868,6834,6450,148,103,45,110,48,62,126
2021,Tower Hamlets 006,E02000869,5634,5261,177,124,53,82,38,44,114
2021,Tower Hamlets 007,E02000870,6016,5592,196,128,68,96,43,53,132
2021,Tower Hamlets 008,E02000871,10668,9958,274,168,106,215,98,117,221
2021,Tower Hamlets 009,E02000872,7750,7235,242,168,74,124,53,71,149
2021,Tower Hamlets 010,E02000873,9222,8639,267,185,82,141,62,79,175
2021,Tower Hamlets 011,E02000874,7044,6566,203,127,76,111,48,63,164
2021,Tower Hamlets 012,E02000875,12713,11835,354,236,118,255,114,141,269
2021,Tower Hamlets 013,E02000876,6837,6368,208,130,78,133,64,69,128
2021,Tower Hamlets 014,E02000877,12907,12049,364,254,110,241,100,141,253
2021,Tower Hamlets 015,E02000878,9954,9341,260,172,88,173,75,98,180
2021,Tower Hamlets 016,E02000879,7831,7241,228,140,88,175,73,102,187
2021,Tower Hamlets 017,E02000880,6046,5650,154,103,51,133,67,66,109
2021,Tower Hamlets 018,E02000881,10007,9313,249,165,84,216,86,130,229
2021,Tower Hamlets 019,E02000882,10697,9721,378,240,138,315,142,173,283
2021,Tower Hamlets 020,E02000883,8654,8024,233,150,83,199,76,123,198
2021,Tower Hamlets 021,E02000884,12071,11426,306,203,103,173,84,89,166
2021,Tower Hamlets 022,E02000885,6587,6028,220,128,92,174,80,94,165
2021,Tower Hamlets 023,E02000886,9009,8534,243,171,72,119,46,73,113
2021,Tower Hamlets 024,E02000887,10022,9355,274,178,96,199,97,102,194
2021,Tower Hamlets 025,E02000888,8045,7549,217,157,60,129,65,64,150
2021,Tower Hamlets 026,E02000889,8471,8033,210,159,51,118,58,60,110
2021,Tower Hamlets 027,E02000890,5505,5173,194,147,47,53,18,35,85
2021,Tower Hamlets 030,E02000893,6926,6443,219,145,74,125,57,68,139
2021,Tower Hamlets 031,E02000894,10224,9633,285,208,77,163,79,84,143
2021,Waltham Forest 001,E02000895,7916,7228,333,242,91,131,59,72,224
2021,Waltham Forest 002,E02000896,8776,8065,404,294,110,134,71,63,173
2021,Waltham Forest 003,E02000897,8103,7412,324,233,91,137,68,69,230
2021,Waltham Forest 004,E02000898,7560,6865,378,264,114,124,58,66,193
2021,Waltham Forest 005,E02000899,8303,7656,340,248,92,131,58,73,176
2021,Waltham Forest 006,E02000900,8386,7752,299,206,93,147,75,72,188
2021,Waltham Forest 007,E02000901,9795,9026,439,339,100,138,74,64,192
2021,Waltham Forest 008,E02000902,9174,8497,346,245,101,145,68,77,186
2021,Waltham Forest 009,E02000903,9585,8765,370,257,113,213,108,105,237
2021,Waltham Forest 010,E02000904,7877,7310,290,213,77,120,62,58,157
2021,Waltham Forest 011,E02000905,9532,8959,277,193,84,141,64,77,155
2021,Waltham Forest 012,E02000906,8990,8416,249,161,88,148,69,79,177
2021,Waltham Forest 013,E02000907,9770,9158,282,192,90,167,75,92,163
2021,Waltham Forest 014,E02000908,12066,11365,342,250,92,179,69,110,180
2021,Waltham Forest 015,E02000909,8582,7999,321,242,79,134,72,62,128
2021,Waltham Forest 016,E02000910,10635,9909,379,276,103,179,103,76,168
2021,Waltham Forest 017,E02000911,12047,11285,362,267,95,206,101,105,194
2021,Waltham Forest 018,E02000912,9034,8361,304,204,100,177,76,101,192
2021,Waltham Forest 019,E02000913,8952,8231,329,212,117,186,96,90,206
2021,Waltham Forest 020,E02000914,10952,10235,256,168,88,230,114,116,231
2021,Waltham Forest 021,E02000915,7592,7039,306,225,81,118,62,56,129
2021,Waltham Forest 022,E02000916,9796,9161,300,198,102,167,65,102,168
2021,Waltham Forest 023,E02000917,8810,8276,251,185,66,141,69,72,142
2021,Waltham Forest 024,E02000918,8682,8132,266,194,72,131,56,75,153
2021,Waltham Forest 025,E02000919,8556,8005,259,174,85,150,68,82,142
2021,Waltham Forest 026,E02000920,9676,9043,261,174,87,179,85,94,193
2021,Waltham Forest 027,E02000921,10522,9807,300,201,99,198,93,105,217
2021,Waltham Forest 028,E02000922,9779,9204,242,161,81,174,78,96,159
2021,Wandsworth 001,E02000923,7159,6776,237,170,67,72,24,48,74
2021,Wandsworth 003,E02000925,7427,6981,215,162,53,106,51,55,125
2021,Wandsworth 004,E02000926,11023,10490,278,213,65,137,57,80,118
2021,Wandsworth 005,E02000927,6735,6263,231,174,57,120,52,68,121
2021,Wandsworth 006,E02000928,7892,7447,304,245,59,54,26,28,87
2021,Wandsworth 007,E02000929,7592,7066,211,133,78,163,65,98,152
2021,Wandsworth 008,E02000930,9607,9198,241,186,55,96,48,48,72
2021,Wandsworth 009,E02000931,8194,7858,213,173,40,54,31,23,69
2021,Wandsworth 010,E02000932,12181,11594,385,317,68,96,39,57,106
2021,Wandsworth 011,E02000933,8460,7938,307,233,74,87,42,45,128
2021,Wandsworth 012,E02000934,8511,8088,248,190,58,85,41,44,90
2021,Wandsworth 013,E02000935,6906,6477,177,122,55,115,48,67,137
2021,Wandsworth 014,E02000936,8953,8491,265,213,52,86,34,52,111
2021,Wandsworth 015,E02000937,7623,7227,269,219,50,59,25,34,68
2021,Wandsworth 016,E02000938,10075,9306,366,269,97,177,84,93,226
2021,Wandsworth 017,E02000939,7272,6922,228,189,39,58,24,34,64
2021,Wandsworth 018,E02000940,8841,8325,265,183,82,128,44,84,123
2021,Wandsworth 019,E02000941,9441,8917,298,222,76,109,52,57,117
2021,Wandsworth 020,E02000942,9093,8588,307,247,60,99,55,44,99
2021,Wandsworth 021,E02000943,8264,7857,233,171,62,89,46,43,85
2021,Wandsworth 022,E02000944,7169,6729,204,140,64,108,42,66,128
2021,Wandsworth 023,E02000945,7395,6898,220,149,71,131,57,74,146
2021,Wandsworth 024,E02000946,7935,7399,269,200,69,121,67,54,146
2021,Wandsworth 025,E02000947,8539,8096,260,208,52,88,46,42,95
2021,Wandsworth 026,E02000948,9517,8998,312,235,77,95,39,56,112
2021,Wandsworth 027,E02000949,9492,9005,318,259,59,74,31,43,95
2021,Wandsworth 028,E02000950,7176,6749,226,163,63,100,56,44,101
2021,Wandsworth 029,E02000951,6134,5747,203,148,55,88,41,47,96
2021,Wandsworth 030,E02000952,5826,5452,208,161,47,73,31,42,93
2021,Wandsworth 031,E02000953,6944,6615,164,128,36,82,35,47,83
2021,Wandsworth 032,E02000954,5750,5376,165,130,35,101,45,56,108
2021,Wandsworth 033,E02000955,6535,6110,211,133,78,97,42,55,117
2021,Wandsworth 034,E02000956,7061,6621,214,150,64,112,51,61,114
2021,Wandsworth 035,E02000957,10234,9634,301,204,97,164,91,73,135
2021,Wandsworth 036,E02000958,7853,7279,314,236,78,107,52,55,153
2021,Wandsworth 037,E02000959,7347,6859,220,150,70,123,56,67,145
2021,Westminster 001,E02000960,5892,5493,216,160,56,75,32,43,108
2021,Westminster 002,E02000961,9263,8632,298,222,76,184,76,108,149
2021,Westminster 003,E02000962,7385,6886,267,205,62,110,58,52,122
2021,Westminster 004,E02000963,9960,9084,345,206,139,244,98,146,287
2021,Westminster 005,E02000964,11564,10617,445,310,135,229,98,131,273
2021,Westminster 006,E02000965,7464,7019,243,180,63,110,32,78,92
2021,Westminster 007,E02000966,8824,8256,315,248,67,125,45,80,128
2021,Westminster 008,E02000967,5836,5500,170,126,44,71,25,46,95
2021,Westminster 009,E02000968,13763,12451,471,282,189,422,176,246,419
2021,Westminster 010,E02000969,9151,8366,322,215,107,231,95,136,232
2021,Westminster 011,E02000970,6593,6142,278,213,65,59,34,25,114
2021,Westminster 012,E02000971,7220,6817,219,166,53,98,62,36,86
2021,Westminster 013,E02000972,7701,7154,274,200,74,151,67,84,122
2021,Westminster 014,E02000973,9498,8860,380,283,97,130,69,61,128
2021,Westminster 015,E02000974,8327,7794,237,163,74,138,61,77,158
2021,Westminster 016,E02000975,7138,6782,224,183,41,73,40,33,59
2021,Westminster 017,E02000976,8102,7627,251,181,70,116,53,63,108
2021,Westminster 018,E02000977,6215,5885,195,145,50,77,33,44,58
2021,Westminster 019,E02000978,6847,6557,177,128,49,54,27,27,59
2021,Westminster 020,E02000979,7806,7358,247,177,70,100,47,53,101
2021,Westminster 021,E02000980,8426,7796,315,230,85,154,76,78,161
2021,Westminster 022,E02000981,8051,7554,284,227,57,86,39,47,127
2021,Westminster 023,E02000982,7335,6802,246,173,73,145,60,85,142
2021,Westminster 024,E02000983,7375,6789,264,192,72,136,66,70,186
2021,Bolton 001,E02000984,7324,6617,421,306,115,122,65,57,164
2021,Bolton 002,E02000985,7141,6385,433,315,118,101,56,45,222
2021,Bolton 003,E02000986,7989,7202,414,309,105,146,75,71,227
2021,Bolton 004,E02000987,6987,6307,328,226,102,136,58,78,216
2021,Bolton 005,E02000988,8489,7693,303,202,101,176,83,93,317
2021,Bolton 006,E02000989,8019,7119,440,297,143,156,71,85,304
2021,Bolton 007,E02000990,7953,7194,399,299,100,143,58,85,217
2021,Bolton 008,E02000991,7280,6638,342,253,89,118,64,54,182
2021,Bolton 009,E02000992,5999,5395,339,268,71,101,51,50,164
2021,Bolton 010,E02000993,7771,7074,244,157,87,173,62,111,280
2021,Bolton 011,E02000994,8318,7655,223,126,97,200,74,126,240
2021,Bolton 012,E02000995,7868,7124,362,243,119,142,71,71,240
2021,Bolton 013,E02000996,8017,7244,224,146,78,205,70,135,344
2021,Bolton 014,E02000997,6150,5556,297,202,95,120,57,63,177
2021,Bolton 015,E02000998,9497,8743,254,172,82,235,106,129,265
2021,Bolton 016,E02000999,7959,7365,196,126,70,167,57,110,231
2021,Bolton 017,E02001000,8619,7826,327,217,110,181,81,100,285
2021,Bolton 018,E02001001,8210,7490,352,227,125,149,75,74,219
2021,Bolton 019,E02001002,9181,8212,424,283,141,218,107,111,327
2021,Bolton 020,E02001003,7047,6361,375,264,111,129,66,63,182
2021,Bolton 021,E02001004,8579,7873,239,150,89,237,101,136,230
2021,Bolton 022,E02001005,8981,8330,255,169,86,176,89,87,220
2021,Bolton 023,E02001006,7812,7218,225,133,92,174,77,97,195
2021,Bolton 024,E02001007,9656,8607,474,330,144,211,100,111,364
2021,Bolton 025,E02001008,8440,7774,230,116,114,191,66,125,245
2021,Bolton 026,E02001009,6943,6299,262,183,79,167,68,99,215
2021,Bolton 027,E02001010,6016,5498,186,116,70,146,64,82,186
2021,Bolton 028,E02001011,9264,8359,475,362,113,179,101,78,251
2021,Bolton 029,E02001012,8951,8098,310,211,99,221,103,118,322
2021,Bolton 030,E02001013,5803,5137,358,252,106,130,69,61,178
2021,Bolton 031,E02001014,8049,7213,366,241,125,188,84,104,282
2021,Bolton 032,E02001015,7699,6947,281,199,82,182,73,109,289
2021,Bolton 033,E02001016,8077,7270,274,185,89,227,101,126,306
2021,Bolton 034,E02001017,10176,9184,465,340,125,215,111,104,312
2021,Bolton 035,E02001018,7249,6519,387,288,99,139,66,73,204
2021,Bury 001,E02001019,8630,7931,374,268,106,138,70,68,187
2021,Bury 002,E02001020,5721,5156,335,248,87,75,36,39,155
2021,Bury 003,E02001021,7190,6468,441,339,102,106,55,51,175
2021,Bury 004,E02001022,7671,6896,359,254,105,160,66,94,256
2021,Bury 005,E02001023,5410,4811,315,231,84,115,57,58,169
2021,Bury 006,E02001024,7668,6947,385,278,107,117,61,56,219
2021,Bury 007,E02001025,7609,6923,265,170,95,167,75,92,254
2021,Bury 008,E02001026,10445,9613,282,170,112,261,124,137,289
2021,Bury 009,E02001027,6813,6222,270,201,69,120,58,62,201
2021,Bury 010,E02001028,7058,6334,400,303,97,107,62,45,217
2021,Bury 011,E02001029,7240,6612,246,163,83,181,84,97,201
2021,Bury 012,E02001030,5891,5282,328,252,76,112,59,53,169
2021,Bury 013,E02001031,6496,5879,268,176,92,165,76,89,184
2021,Bury 014,E02001032,7254,6526,341,246,95,168,82,86,219
2021,Bury 015,E02001033,5735,5233,209,148,61,125,58,67,168
2021,Bury 016,E02001034,8072,7367,282,185,97,174,81,93,249
2021,Bury 017,E02001035,6902,6229,345,235,110,148,73,75,180
2021,Bury 018,E02001036,7034,6345,315,216,99,156,66,90,218
2021,Bury 019,E02001037,6868,6234,366,277,89,121,65,56,147
2021,Bury 020,E02001038,5399,4895,248,173,75,101,46,55,155
2021,Bury 021,E02001039,8052,7289,315,212,103,196,101,95,252
2021,Bury 022,E02001040,6035,5553,262,181,81,96,45,51,124
2021,Bury 023,E02001041,7310,6659,295,220,75,144,64,80,212
2021,Bury 024,E02001042,6175,5587,306,216,90,131,57,74,151
2021,Bury 025,E02001043,5320,4860,215,158,57,104,51,53,141
2021,Bury 026,E02001044,8696,7962,376,257,119,155,75,80,203
2021,Manchester 001,E02001045,7879,7142,254,158,96,202,81,121,281
2021,Manchester 002,E02001046,10414,9424,365,233,132,273,123,150,352
2021,Manchester 003,E02001047,9793,8843,364,232,132,266,117,149,320
2021,Manchester 004,E02001048,8683,7982,293,187,106,182,79,103,226
2021,Manchester 005,E02001049,9887,8902,384,254,130,237,99,138,364
2021,Manchester 006,E02001050,7707,7142,209,127,82,168,72,96,188
2021,Manchester 007,E02001051,8579,7819,314,195,119,218,95,123,228
2021,Manchester 008,E02001052,13682,12695,401,236,165,297,136,161,289
2021,Manchester 009,E02001053,10841,9955,242,133,109,302,126,176,342
2021,Manchester 011,E02001055,8974,8240,256,163,93,215,85,130,263
2021,Manchester 012,E02001056,8293,7512,237,134,103,214,88,126,330
2021,Manchester 015,E02001059,10906,10044,300,178,122,221,91,130,341
2021,Manchester 017,E02001061,10119,9330,264,140,124,216,99,117,309
2021,Manchester 018,E02001062,9486,8829,210,127,83,204,78,126,243
2021,Manchester 019,E02001063,10586,10066,304,226,78,111,53,58,105
2021,Manchester 020,E02001064,9853,9078,268,166,102,250,102,148,257
2021,Manchester 021,E02001065,8683,7872,292,180,112,250,134,116,269
2021,Manchester 022,E02001066,10972,10429,193,121,72,172,64,108,178
2021,Manchester 023,E02001067,10601,9773,274,162,112,287,117,170,267
2021,Manchester 024,E02001068,10994,10230,244,146,98,272,107,165,248
2021,Manchester 025,E02001069,11583,10937,292,207,85,196,93,103,158
2021,Manchester 026,E02001070,11577,10907,276,200,76,199,68,131,195
2021,Manchester 028,E02001072,8383,7797,309,220,89,146,66,80,131
2021,Manchester 029,E02001073,8896,8214,416,314,102,123,63,60,143
2021,Manchester 030,E02001074,11101,10118,393,251,142,282,116,166,308
2021,Manchester 031,E02001075,8436,7859,268,186,82,141,64,77,168
2021,Manchester 032,E02001076,10967,10551,238,183,55,92,40,52,86
2021,Manchester 033,E02001077,7008,6446,293,218,75,126,58,68,143
2021,Manchester 034,E02001078,10025,9189,356,242,114,211,102,109,269
2021,Manchester 035,E02001079,8995,8296,293,207,86,168,77,91,238
2021,Manchester 036,E02001080,9419,8986,215,150,65,101,50,51,117
2021,Manchester 037,E02001081,5962,5474,281,208,73,85,39,46,122
2021,Manchester 038,E02001082,6403,6042,194,145,49,70,29,41,97
2021,Manchester 039,E02001083,7818,7430,211,167,44,76,31,45,101
2021,Manchester 040,E02001084,8192,7583,309,238,71,160,70,90,140
2021,Manchester 041,E02001085,8367,7489,329,210,119,239,107,132,310
2021,Manchester 042,E02001086,6560,6058,245,166,79,128,46,82,129
2021,Manchester 043,E02001087,8812,8170,367,271,96,120,51,69,155
2021,Manchester 044,E02001088,8472,7690,314,208,106,194,89,105,274
2021,Manchester 045,E02001089,7550,6917,333,241,92,136,69,67,164
2021,Manchester 046,E02001090,6543,5923,273,205,68,152,79,73,195
2021,Manchester 047,E02001091,7864,7155,333,215,118,158,78,80,218
2021,Manchester 048,E02001092,8572,7826,285,189,96,223,93,130,238
2021,Manchester 049,E02001093,9092,8231,257,169,88,258,116,142,346
2021,Manchester 050,E02001094,9157,8279,243,137,106,271,101,170,364
2021,Manchester 051,E02001095,8432,7631,267,177,90,207,92,115,327
2021,Manchester 052,E02001096,7539,6727,306,205,101,200,94,106,306
2021,Manchester 053,E02001097,7971,7225,261,168,93,207,90,117,278
2021,Oldham 001,E02001098,5704,5051,268,186,82,131,66,65,254
2021,Oldham 002,E02001099,5368,4843,222,157,65,111,58,53,192
2021,Oldham 003,E02001100,5744,5145,289,216,73,123,60,63,187
2021,Oldham 004,E02001101,5422,4902,280,212,68,83,37,46,157
2021,Oldham 005,E02001102,5708,5139,273,202,71,120,64,56,176
2021,Oldham 006,E02001103,5296,4764,293,225,68,94,54,40,145
2021,Oldham 007,E02001104,6821,6165,308,195,113,156,80,76,192
2021,Oldham 008,E02001105,5684,5133,267,197,70,113,52,61,171
2021,Oldham 009,E02001106,5700,5104,271,190,81,117,59,58,208
2021,Oldham 010,E02001107,6441,5904,258,178,80,126,73,53,153
2021,Oldham 011,E02001108,5452,4955,201,127,74,137,66,71,159
2021,Oldham 012,E02001109,7171,6507,273,184,89,177,80,97,214
2021,Oldham 013,E02001110,6181,5650,328,237,91,76,41,35,127
2021,Oldham 014,E02001111,8421,7798,180,111,69,200,79,121,243
2021,Oldham 015,E02001112,5751,5210,276,178,98,108,53,55,157
2021,Oldham 016,E02001113,8692,8017,198,121,77,205,73,132,272
2021,Oldham 017,E02001114,8306,7595,270,186,84,173,73,100,268
2021,Oldham 018,E02001115,5614,5066,278,186,92,109,49,60,161
2021,Oldham 019,E02001116,7132,6580,192,126,66,202,68,134,158
2021,Oldham 020,E02001117,5773,5196,339,264,75,75,45,30,163
2021,Oldham 021,E02001118,5791,5205,325,254,71,93,48,45,168
2021,Oldham 022,E02001119,11223,10315,298,168,130,304,117,187,306
2021,Oldham 024,E02001121,7879,7295,201,136,65,186,79,107,197
2021,Oldham 026,E02001123,6479,5825,214,133,81,178,82,96,262
2021,Oldham 027,E02001124,6374,5824,181,124,57,173,78,95,196
2021,Oldham 028,E02001125,7484,6764,279,185,94,171,80,91,270
2021,Oldham 029,E02001126,8355,7599,249,147,102,213,91,122,294
2021,Oldham 030,E02001127,7200,6434,274,173,101,199,87,112,293
2021,Oldham 031,E02001128,7025,6352,302,189,113,161,73,88,210
2021,Oldham 032,E02001129,6359,5839,207,139,68,146,67,79,167
2021,Oldham 033,E02001130,5561,4929,292,201,91,143,69,74,197
2021,Oldham 034,E02001131,5163,4649,233,151,82,110,52,58,171
2021,Rochdale 001,E02001132,6278,5738,269,197,72,103,64,39,168
2021,Rochdale 002,E02001133,6265,5694,283,195,88,116,65,51,172
2021,Rochdale 003,E02001134,6023,5456,312,216,96,99,47,52,156
2021,Rochdale 004,E02001135,7758,7077,219,146,73,211,84,127,251
2021,Rochdale 005,E02001136,9017,8122,434,301,133,195,86,109,266
2021,Rochdale 006,E02001137,5902,5325,318,232,86,103,48,55,156
2021,Rochdale 007,E02001138,8242,7438,462,317,145,145,82,63,197
2021,Rochdale 008,E02001139,9464,8675,274,161,113,264,112,152,251
2021,Rochdale 009,E02001140,7533,6877,255,173,82,145,71,74,256
2021,Rochdale 010,E02001141,11084,10174,294,169,125,291,139,152,325
2021,Rochdale 011,E02001142,5732,5154,296,209,87,113,64,49,169
2021,Rochdale 012,E02001143,10751,9779,329,205,124,307,126,181,336
2021,Rochdale 013,E02001144,6009,5431,277,189,88,114,51,63,187
2021,Rochdale 014,E02001145,6702,6024,334,249,85,115,64,51,229
2021,Rochdale 015,E02001146,9492,8645,305,178,127,246,109,137,296
2021,Rochdale 016,E02001147,9599,8759,303,201,102,242,103,139,295
2021,Rochdale 017,E02001148,9775,8837,373,248,125,217,98,119,348
2021,Rochdale 018,E02001149,9596,8721,333,229,104,207,100,107,335
2021,Rochdale 019,E02001150,8304,7449,330,220,110,218,99,119,307
2021,Rochdale 020,E02001151,9488,8649,408,286,122,162,82,80,269
2021,Rochdale 021,E02001152,9117,8303,341,227,114,200,74,126,273
2021,Rochdale 022,E02001153,11326,10258,352,213,139,285,106,179,431
2021,Rochdale 023,E02001154,9490,8567,374,254,120,223,101,122,326
2021,Rochdale 024,E02001155,6769,6159,246,161,85,173,72,101,191
2021,Rochdale 025,E02001156,9402,8407,492,351,141,202,96,106,301
2021,Salford 001,E02001157,8036,7204,257,156,101,215,87,128,360
2021,Salford 002,E02001158,5653,5023,238,171,67,161,63,98,231
2021,Salford 003,E02001159,6940,6370,264,176,88,126,56,70,180
2021,Salford 004,E02001160,6674,5950,232,150,82,192,82,110,300
2021,Salford 005,E02001161,5558,4987,270,172,98,116,59,57,185
2021,Salford 006,E02001162,5509,4974,236,158,78,99,46,53,200
2021,Salford 007,E02001163,9295,8424,395,296,99,170,72,98,306
2021,Salford 008,E02001164,7156,6613,218,143,75,129,54,75,196
2021,Salford 009,E02001165,5813,5234,263,176,87,127,56,71,189
2021,Salford 010,E02001166,7353,6844,237,168,69,125,65,60,147
2021,Salford 011,E02001167,6446,5890,229,156,73,128,54,74,199
2021,Salford 012,E02001168,9216,8314,379,266,113,223,96,127,300
2021,Salford 013,E02001169,10296,9405,476,355,121,171,81,90,244
2021,Salford 014,E02001170,9292,8472,464,368,96,123,57,66,233
2021,Salford 015,E02001171,5840,5297,251,174,77,125,73,52,167
2021,Salford 017,E02001173,8941,8284,221,146,75,191,71,120,245
2021,Salford 018,E02001174,5431,4910,271,190,81,107,49,58,143
2021,Salford 019,E02001175,7060,6396,283,204,79,152,55,97,229
2021,Salford 020,E02001176,11156,10130,503,354,149,236,88,148,287
2021,Salford 021,E02001177,12544,11526,408,271,137,246,109,137,364
2021,Salford 023,E02001179,6632,6088,215,144,71,151,52,99,178
2021,Salford 024,E02001180,5205,4856,115,74,41,108,39,69,126
2021,Salford 025,E02001181,5597,5067,195,129,66,138,58,80,197
2021,Salford 026,E02001182,6765,6199,215,148,67,139,52,87,212
2021,Salford 027,E02001183,6760,6191,263,179,84,124,62,62,182
2021,Salford 029,E02001185,9168,8220,404,268,136,192,94,98,352
2021,Salford 030,E02001186,9846,8908,365,248,117,237,111,126,336
2021,Stockport 001,E02001187,6605,5955,321,230,91,141,72,69,188
2021,Stockport 002,E02001188,8068,7385,301,221,80,159,73,86,223
2021,Stockport 003,E02001189,7821,7065,384,272,112,134,67,67,238
2021,Stockport 004,E02001190,7322,6654,210,139,71,197,97,100,261
2021,Stockport 005,E02001191,5474,4907,275,202,73,115,55,60,177
2021,Stockport 006,E02001192,6221,5707,321,249,72,74,38,36,119
2021,Stockport 007,E02001193,6019,5468,260,175,85,116,44,72,175
2021,Stockport 008,E02001194,6044,5525,325,243,82,77,42,35,117
2021,Stockport 009,E02001195,7063,6365,355,252,103,127,63,64,216
2021,Stockport 010,E02001196,7456,6672,433,317,116,143,70,73,208
2021,Stockport 011,E02001197,5936,5381,332,243,89,85,41,44,138
2021,Stockport 012,E02001198,7105,6404,325,234,91,158,69,89,218
2021,Stockport 013,E02001199,7448,6779,399,299,100,120,67,53,150
2021,Stockport 014,E02001200,7369,6753,257,193,64,144,71,73,215
2021,Stockport 015,E02001201,5436,4928,276,216,60,84,44,40,148
2021,Stockport 016,E02001202,6019,5532,232,158,74,123,58,65,132
2021,Stockport 017,E02001203,5579,5018,342,258,84,84,53,31,135
2021,Stockport 018,E02001204,8365,7628,391,295,96,137,67,70,209
2021,Stockport 019,E02001205,7859,7148,360,262,98,145,65,80,206
2021,Stockport 020,E02001206,6888,6218,371,281,90,104,53,51,195
2021,Stockport 021,E02001207,6503,5844,352,255,97,103,52,51,204
2021,Stockport 022,E02001208,7121,6472,311,221,90,138,58,80,200
2021,Stockport 023,E02001209,7263,6582,372,283,89,145,70,75,164
2021,Stockport 024,E02001210,7015,6258,351,243,108,160,72,88,246
2021,Stockport 025,E02001211,6218,5648,328,222,106,95,47,48,147
2021,Stockport 026,E02001212,6506,5804,269,165,104,184,86,98,249
2021,Stockport 027,E02001213,9343,8548,478,365,113,122,59,63,195
2021,Stockport 028,E02001214,7635,6918,363,248,115,139,84,55,215
2021,Stockport 029,E02001215,5708,5107,330,251,79,98,50,48,173
2021,Stockport 030,E02001216,7462,6770,371,273,98,124,54,70,197
2021,Stockport 031,E02001217,6367,5801,276,200,76,127,59,68,163
2021,Stockport 032,E02001218,5724,5175,298,216,82,90,46,44,161
2021,Stockport 033,E02001219,5034,4563,269,195,74,81,41,40,121
2021,Stockport 034,E02001220,5389,4870,306,223,83,66,33,33,147
2021,Stockport 035,E02001221,5623,5020,337,243,94,100,43,57,166
2021,Stockport 036,E02001222,6149,5584,289,202,87,103,53,50,173
2021,Stockport 037,E02001223,6358,5797,333,253,80,101,53,48,127
2021,Stockport 038,E02001224,5623,5008,331,235,96,119,65,54,165
2021,Stockport 039,E02001225,7044,6426,360,280,80,113,62,51,145
2021,Stockport 040,E02001226,6713,6033,334,225,109,143,80,63,203
2021,Stockport 041,E02001227,5395,4886,313,253,60,72,34,38,124
2021,Stockport 042,E02001228,5910,5386,314,236,78,78,42,36,132
2021,Tameside 001,E02001229,9737,8801,522,384,138,173,104,69,241
2021,Tameside 002,E02001230,5602,4999,287,201,86,123,52,71,193
2021,Tameside 003,E02001231,6690,6053,305,235,70,129,48,81,203
2021,Tameside 004,E02001232,8063,7316,300,207,93,208,84,124,239
2021,Tameside 005,E02001233,7550,6814,307,197,110,199,102,97,230
2021,Tameside 006,E02001234,7406,6764,270,194,76,156,79,77,216
2021,Tameside 007,E02001235,6681,6102,291,201,90,116,61,55,172
2021,Tameside 008,E02001236,5642,5076,218,146,72,132,53,79,216
2021,Tameside 009,E02001237,6822,6248,249,179,70,118,45,73,207
2021,Tameside 010,E02001238,7597,6834,379,254,125,175,84,91,209
2021,Tameside 011,E02001239,8980,8088,373,242,131,211,108,103,308
2021,Tameside 012,E02001240,6047,5453,256,156,100,137,65,72,201
2021,Tameside 013,E02001241,10346,9584,264,196,68,239,109,130,259
2021,Tameside 014,E02001242,6635,6027,310,212,98,107,45,62,191
2021,Tameside 015,E02001243,7851,7094,338,240,98,176,95,81,243
2021,Tameside 016,E02001244,5183,4662,267,210,57,93,46,47,161
2021,Tameside 017,E02001245,7535,6770,352,237,115,166,60,106,247
2021,Tameside 018,E02001246,7050,6299,308,201,107,176,75,101,267
2021,Tameside 019,E02001247,6996,6333,331,229,102,146,57,89,186
2021,Tameside 020,E02001248,11130,10131,390,272,118,240,109,131,369
2021,Tameside 021,E02001249,6002,5462,236,153,83,115,49,66,189
2021,Tameside 022,E02001250,6188,5569,345,257,88,116,51,65,158
2021,Tameside 023,E02001251,5789,5254,257,190,67,104,58,46,174
2021,Tameside 024,E02001252,7200,6480,366,239,127,140,65,75,214
2021,Tameside 025,E02001253,4790,4304,224,156,68,100,44,56,162
2021,Tameside 026,E02001254,5315,4774,214,134,80,150,76,74,177
2021,Tameside 027,E02001255,7032,6350,235,161,74,185,82,103,262
2021,Tameside 028,E02001256,9812,8932,343,230,113,237,102,135,300
2021,Tameside 029,E02001257,8655,7795,375,261,114,178,89,89,307
2021,Tameside 030,E02001258,7078,6362,375,284,91,130,66,64,211
2021,Trafford 001,E02001259,10954,10110,383,248,135,225,92,133,236
2021,Trafford 002,E02001260,7146,6468,346,242,104,137,70,67,195
2021,Trafford 003,E02001261,8323,7620,351,227,124,181,81,100,171
2021,Trafford 004,E02001262,8147,7375,340,240,100,186,90,96,246
2021,Trafford 005,E02001263,7964,7207,418,301,117,120,59,61,219
2021,Trafford 006,E02001264,8123,7416,334,226,108,149,69,80,224
2021,Trafford 007,E02001265,7731,6988,374,274,100,161,70,91,208
2021,Trafford 008,E02001266,6492,5896,284,211,73,131,56,75,181
2021,Trafford 009,E02001267,6864,6242,344,263,81,115,52,63,163
2021,Trafford 010,E02001268,6679,6063,344,264,80,86,39,47,186
2021,Trafford 011,E02001269,7912,7232,371,269,102,140,64,76,169
2021,Trafford 012,E02001270,7962,7364,376,288,88,103,42,61,119
2021,Trafford 013,E02001271,6269,5697,271,183,88,122,64,58,179
2021,Trafford 014,E02001272,7546,6946,342,261,81,101,50,51,157
2021,Trafford 015,E02001273,8975,8353,356,273,83,124,53,71,142
2021,Trafford 016,E02001274,7719,7011,405,298,107,110,68,42,193
2021,Trafford 017,E02001275,7640,6843,282,189,93,209,105,104,306
2021,Trafford 018,E02001276,7582,6903,305,206,99,165,91,74,209
2021,Trafford 019,E02001277,8755,8047,333,244,89,165,68,97,210
2021,Trafford 020,E02001278,8193,7590,386,301,85,83,43,40,134
2021,Trafford 021,E02001279,7843,7163,420,322,98,106,51,55,154
2021,Trafford 022,E02001280,7999,7270,371,255,116,136,75,61,222
2021,Trafford 023,E02001281,7359,6710,373,290,83,117,54,63,159
2021,Trafford 024,E02001282,9428,8794,367,279,88,110,47,63,157
2021,Trafford 025,E02001283,9037,8342,425,326,99,120,73,47,150
2021,Trafford 026,E02001284,7642,7061,401,310,91,76,39,37,104
2021,Trafford 027,E02001285,7464,6852,372,285,87,108,53,55,132
2021,Trafford 028,E02001286,7848,7202,379,285,94,104,53,51,163
2021,Wigan 001,E02001287,6242,5647,332,253,79,104,50,54,159
2021,Wigan 002,E02001288,7931,7165,416,288,128,139,69,70,211
2021,Wigan 003,E02001289,9693,8604,582,427,155,208,112,96,299
2021,Wigan 004,E02001290,5862,5212,320,232,88,139,62,77,191
2021,Wigan 005,E02001291,7388,6571,279,181,98,230,97,133,308
2021,Wigan 006,E02001292,7629,6928,359,262,97,136,60,76,206
2021,Wigan 007,E02001293,5959,5292,335,236,99,146,80,66,186
2021,Wigan 008,E02001294,7546,6831,353,245,108,145,56,89,217
2021,Wigan 009,E02001295,6847,6179,223,123,100,170,71,99,275
2021,Wigan 010,E02001296,8329,7498,202,117,85,269,98,171,360
2021,Wigan 011,E02001297,6261,5620,257,171,86,161,82,79,223
2021,Wigan 012,E02001298,7624,6867,250,169,81,217,71,146,290
2021,Wigan 013,E02001299,8262,7427,373,249,124,186,79,107,276
2021,Wigan 014,E02001300,7471,6706,300,209,91,182,83,99,283
2021,Wigan 015,E02001301,8449,7700,301,194,107,189,71,118,259
2021,Wigan 016,E02001302,7541,6693,296,186,110,240,97,143,312
2021,Wigan 017,E02001303,8429,7606,301,199,102,201,73,128,321
2021,Wigan 018,E02001304,12166,10910,674,489,185,218,113,105,364
2021,Wigan 019,E02001305,8094,7206,403,273,130,187,90,97,298
2021,Wigan 020,E02001306,6831,6044,327,212,115,181,80,101,279
2021,Wigan 021,E02001307,11081,9989,564,371,193,212,105,107,316
2021,Wigan 022,E02001308,5695,5092,254,169,85,161,58,103,188
2021,Wigan 023,E02001309,7915,7191,335,229,106,155,77,78,234
2021,Wigan 024,E02001310,8615,7758,316,186,130,224,96,128,317
2021,Wigan 025,E02001311,7753,7011,344,238,106,158,70,88,240
2021,Wigan 026,E02001312,8151,7385,293,195,98,191,85,106,282
2021,Wigan 027,E02001313,7694,6796,324,208,116,226,93,133,348
2021,Wigan 028,E02001314,7559,6864,351,251,100,128,51,77,216
2021,Wigan 029,E02001315,8867,8047,382,263,119,176,85,91,262
2021,Wigan 030,E02001316,6855,6330,215,139,76,145,57,88,165
2021,Wigan 031,E02001317,8515,7675,363,266,97,185,80,105,292
2021,Wigan 032,E02001318,7488,6707,362,243,119,164,79,85,255
2021,Wigan 033,E02001319,7765,6980,320,197,123,178,82,96,287
2021,Wigan 034,E02001320,6995,6325,316,206,110,125,63,62,229
2021,Wigan 035,E02001321,7637,6864,364,257,107,153,71,82,256
2021,Wigan 036,E02001322,6914,6158,365,263,102,148,78,70,243
2021,Wigan 037,E02001323,7345,6577,370,268,102,164,74,90,234
2021,Wigan 038,E02001324,7844,7020,343,237,106,191,82,109,290
2021,Wigan 039,E02001325,8533,7656,464,331,133,166,97,69,247
2021,Wigan 040,E02001326,7771,6941,399,285,114,157,74,83,274
2021,Knowsley 001,E02001327,8635,7608,294,178,116,314,145,169,419
2021,Knowsley 002,E02001328,9871,8788,448,276,172,253,111,142,382
2021,Knowsley 003,E02001329,6987,6171,246,124,122,243,111,132,327
2021,Knowsley 004,E02001330,8484,7551,301,175,126,280,123,157,352
2021,Knowsley 005,E02001331,9534,8360,399,228,171,314,143,171,461
2021,Knowsley 006,E02001332,7044,6269,229,126,103,210,93,117,336
2021,Knowsley 007,E02001333,8848,7925,365,225,140,233,125,108,325
2021,Knowsley 008,E02001334,6103,5406,185,101,84,198,85,113,314
2021,Knowsley 009,E02001335,7783,6934,406,271,135,198,97,101,245
2021,Knowsley 010,E02001336,6440,5724,176,104,72,206,91,115,334
2021,Knowsley 011,E02001337,5518,4882,218,131,87,178,83,95,240
2021,Knowsley 012,E02001338,5720,5065,244,149,95,175,89,86,236
2021,Knowsley 013,E02001339,6020,5294,291,180,111,171,75,96,264
2021,Knowsley 014,E02001340,9111,8169,448,276,172,185,87,98,309
2021,Knowsley 015,E02001341,7033,6223,302,161,141,219,90,129,289
2021,Knowsley 016,E02001342,7446,6572,429,291,138,182,93,89,263
2021,Knowsley 017,E02001343,6887,6057,425,279,146,177,89,88,228
2021,Knowsley 018,E02001344,5216,4637,260,168,92,134,59,75,185
2021,Knowsley 019,E02001345,5124,4536,260,176,84,145,76,69,183
2021,Knowsley 020,E02001346,6983,6163,277,172,105,252,117,135,291
2021,Liverpool 001,E02001347,7531,6652,323,206,117,237,102,135,319
2021,Liverpool 002,E02001348,6335,5662,277,186,91,169,97,72,227
2021,Liverpool 003,E02001349,7709,6877,361,241,120,198,84,114,273
2021,Liverpool 004,E02001350,7588,6731,274,158,116,252,99,153,331
2021,Liverpool 005,E02001351,8448,7488,307,178,129,261,121,140,392
2021,Liverpool 006,E02001352,6040,5462,212,140,72,171,76,95,195
2021,Liverpool 007,E02001353,6869,6020,389,262,127,205,95,110,255
2021,Liverpool 008,E02001354,7403,6480,296,176,120,262,133,129,365
2021,Liverpool 009,E02001355,5971,5290,258,172,86,206,77,129,217
2021,Liverpool 010,E02001356,8279,7527,232,148,84,216,91,125,304
2021,Liverpool 011,E02001357,6795,5966,244,137,107,253,110,143,332
2021,Liverpool 012,E02001358,6526,5910,189,127,62,205,74,131,222
2021,Liverpool 013,E02001359,5268,4625,249,164,85,168,72,96,226
2021,Liverpool 014,E02001360,8221,7350,283,164,119,286,120,166,302
2021,Liverpool 015,E02001361,6867,6081,296,194,102,179,84,95,311
2021,Liverpool 016,E02001362,7197,6247,379,233,146,221,106,115,350
2021,Liverpool 017,E02001363,7371,6564,243,141,102,244,110,134,320
2021,Liverpool 018,E02001364,5781,5266,153,89,64,162,75,87,200
2021,Liverpool 019,E02001365,8613,7884,251,149,102,215,99,116,263
2021,Liverpool 020,E02001366,8267,7384,354,230,124,217,112,105,312
2021,Liverpool 021,E02001367,9236,8137,552,362,190,259,126,133,288
2021,Liverpool 022,E02001368,6761,6054,191,110,81,241,97,144,275
2021,Liverpool 023,E02001369,7635,6764,244,139,105,272,98,174,355
2021,Liverpool 024,E02001370,6650,5951,207,128,79,231,81,150,261
2021,Liverpool 025,E02001371,7133,6405,259,159,100,222,107,115,247
2021,Liverpool 026,E02001372,5758,5139,250,157,93,152,59,93,217
2021,Liverpool 027,E02001373,8432,7558,346,218,128,227,114,113,301
2021,Liverpool 028,E02001374,8109,7472,219,145,74,164,59,105,254
2021,Liverpool 029,E02001375,6538,5756,303,194,109,194,91,103,285
2021,Liverpool 030,E02001376,8765,8164,177,100,77,188,81,107,236
2021,Liverpool 031,E02001377,12069,11466,269,189,80,135,63,72,199
2021,Liverpool 032,E02001378,6994,6218,331,209,122,201,103,98,244
2021,Liverpool 034,E02001380,7115,6277,399,284,115,173,80,93,266
2021,Liverpool 035,E02001381,9181,8464,267,171,96,214,83,131,236
2021,Liverpool 036,E02001382,6498,5751,412,289,123,133,64,69,202
2021,Liverpool 037,E02001383,9268,8755,250,172,78,139,72,67,124
2021,Liverpool 038,E02001384,10460,9873,267,178,89,165,71,94,155
2021,Liverpool 039,E02001385,8365,7712,194,122,72,217,90,127,242
2021,Liverpool 040,E02001386,7744,6759,310,178,132,251,115,136,424
2021,Liverpool 041,E02001387,7507,6723,449,312,137,148,71,77,187
2021,Liverpool 042,E02001388,7880,7292,330,242,88,125,67,58,133
2021,Liverpool 043,E02001389,6240,5813,219,171,48,106,42,64,102
2021,Liverpool 044,E02001390,9067,8200,275,159,116,271,114,157,321
2021,Liverpool 045,E02001391,5614,4934,227,135,92,181,68,113,272
2021,Liverpool 046,E02001392,5982,5304,337,214,123,134,68,66,207
2021,Liverpool 047,E02001393,7182,6462,449,335,114,119,56,63,152
2021,Liverpool 048,E02001394,8331,7637,377,277,100,143,72,71,174
2021,Liverpool 049,E02001395,5596,5046,301,219,82,93,44,49,156
2021,Liverpool 050,E02001396,7248,6630,245,163,82,180,84,96,193
2021,Liverpool 051,E02001397,6824,6100,358,240,118,136,70,66,230
2021,Liverpool 052,E02001398,7145,6526,294,204,90,152,75,77,173
2021,Liverpool 053,E02001399,6611,5858,380,263,117,138,75,63,235
2021,Liverpool 054,E02001400,6463,5725,298,191,107,186,80,106,254
2021,Liverpool 055,E02001401,7513,6725,370,250,120,149,63,86,269
2021,Liverpool 056,E02001402,8580,7746,458,326,132,156,71,85,220
2021,Liverpool 057,E02001403,6017,5385,246,159,87,150,76,74,236
2021,Liverpool 058,E02001404,7334,6546,279,163,116,210,101,109,299
2021,Liverpool 059,E02001405,9135,8185,263,145,118,285,124,161,402
2021,St. Helens 001,E02001406,7574,6660,491,349,142,184,93,91,239
2021,St. Helens 002,E02001407,5658,4947,352,251,101,124,71,53,235
2021,St. Helens 003,E02001408,5226,4598,321,224,97,114,55,59,193
2021,St. Helens 004,E02001409,9746,8547,466,302,164,306,133,173,427
2021,St. Helens 005,E02001410,5460,4784,236,157,79,173,69,104,267
2021,St. Helens 006,E02001411,5525,4901,279,192,87,150,66,84,195
2021,St. Helens 007,E02001412,8592,7552,493,344,149,250,110,140,297
2021,St. Helens 008,E02001413,8847,7688,469,319,150,266,127,139,424
2021,St. Helens 009,E02001414,5304,4670,348,242,106,106,58,48,180
2021,St. Helens 010,E02001415,6561,5823,306,217,89,181,85,96,251
2021,St. Helens 011,E02001416,5981,5234,251,146,105,203,87,116,293
2021,St. Helens 012,E02001417,6960,6214,291,203,88,200,63,137,255
2021,St. Helens 013,E02001418,6109,5509,250,179,71,132,48,84,218
2021,St. Helens 014,E02001419,7127,6382,282,173,109,213,100,113,250
2021,St. Helens 015,E02001420,11103,9958,521,358,163,265,114,151,359
2021,St. Helens 016,E02001421,9983,8740,547,373,174,309,147,162,387
2021,St. Helens 017,E02001422,6242,5475,255,145,110,182,72,110,330
2021,St. Helens 018,E02001423,6279,5527,402,291,111,125,58,67,225
2021,St. Helens 020,E02001425,10147,8893,545,356,189,287,129,158,422
2021,St. Helens 021,E02001426,5190,4567,296,206,90,131,60,71,196
2021,St. Helens 022,E02001427,10259,9036,490,325,165,296,107,189,437
2021,St. Helens 023,E02001428,5361,4672,370,270,100,117,61,56,202
2021,Sefton 001,E02001429,6399,5667,333,224,109,162,87,75,237
2021,Sefton 002,E02001430,6594,5856,381,273,108,120,51,69,237
2021,Sefton 003,E02001431,7252,6497,380,272,108,132,69,63,243
2021,Sefton 004,E02001432,9175,8403,297,201,96,229,87,142,246
2021,Sefton 005,E02001433,7009,6284,366,249,117,141,62,79,218
2021,Sefton 006,E02001434,6984,6227,364,249,115,182,84,98,211
2021,Sefton 007,E02001435,8366,7502,369,255,114,231,104,127,264
2021,Sefton 008,E02001436,9163,8146,476,346,130,202,90,112,339
2021,Sefton 009,E02001437,9012,8091,480,354,126,178,87,91,263
2021,Sefton 010,E02001438,6865,6101,381,268,113,163,79,84,220
2021,Sefton 011,E02001439,6293,5642,287,201,86,144,64,80,220
2021,Sefton 012,E02001440,5846,5140,345,250,95,139,64,75,222
2021,Sefton 013,E02001441,6147,5501,354,254,100,107,46,61,185
2021,Sefton 014,E02001442,5814,5237,279,193,86,102,55,47,196
2021,Sefton 015,E02001443,5447,4844,301,203,98,107,46,61,195
2021,Sefton 016,E02001444,5359,4755,332,233,99,116,54,62,156
2021,Sefton 017,E02001445,6569,5812,404,279,125,138,89,49,215
2021,Sefton 018,E02001446,6925,6193,372,265,107,145,76,69,215
2021,Sefton 019,E02001447,5823,5161,329,230,99,143,79,64,190
2021,Sefton 020,E02001448,6453,5739,366,253,113,145,76,69,203
2021,Sefton 021,E02001449,8874,7788,531,335,196,221,106,115,334
2021,Sefton 022,E02001450,8064,7214,481,345,136,157,85,72,212
2021,Sefton 023,E02001451,5650,4984,220,134,86,190,83,107,256
2021,Sefton 024,E02001452,5940,5215,252,158,94,196,94,102,277
2021,Sefton 025,E02001453,8336,7456,477,348,129,172,93,79,231
2021,Sefton 026,E02001454,6931,6116,365,246,119,175,101,74,275
2021,Sefton 027,E02001455,6743,5913,396,266,130,187,86,101,247
2021,Sefton 028,E02001456,7035,6248,391,283,108,167,74,93,229
2021,Sefton 029,E02001457,6421,5680,274,165,109,189,79,110,278
2021,Sefton 030,E02001458,7247,6532,340,236,104,160,71,89,215
2021,Sefton 031,E02001459,6492,5695,308,202,106,185,88,97,304
2021,Sefton 032,E02001460,7555,6742,295,185,110,238,98,140,280
2021,Sefton 033,E02001461,6526,5828,331,208,123,149,65,84,218
2021,Sefton 034,E02001462,7098,6381,219,124,95,211,110,101,287
2021,Sefton 035,E02001463,7002,6152,303,179,124,232,122,110,315
2021,Sefton 036,E02001464,6577,5875,264,157,107,183,75,108,255
2021,Sefton 037,E02001465,7251,6494,232,139,93,222,92,130,303
2021,Sefton 038,E02001466,8481,7591,287,191,96,237,96,141,366
2021,Wirral 001,E02001467,7295,6440,405,267,138,177,86,91,273
2021,Wirral 002,E02001468,7228,6455,369,253,116,162,78,84,242
2021,Wirral 003,E02001469,7311,6462,438,307,131,180,69,111,231
2021,Wirral 004,E02001470,7902,7028,453,300,153,166,63,103,255
2021,Wirral 005,E02001471,6939,6132,348,215,133,181,65,116,278
2021,Wirral 006,E02001472,6657,5843,336,220,116,182,89,93,296
2021,Wirral 007,E02001473,7200,6421,340,221,119,175,84,91,264
2021,Wirral 008,E02001474,6451,5779,220,131,89,171,66,105,281
2021,Wirral 009,E02001475,6011,5291,238,157,81,164,67,97,318
2021,Wirral 010,E02001476,7384,6559,252,167,85,259,102,157,314
2021,Wirral 011,E02001477,7074,6255,231,134,97,243,89,154,345
2021,Wirral 012,E02001478,7791,6841,394,259,135,199,90,109,357
2021,Wirral 013,E02001479,5733,5068,346,254,92,134,73,61,185
2021,Wirral 014,E02001480,7312,6505,445,316,129,142,61,81,220
2021,Wirral 015,E02001481,7739,6909,375,257,118,206,100,106,249
2021,Wirral 016,E02001482,7575,6776,247,153,94,280,128,152,272
2021,Wirral 017,E02001483,6870,6047,392,291,101,179,86,93,252
2021,Wirral 018,E02001484,7659,6834,389,263,126,161,83,78,275
2021,Wirral 019,E02001485,6405,5666,247,157,90,206,68,138,286
2021,Wirral 020,E02001486,7711,6982,392,272,120,150,75,75,187
2021,Wirral 021,E02001487,8677,7744,364,226,138,234,100,134,335
2021,Wirral 022,E02001488,7918,7097,346,237,109,204,83,121,271
2021,Wirral 023,E02001489,7760,6855,501,354,147,151,82,69,253
2021,Wirral 024,E02001490,7838,6972,396,278,118,185,112,73,285
2021,Wirral 025,E02001491,6342,5700,214,131,83,178,73,105,250
2021,Wirral 026,E02001492,7250,6497,435,325,110,117,68,49,201
2021,Wirral 027,E02001493,8341,7419,305,200,105,259,93,166,358
2021,Wirral 028,E02001494,6750,6031,432,332,100,117,57,60,170
2021,Wirral 029,E02001495,7579,6722,359,236,123,237,118,119,261
2021,Wirral 030,E02001496,5803,5141,340,238,102,137,70,67,185
2021,Wirral 031,E02001497,7654,6840,302,213,89,213,99,114,299
2021,Wirral 032,E02001498,6910,6162,368,263,105,143,56,87,237
2021,Wirral 033,E02001499,6338,5627,378,269,109,115,60,55,218
2021,Wirral 034,E02001500,6986,6162,426,286,140,153,83,70,245
2021,Wirral 035,E02001501,7359,6518,457,341,116,133,67,66,251
2021,Wirral 036,E02001502,9142,8231,434,298,136,200,105,95,277
2021,Wirral 037,E02001503,7238,6476,415,308,107,133,69,64,214
2021,Wirral 038,E02001504,6699,5996,387,296,91,122,70,52,194
2021,Wirral 039,E02001505,6156,5445,313,218,95,155,70,85,243
2021,Wirral 040,E02001506,8525,7706,495,385,110,109,47,62,215
2021,Wirral 041,E02001507,6692,5976,397,264,133,130,73,57,189
2021,Wirral 042,E02001508,7686,6774,378,276,102,190,89,101,344
2021,Barnsley 001,E02001509,6585,5891,330,230,100,160,62,98,204
2021,Barnsley 002,E02001510,5590,4885,280,171,109,165,69,96,260
2021,Barnsley 003,E02001511,5814,5152,270,182,88,147,69,78,245
2021,Barnsley 004,E02001512,8067,7196,416,309,107,180,82,98,275
2021,Barnsley 005,E02001513,7253,6429,411,294,117,154,68,86,259
2021,Barnsley 006,E02001514,7215,6396,274,186,88,228,88,140,317
2021,Barnsley 007,E02001515,9034,7962,329,229,100,280,121,159,463
2021,Barnsley 008,E02001516,5904,5283,246,160,86,153,61,92,222
2021,Barnsley 009,E02001517,7625,6791,343,232,111,182,89,93,309
2021,Barnsley 010,E02001518,9670,8651,473,344,129,262,106,156,284
2021,Barnsley 011,E02001519,7419,6608,269,154,115,210,82,128,332
2021,Barnsley 012,E02001520,11131,9934,613,429,184,226,116,110,358
2021,Barnsley 013,E02001521,11392,10488,430,290,140,213,105,108,261
2021,Barnsley 014,E02001522,8867,7873,308,187,121,275,106,169,411
2021,Barnsley 015,E02001523,6432,5820,300,218,82,140,65,75,172
2021,Barnsley 016,E02001524,5893,5247,379,296,83,103,53,50,164
2021,Barnsley 017,E02001525,6390,5826,223,148,75,141,57,84,200
2021,Barnsley 018,E02001526,5812,5181,193,117,76,168,67,101,270
2021,Barnsley 019,E02001527,5726,5109,294,182,112,125,55,70,198
2021,Barnsley 020,E02001528,10113,8995,423,288,135,292,132,160,403
2021,Barnsley 021,E02001529,8962,7985,376,259,117,252,121,131,349
2021,Barnsley 022,E02001530,6676,5980,234,144,90,187,59,128,275
2021,Barnsley 023,E02001531,7237,6470,267,168,99,224,82,142,276
2021,Barnsley 024,E02001532,9997,9048,486,359,127,167,84,83,296
2021,Barnsley 025,E02001533,7300,6535,281,189,92,226,99,127,258
2021,Barnsley 026,E02001534,9036,8012,425,261,164,255,106,149,344
2021,Barnsley 027,E02001535,6248,5559,377,256,121,119,51,68,193
2021,Barnsley 028,E02001536,8234,7298,454,322,132,188,77,111,294
2021,Barnsley 029,E02001537,7984,7117,410,289,121,192,90,102,265
2021,Barnsley 030,E02001538,7519,6657,349,240,109,202,87,115,311
2021,Doncaster 001,E02001539,6270,5625,203,142,61,195,86,109,247
2021,Doncaster 002,E02001540,11349,10153,513,352,161,261,102,159,422
2021,Doncaster 003,E02001541,10837,9737,421,274,147,281,108,173,398
2021,Doncaster 004,E02001542,6982,6234,275,188,87,179,78,101,294
2021,Doncaster 005,E02001543,7373,6575,294,188,106,192,86,106,312
2021,Doncaster 006,E02001544,7875,7061,274,183,91,230,90,140,310
2021,Doncaster 007,E02001545,8085,7350,384,252,132,132,57,75,219
2021,Doncaster 008,E02001546,8550,7805,337,231,106,141,72,69,267
2021,Doncaster 009,E02001547,10208,9182,385,241,144,261,109,152,380
2021,Doncaster 010,E02001548,7360,6604,276,173,103,197,90,107,283
2021,Doncaster 011,E02001549,5958,5333,299,221,78,114,54,60,212
2021,Doncaster 012,E02001550,7337,6669,275,173,102,143,65,78,250
2021,Doncaster 013,E02001551,5582,5060,218,150,68,117,62,55,187
2021,Doncaster 014,E02001552,7198,6539,256,159,97,145,71,74,258
2021,Doncaster 015,E02001553,9555,8621,380,248,132,204,91,113,350
2021,Doncaster 016,E02001554,5759,5143,309,221,88,119,58,61,188
2021,Doncaster 017,E02001555,5021,4514,237,164,73,106,59,47,164
2021,Doncaster 018,E02001556,8617,7821,270,190,80,218,104,114,308
2021,Doncaster 019,E02001557,9592,8877,329,211,118,177,78,99,209
2021,Doncaster 020,E02001558,5765,5071,335,236,99,152,68,84,207
2021,Doncaster 021,E02001559,7208,6479,414,309,105,104,49,55,211
2021,Doncaster 022,E02001560,11064,10377,240,171,69,196,69,127,251
2021,Doncaster 023,E02001561,5848,5410,188,133,55,122,41,81,128
2021,Doncaster 024,E02001562,5513,4930,280,185,95,133,63,70,170
2021,Doncaster 025,E02001563,7695,6960,373,262,111,135,75,60,227
2021,Doncaster 026,E02001564,7846,7078,432,324,108,127,61,66,209
2021,Doncaster 027,E02001565,7438,6741,362,266,96,114,62,52,221
2021,Doncaster 028,E02001566,8021,7387,269,191,78,168,58,110,197
2021,Doncaster 029,E02001567,8170,7382,275,180,95,185,87,98,328
2021,Doncaster 030,E02001568,6356,5748,205,150,55,157,65,92,246
2021,Doncaster 031,E02001569,8107,7275,307,181,126,223,87,136,302
2021,Doncaster 032,E02001570,6585,5880,242,159,83,193,72,121,270
2021,Doncaster 033,E02001571,5642,5062,287,219,68,111,53,58,182
2021,Doncaster 034,E02001572,7296,6635,219,133,86,178,75,103,264
2021,Doncaster 035,E02001573,7224,6450,296,199,97,199,88,111,279
2021,Doncaster 036,E02001574,5746,5130,315,208,107,121,52,69,180
2021,Doncaster 037,E02001575,7351,6646,231,144,87,200,67,133,274
2021,Doncaster 038,E02001576,6574,5985,297,220,77,117,58,59,175
2021,Doncaster 039,E02001577,6210,5500,342,251,91,126,62,64,242
2021,Rotherham 001,E02001578,10992,9898,437,307,130,271,111,160,386
2021,Rotherham 002,E02001579,9460,8383,438,285,153,243,100,143,396
2021,Rotherham 003,E02001580,8104,7218,414,304,110,166,65,101,306
2021,Rotherham 004,E02001581,5889,5247,231,155,76,165,65,100,246
2021,Rotherham 005,E02001582,7312,6526,330,227,103,185,92,93,271
2021,Rotherham 006,E02001583,5239,4647,224,143,81,140,56,84,228
2021,Rotherham 007,E02001584,6432,5739,368,272,96,133,68,65,192
2021,Rotherham 008,E02001585,5907,5302,196,127,69,154,53,101,255
2021,Rotherham 009,E02001586,7433,6599,307,213,94,213,89,124,314
2021,Rotherham 010,E02001587,5482,4834,166,99,67,192,61,131,290
2021,Rotherham 011,E02001588,6788,6021,261,171,90,200,82,118,306
2021,Rotherham 012,E02001589,7626,6844,394,290,104,140,63,77,248
2021,Rotherham 013,E02001590,6989,6204,192,124,68,218,74,144,375
2021,Rotherham 014,E02001591,7689,6894,250,163,87,254,109,145,291
2021,Rotherham 015,E02001592,8140,7309,368,249,119,172,72,100,291
2021,Rotherham 016,E02001593,6702,6088,207,123,84,214,82,132,193
2021,Rotherham 017,E02001594,6882,6309,191,118,73,192,93,99,190
2021,Rotherham 018,E02001595,7903,7044,419,279,140,173,87,86,267
2021,Rotherham 019,E02001596,7940,7096,360,263,97,159,67,92,325
2021,Rotherham 020,E02001597,8877,7917,358,222,136,246,83,163,356
2021,Rotherham 021,E02001598,9119,8138,439,315,124,209,94,115,333
2021,Rotherham 023,E02001600,10499,9474,445,292,153,250,117,133,330
2021,Rotherham 025,E02001602,8533,7668,394,268,126,185,72,113,286
2021,Rotherham 026,E02001603,6991,6258,280,181,99,183,67,116,270
2021,Rotherham 027,E02001604,10922,9924,492,336,156,226,114,112,280
2021,Rotherham 028,E02001605,7100,6331,346,251,95,144,57,87,279
2021,Rotherham 029,E02001606,7619,6871,335,223,112,141,53,88,272
2021,Rotherham 030,E02001607,8428,7563,364,243,121,191,83,108,310
2021,Rotherham 031,E02001608,6693,5995,333,237,96,143,67,76,222
2021,Rotherham 032,E02001609,8170,7298,419,320,99,145,69,76,308
2021,Rotherham 033,E02001610,8265,7364,412,300,112,178,98,80,311
2021,Sheffield 001,E02001611,7291,6520,360,253,107,160,77,83,251
2021,Sheffield 002,E02001612,5380,4850,286,224,62,73,42,31,171
2021,Sheffield 003,E02001613,9685,8602,487,350,137,215,117,98,381
2021,Sheffield 004,E02001614,10584,9448,605,449,156,186,101,85,345
2021,Sheffield 005,E02001615,6900,6102,441,316,125,125,77,48,232
2021,Sheffield 006,E02001616,6917,6148,315,215,100,175,77,98,279
2021,Sheffield 007,E02001617,5447,4933,174,109,65,139,61,78,201
2021,Sheffield 008,E02001618,9346,8341,583,451,132,158,88,70,264
2021,Sheffield 009,E02001619,9499,8466,312,197,115,317,126,191,404
2021,Sheffield 010,E02001620,6545,5838,235,153,82,204,101,103,268
2021,Sheffield 011,E02001621,5610,4997,228,133,95,146,60,86,239
2021,Sheffield 012,E02001622,8428,7574,324,202,122,213,82,131,317
2021,Sheffield 013,E02001623,7676,6886,234,151,83,271,90,181,285
2021,Sheffield 014,E02001624,8799,7936,365,246,119,201,86,115,297
2021,Sheffield 015,E02001625,7340,6504,244,141,103,227,89,138,365
2021,Sheffield 016,E02001626,5530,4939,301,223,78,101,48,53,189
2021,Sheffield 017,E02001627,5695,5192,244,177,67,110,53,57,149
2021,Sheffield 018,E02001628,6010,5449,167,110,57,162,76,86,232
2021,Sheffield 019,E02001629,6088,5473,220,148,72,169,79,90,226
2021,Sheffield 020,E02001630,8546,7792,264,156,108,280,114,166,210
2021,Sheffield 021,E02001631,7191,6444,379,290,89,146,81,65,222
2021,Sheffield 022,E02001632,11310,10426,308,187,121,317,114,203,259
2021,Sheffield 023,E02001633,7250,6415,479,380,99,129,67,62,227
2021,Sheffield 024,E02001634,8518,7825,404,305,99,109,56,53,180
2021,Sheffield 025,E02001635,5733,5089,326,226,100,114,68,46,204
2021,Sheffield 026,E02001636,8837,8180,285,190,95,166,68,98,206
2021,Sheffield 027,E02001637,7837,7104,230,141,89,236,96,140,267
2021,Sheffield 028,E02001638,5516,5238,168,134,34,49,26,23,61
2021,Sheffield 029,E02001639,5707,5294,252,195,57,62,28,34,99
2021,Sheffield 030,E02001640,8079,7715,228,184,44,71,37,34,65
2021,Sheffield 032,E02001642,9696,8720,445,302,143,213,92,121,318
2021,Sheffield 033,E02001643,5928,5339,383,290,93,83,37,46,123
2021,Sheffield 036,E02001646,7511,7159,248,201,47,50,23,27,54
2021,Sheffield 037,E02001647,5884,5219,327,219,108,117,47,70,221
2021,Sheffield 038,E02001648,8012,7481,368,295,73,68,40,28,95
2021,Sheffield 039,E02001649,10219,9168,315,201,114,310,129,181,426
2021,Sheffield 040,E02001650,9213,8759,246,177,69,114,48,66,94
2021,Sheffield 041,E02001651,7701,6940,478,372,106,110,57,53,173
2021,Sheffield 042,E02001652,12438,11867,302,229,73,152,79,73,117
2021,Sheffield 043,E02001653,6933,6299,231,151,80,183,78,105,220
2021,Sheffield 044,E02001654,5991,5338,247,169,78,144,63,81,262
2021,Sheffield 045,E02001655,7134,6394,291,195,96,169,86,83,280
2021,Sheffield 046,E02001656,7383,6826,373,286,87,77,43,34,107
2021,Sheffield 047,E02001657,8549,7825,461,369,92,108,60,48,155
2021,Sheffield 048,E02001658,4899,4356,150,84,66,151,58,93,242
2021,Sheffield 049,E02001659,5523,4957,237,167,70,124,52,72,205
2021,Sheffield 050,E02001660,9314,8563,451,348,103,125,55,70,175
2021,Sheffield 051,E02001661,7155,6424,313,211,102,178,81,97,240
2021,Sheffield 052,E02001662,7065,6312,315,202,113,155,71,84,283
2021,Sheffield 053,E02001663,6941,6381,343,257,86,94,55,39,123
2021,Sheffield 054,E02001664,5871,5194,314,213,101,138,64,74,225
2021,Sheffield 055,E02001665,9355,8422,607,463,144,140,80,60,186
2021,Sheffield 056,E02001666,5618,4992,257,176,81,152,56,96,217
2021,Sheffield 059,E02001669,7372,6750,341,249,92,121,48,73,160
2021,Sheffield 060,E02001670,5599,4960,202,126,76,148,74,74,289
2021,Sheffield 061,E02001671,5424,4754,324,231,93,120,65,55,226
2021,Sheffield 062,E02001672,5703,5070,325,249,76,112,54,58,196
2021,Sheffield 063,E02001673,4948,4428,294,211,83,98,54,44,128
2021,Sheffield 064,E02001674,8630,7729,527,379,148,139,60,79,235
2021,Sheffield 065,E02001675,8016,7079,409,288,121,187,87,100,341
2021,Sheffield 066,E02001676,5617,5023,347,263,84,102,58,44,145
2021,Sheffield 068,E02001678,9985,9002,587,454,133,147,83,64,249
2021,Sheffield 069,E02001679,5878,5259,261,191,70,137,64,73,221
2021,Sheffield 070,E02001680,5794,5168,216,152,64,165,81,84,245
2021,Sheffield 071,E02001681,7243,6520,464,315,149,98,47,51,161
2021,Gateshead 001,E02001682,8088,7308,389,298,91,159,82,77,232
2021,Gateshead 002,E02001683,8872,8016,465,319,146,169,78,91,222
2021,Gateshead 003,E02001684,6270,5692,209,147,62,170,73,97,199
2021,Gateshead 004,E02001685,7580,6812,288,197,91,191,69,122,289
2021,Gateshead 005,E02001686,6464,5787,332,229,103,144,58,86,201
2021,Gateshead 007,E02001688,7212,6553,270,194,76,174,66,108,215
2021,Gateshead 008,E02001689,6952,6326,255,174,81,176,79,97,195
2021,Gateshead 009,E02001690,6694,6013,321,218,103,158,59,99,202
2021,Gateshead 010,E02001691,7905,7264,259,189,70,170,72,98,212
2021,Gateshead 011,E02001692,5908,5250,216,125,91,189,81,108,253
2021,Gateshead 012,E02001693,4999,4402,218,164,54,148,54,94,231
2021,Gateshead 013,E02001694,5908,5193,317,217,100,149,71,78,249
2021,Gateshead 014,E02001695,5558,4964,287,191,96,123,50,73,184
2021,Gateshead 015,E02001696,8640,7707,369,251,118,225,87,138,339
2021,Gateshead 016,E02001697,7052,6365,361,242,119,147,82,65,179
2021,Gateshead 017,E02001698,6699,6008,358,248,110,137,80,57,196
2021,Gateshead 018,E02001699,6239,5519,275,175,100,169,92,77,276
2021,Gateshead 019,E02001700,9732,8751,487,348,139,193,86,107,301
2021,Gateshead 020,E02001701,5975,5399,331,255,76,91,41,50,154
2021,Gateshead 021,E02001702,7418,6597,266,163,103,215,91,124,340
2021,Gateshead 022,E02001703,5354,4751,309,233,76,84,41,43,210
2021,Gateshead 023,E02001704,6477,5742,288,198,90,186,97,89,261
2021,Gateshead 025,E02001706,7424,6655,324,215,109,173,80,93,272
2021,Gateshead 026,E02001707,7915,7079,359,250,109,196,79,117,281
2021,Newcastle upon Tyne 002,E02001709,9873,9030,502,403,99,124,59,65,217
2021,Newcastle upon Tyne 003,E02001710,9607,8606,366,250,116,250,110,140,385
2021,Newcastle upon Tyne 004,E02001711,9275,8259,378,243,135,265,104,161,373
2021,Newcastle upon Tyne 005,E02001712,8828,8131,435,334,101,98,39,59,164
2021,Newcastle upon Tyne 006,E02001713,9527,8718,475,362,113,133,64,69,201
2021,Newcastle upon Tyne 007,E02001714,9175,8376,441,328,113,136,65,71,222
2021,Newcastle upon Tyne 008,E02001715,11072,9987,391,273,118,285,121,164,409
2021,Newcastle upon Tyne 011,E02001718,6149,5521,220,143,77,178,67,111,230
2021,Newcastle upon Tyne 012,E02001719,8205,7458,356,240,116,141,69,72,250
2021,Newcastle upon Tyne 013,E02001720,9371,8977,262,208,54,60,38,22,72
2021,Newcastle upon Tyne 014,E02001721,10147,9054,524,362,162,232,98,134,337
2021,Newcastle upon Tyne 015,E02001722,8903,7966,362,244,118,243,104,139,332
2021,Newcastle upon Tyne 016,E02001723,6679,6018,270,171,99,160,72,88,231
2021,Newcastle upon Tyne 017,E02001724,8834,8496,233,177,56,39,20,19,66
2021,Newcastle upon Tyne 018,E02001725,8877,8337,247,175,72,133,54,79,160
2021,Newcastle upon Tyne 019,E02001726,11090,10096,349,229,120,284,126,158,361
2021,Newcastle upon Tyne 020,E02001727,8289,7440,363,237,126,200,88,112,286
2021,Newcastle upon Tyne 021,E02001728,8963,8047,388,262,126,210,76,134,318
2021,Newcastle upon Tyne 022,E02001729,11415,10707,288,188,100,217,88,129,203
2021,Newcastle upon Tyne 025,E02001732,5336,4802,211,145,66,131,53,78,192
2021,Newcastle upon Tyne 027,E02001734,7621,6953,239,163,76,177,72,105,252
2021,Newcastle upon Tyne 028,E02001735,6196,5531,181,114,67,200,82,118,284
2021,Newcastle upon Tyne 030,E02001737,5740,5125,152,100,52,200,80,120,263
2021,North Tyneside 001,E02001738,5910,5332,356,275,81,73,38,35,149
2021,North Tyneside 002,E02001739,6918,6198,295,198,97,183,74,109,242
2021,North Tyneside 003,E02001740,5626,5116,307,235,72,77,40,37,126
2021,North Tyneside 004,E02001741,7348,6655,387,279,108,122,56,66,184
2021,North Tyneside 005,E02001742,5536,4989,320,241,79,78,48,30,149
2021,North Tyneside 006,E02001743,7189,6588,356,267,89,105,48,57,140
2021,North Tyneside 007,E02001744,7689,6997,377,275,102,114,61,53,201
2021,North Tyneside 008,E02001745,6338,5750,259,193,66,141,71,70,188
2021,North Tyneside 009,E02001746,7802,6979,420,300,120,142,68,74,261
2021,North Tyneside 010,E02001747,5938,5339,325,241,84,98,50,48,176
2021,North Tyneside 011,E02001748,8134,7378,323,223,100,179,70,109,254
2021,North Tyneside 012,E02001749,6056,5464,291,199,92,113,55,58,188
2021,North Tyneside 013,E02001750,6450,5761,380,262,118,113,51,62,196
2021,North Tyneside 014,E02001751,6283,5637,320,216,104,133,59,74,193
2021,North Tyneside 015,E02001752,6044,5389,253,169,84,157,61,96,245
2021,North Tyneside 016,E02001753,5914,5364,299,227,72,109,58,51,142
2021,North Tyneside 017,E02001754,5545,5038,310,227,83,78,38,40,119
2021,North Tyneside 018,E02001755,9271,8404,456,342,114,148,76,72,263
2021,North Tyneside 019,E02001756,8716,7828,345,219,126,239,95,144,304
2021,North Tyneside 020,E02001757,5554,4959,296,205,91,122,49,73,177
2021,North Tyneside 021,E02001758,5312,4763,260,180,80,119,66,53,170
2021,North Tyneside 022,E02001759,5868,5300,307,227,80,110,49,61,151
2021,North Tyneside 023,E02001760,7206,6483,234,152,82,177,72,105,312
2021,North Tyneside 024,E02001761,5270,4716,228,144,84,120,54,66,206
2021,North Tyneside 025,E02001762,6327,5692,291,204,87,151,65,86,193
2021,North Tyneside 026,E02001763,6060,5375,258,161,97,181,74,107,246
2021,North Tyneside 027,E02001764,7154,6419,273,190,83,195,87,108,267
2021,North Tyneside 028,E02001765,7161,6422,291,200,91,189,80,109,259
2021,North Tyneside 029,E02001766,6800,6110,278,182,96,172,82,90,240
2021,North Tyneside 030,E02001767,6553,5849,302,204,98,173,77,96,229
2021,South Tyneside 001,E02001768,7713,7006,322,202,120,181,79,102,204
2021,South Tyneside 002,E02001769,6981,6319,276,178,98,157,61,96,229
2021,South Tyneside 003,E02001770,5719,5162,279,184,95,137,55,82,141
2021,South Tyneside 004,E02001771,5856,5175,277,186,91,137,53,84,267
2021,South Tyneside 005,E02001772,4794,4296,223,154,69,124,61,63,151
2021,South Tyneside 006,E02001773,5042,4467,294,206,88,98,38,60,183
2021,South Tyneside 007,E02001774,4976,4480,208,140,68,125,61,64,163
2021,South Tyneside 008,E02001775,5168,4584,226,153,73,145,64,81,213
2021,South Tyneside 009,E02001776,8512,7679,345,226,119,207,90,117,281
2021,South Tyneside 010,E02001777,6395,5777,308,226,82,137,64,73,173
2021,South Tyneside 011,E02001778,5327,4796,220,150,70,136,61,75,175
2021,South Tyneside 012,E02001779,5076,4519,215,128,87,141,54,87,201
2021,South Tyneside 013,E02001780,5698,5084,214,141,73,163,71,92,237
2021,South Tyneside 014,E02001781,5026,4439,217,128,89,141,53,88,229
2021,South Tyneside 015,E02001782,9528,8592,348,227,121,227,89,138,361
2021,South Tyneside 016,E02001783,6578,5855,257,164,93,199,73,126,267
2021,South Tyneside 017,E02001784,6260,5487,311,199,112,199,84,115,263
2021,South Tyneside 018,E02001785,7281,6431,375,249,126,183,73,110,292
2021,South Tyneside 019,E02001786,6256,5518,244,159,85,179,90,89,315
2021,South Tyneside 020,E02001787,5138,4605,208,140,68,144,67,77,181
2021,South Tyneside 021,E02001788,5445,4873,224,155,69,135,54,81,213
2021,South Tyneside 022,E02001789,5555,4902,417,303,114,98,51,47,138
2021,South Tyneside 023,E02001790,5638,5027,315,226,89,123,57,66,173
2021,Sunderland 001,E02001791,5235,4632,337,243,94,110,63,47,156
2021,Sunderland 002,E02001792,6591,5755,474,317,157,147,84,63,215
2021,Sunderland 003,E02001793,7755,6903,246,155,91,241,89,152,365
2021,Sunderland 004,E02001794,8313,7347,284,168,116,270,93,177,412
2021,Sunderland 005,E02001795,6887,6082,274,163,111,212,88,124,319
2021,Sunderland 006,E02001796,8227,7341,412,256,156,189,83,106,285
2021,Sunderland 007,E02001797,5646,5051,304,218,86,109,52,57,182
2021,Sunderland 008,E02001798,7773,6854,321,214,107,250,101,149,348
2021,Sunderland 009,E02001799,8756,7767,316,203,113,269,98,171,404
2021,Sunderland 010,E02001800,6442,5710,273,177,96,164,77,87,295
2021,Sunderland 011,E02001801,5506,5019,192,115,77,121,49,72,174
2021,Sunderland 012,E02001802,6828,6119,184,111,73,210,85,125,315
2021,Sunderland 013,E02001803,8175,7520,302,206,96,167,78,89,186
2021,Sunderland 014,E02001804,5902,5208,245,161,84,213,89,124,236
2021,Sunderland 015,E02001805,5240,4603,308,215,93,128,64,64,201
2021,Sunderland 016,E02001806,7285,6539,255,156,99,231,84,147,260
2021,Sunderland 017,E02001807,8098,7240,339,232,107,207,92,115,312
2021,Sunderland 018,E02001808,5249,4730,221,145,76,124,67,57,174
2021,Sunderland 019,E02001809,6205,5527,308,224,84,151,65,86,219
2021,Sunderland 020,E02001810,7869,6982,378,271,107,199,92,107,310
2021,Sunderland 021,E02001811,8240,7328,306,197,109,237,84,153,369
2021,Sunderland 022,E02001812,9614,8535,541,394,147,206,96,110,332
2021,Sunderland 023,E02001813,9093,7968,310,182,128,302,109,193,513
2021,Sunderland 024,E02001814,5893,5231,266,170,96,164,66,98,232
2021,Sunderland 025,E02001815,9460,8349,517,364,153,224,114,110,370
2021,Sunderland 026,E02001816,6478,5751,263,177,86,191,69,122,273
2021,Sunderland 027,E02001817,6284,5544,263,158,105,198,86,112,279
2021,Sunderland 028,E02001818,8978,7917,432,289,143,271,122,149,358
2021,Sunderland 029,E02001819,6638,5869,386,286,100,164,85,79,219
2021,Sunderland 030,E02001820,9147,8127,459,315,144,232,99,133,329
2021,Sunderland 031,E02001821,5366,4676,291,187,104,160,65,95,239
2021,Sunderland 032,E02001822,7318,6481,375,262,113,175,78,97,287
2021,Sunderland 033,E02001823,7537,6674,353,251,102,193,89,104,317
2021,Sunderland 034,E02001824,8110,7173,378,276,102,236,93,143,323
2021,Sunderland 035,E02001825,7281,6453,311,209,102,222,90,132,295
2021,Sunderland 036,E02001826,6901,6101,292,197,95,216,88,128,292
2021,Birmingham 001,E02001827,6161,5571,337,253,84,96,56,40,157
2021,Birmingham 002,E02001828,6797,6129,368,284,84,114,69,45,186
2021,Birmingham 003,E02001829,8642,7896,444,350,94,100,61,39,202
2021,Birmingham 004,E02001830,9310,8377,575,445,130,131,77,54,227
2021,Birmingham 005,E02001831,9977,9010,457,314,143,206,94,112,304
2021,Birmingham 006,E02001832,7549,6839,407,294,113,125,74,51,178
2021,Birmingham 007,E02001833,5613,5057,271,203,68,106,58,48,179
2021,Birmingham 008,E02001834,5717,5111,228,153,75,145,54,91,233
2021,Birmingham 009,E02001835,8080,7353,454,331,123,104,54,50,169
2021,Birmingham 010,E02001836,8602,7764,453,307,146,144,74,70,241
2021,Birmingham 011,E02001837,9953,8979,283,180,103,274,98,176,417
2021,Birmingham 012,E02001838,7210,6465,453,323,130,109,56,53,183
2021,Birmingham 013,E02001839,6044,5487,253,181,72,118,56,62,186
2021,Birmingham 014,E02001840,8948,7942,352,218,134,281,121,160,373
2021,Birmingham 015,E02001841,5719,5054,344,264,80,91,56,35,230
2021,Birmingham 016,E02001842,7549,6903,291,198,93,158,82,76,197
2021,Birmingham 017,E02001843,6184,5616,235,149,86,116,48,68,217
2021,Birmingham 018,E02001844,9219,8416,431,322,109,135,68,67,237
2021,Birmingham 019,E02001845,6180,5642,267,178,89,114,49,65,157
2021,Birmingham 020,E02001846,7562,6880,255,164,91,200,86,114,227
2021,Birmingham 021,E02001847,5318,4776,278,198,80,90,41,49,174
2021,Birmingham 022,E02001848,6786,6180,216,132,84,165,71,94,225
2021,Birmingham 023,E02001849,7997,7327,292,201,91,156,65,91,222
2021,Birmingham 024,E02001850,8008,7336,296,212,84,190,92,98,186
2021,Birmingham 025,E02001851,8544,7712,353,246,107,196,102,94,283
2021,Birmingham 026,E02001852,6568,6053,193,125,68,158,61,97,164
2021,Birmingham 029,E02001855,9289,8231,359,245,114,274,112,162,425
2021,Birmingham 030,E02001856,8910,8192,308,205,103,197,81,116,213
2021,Birmingham 031,E02001857,12959,11838,431,269,162,361,167,194,329
2021,Birmingham 032,E02001858,8592,7959,300,181,119,178,85,93,155
2021,Birmingham 033,E02001859,9612,8882,260,144,116,228,104,124,242
2021,Birmingham 034,E02001860,7905,7275,242,150,92,180,78,102,208
2021,Birmingham 035,E02001861,10320,9495,311,183,128,246,114,132,268
2021,Birmingham 036,E02001862,9242,8512,271,173,98,224,93,131,235
2021,Birmingham 037,E02001863,7786,7159,229,126,103,186,62,124,212
2021,Birmingham 039,E02001865,10614,9744,313,164,149,256,113,143,301
2021,Birmingham 040,E02001866,8801,8155,239,146,93,207,104,103,200
2021,Birmingham 041,E02001867,8026,7450,208,124,84,187,77,110,181
2021,Birmingham 042,E02001868,9042,8320,263,153,110,216,84,132,243
2021,Birmingham 043,E02001869,6340,5905,125,79,46,148,59,89,162
2021,Birmingham 044,E02001870,11947,11010,288,172,116,295,136,159,354
2021,Birmingham 045,E02001871,7721,6879,309,212,97,209,89,120,324
2021,Birmingham 046,E02001872,6866,6191,246,168,78,162,68,94,267
2021,Birmingham 047,E02001873,10483,9679,295,188,107,253,117,136,256
2021,Birmingham 048,E02001874,9122,8405,207,122,85,248,88,160,262
2021,Birmingham 049,E02001875,8224,7668,231,144,87,170,63,107,155
2021,Birmingham 050,E02001876,15280,14739,232,158,74,163,72,91,146
2021,Birmingham 051,E02001877,11371,10450,271,168,103,328,113,215,322
2021,Birmingham 052,E02001878,8735,7980,237,136,101,263,110,153,255
2021,Birmingham 053,E02001879,9300,8499,276,161,115,232,110,122,293
2021,Birmingham 054,E02001880,9183,8337,269,148,121,237,100,137,340
2021,Birmingham 055,E02001881,9630,8861,233,130,103,228,100,128,308
2021,Birmingham 056,E02001882,8166,7464,224,145,79,211,104,107,267
2021,Birmingham 057,E02001883,7863,7049,248,159,89,229,92,137,337
2021,Birmingham 058,E02001884,9312,8630,202,112,90,239,96,143,241
2021,Birmingham 060,E02001886,9387,8706,325,204,121,179,88,91,177
2021,Birmingham 062,E02001888,6661,5965,242,153,89,205,85,120,249
2021,Birmingham 063,E02001889,8432,7795,203,120,83,230,93,137,204
2021,Birmingham 064,E02001890,9521,8862,378,281,97,111,53,58,170
2021,Birmingham 066,E02001892,10566,9741,277,172,105,280,117,163,268
2021,Birmingham 067,E02001893,8271,7441,341,220,121,196,80,116,293
2021,Birmingham 069,E02001895,8394,7542,304,198,106,225,90,135,323
2021,Birmingham 070,E02001896,9289,8519,263,135,128,262,111,151,245
2021,Birmingham 071,E02001897,7912,7203,225,133,92,262,103,159,222
2021,Birmingham 072,E02001898,6164,5487,325,229,96,145,74,71,207
2021,Birmingham 073,E02001899,8039,7411,358,245,113,105,52,53,165
2021,Birmingham 074,E02001900,6300,5800,224,164,60,134,54,80,142
2021,Birmingham 075,E02001901,7672,7142,329,249,80,89,51,38,112
2021,Birmingham 076,E02001902,5836,5328,246,154,92,119,55,64,143
2021,Birmingham 077,E02001903,7431,6747,200,123,77,275,97,178,209
2021,Birmingham 078,E02001904,7096,6484,226,152,74,170,65,105,216
2021,Birmingham 079,E02001905,9943,9489,266,215,51,83,38,45,105
2021,Birmingham 080,E02001906,9020,8219,373,276,97,171,70,101,257
2021,Birmingham 081,E02001907,9791,8854,405,296,109,209,93,116,323
2021,Birmingham 082,E02001908,8228,7576,215,117,98,213,81,132,224
2021,Birmingham 083,E02001909,7602,6911,215,121,94,276,96,180,200
2021,Birmingham 084,E02001910,6722,6139,196,121,75,204,89,115,183
2021,Birmingham 085,E02001911,8047,7317,306,215,91,193,83,110,231
2021,Birmingham 087,E02001913,7064,6601,238,183,55,95,54,41,130
2021,Birmingham 088,E02001914,6614,5973,303,222,81,176,53,123,162
2021,Birmingham 089,E02001915,11194,10191,467,329,138,250,112,138,286
2021,Birmingham 090,E02001916,9109,8376,264,173,91,193,90,103,276
2021,Birmingham 092,E02001918,8258,7571,387,284,103,152,77,75,148
2021,Birmingham 093,E02001919,6591,6035,283,200,83,136,65,71,137
2021,Birmingham 094,E02001920,7129,6426,254,168,86,188,77,111,261
2021,Birmingham 095,E02001921,7232,6578,271,184,87,161,62,99,222
2021,Birmingham 096,E02001922,15775,15337,267,218,49,77,32,45,94
2021,Birmingham 097,E02001923,10419,9463,383,259,124,289,146,143,284
2021,Birmingham 098,E02001924,6587,5984,230,156,74,159,79,80,214
2021,Birmingham 099,E02001925,6392,5895,278,204,74,88,46,42,131
2021,Birmingham 100,E02001926,7440,6847,299,217,82,105,37,68,189
2021,Birmingham 101,E02001927,7208,6464,272,181,91,169,76,93,303
2021,Birmingham 102,E02001928,6394,5797,256,179,77,135,60,75,206
2021,Birmingham 103,E02001929,9632,8709,351,206,145,245,115,130,327
2021,Birmingham 104,E02001930,7306,6615,389,291,98,131,61,70,171
2021,Birmingham 105,E02001931,8058,7253,382,265,117,217,101,116,206
2021,Birmingham 106,E02001932,6916,6206,315,214,101,154,64,90,241
2021,Birmingham 107,E02001933,7208,6510,301,210,91,158,67,91,239
2021,Birmingham 108,E02001934,6702,6080,309,202,107,154,76,78,159
2021,Birmingham 109,E02001935,7647,6885,356,266,90,164,79,85,242
2021,Birmingham 110,E02001936,6036,5477,314,227,87,97,47,50,148
2021,Birmingham 111,E02001937,7798,7080,255,161,94,186,88,98,277
2021,Birmingham 112,E02001938,7435,6860,305,232,73,120,51,69,150
2021,Birmingham 113,E02001939,5949,5356,272,196,76,124,56,68,197
2021,Birmingham 115,E02001941,6055,5463,203,129,74,173,75,98,216
2021,Birmingham 116,E02001942,6389,5795,273,196,77,133,49,84,188
2021,Birmingham 117,E02001943,6078,5450,289,204,85,148,69,79,191
2021,Birmingham 118,E02001944,7620,6888,326,236,90,173,77,96,233
2021,Birmingham 119,E02001945,7349,6543,283,192,91,205,72,133,318
2021,Birmingham 120,E02001946,7226,6537,348,236,112,151,73,78,190
2021,Birmingham 121,E02001947,5739,5185,195,135,60,134,35,99,225
2021,Birmingham 122,E02001948,6909,6196,336,240,96,138,57,81,239
2021,Birmingham 123,E02001949,5697,5204,215,168,47,106,41,65,172
2021,Birmingham 124,E02001950,8065,7339,351,256,95,148,71,77,227
2021,Birmingham 125,E02001951,8738,7809,331,211,120,225,85,140,373
2021,Birmingham 126,E02001952,8464,7645,310,217,93,207,88,119,302
2021,Birmingham 127,E02001953,6734,6097,301,215,86,137,67,70,199
2021,Birmingham 128,E02001954,7078,6369,203,140,63,197,85,112,309
2021,Birmingham 129,E02001955,7560,6866,296,210,86,171,73,98,227
2021,Birmingham 130,E02001956,6428,5835,264,196,68,127,64,63,202
2021,Birmingham 131,E02001957,7407,6727,284,195,89,169,85,84,227
2021,Coventry 001,E02001958,7545,6819,332,217,115,170,85,85,224
2021,Coventry 002,E02001959,6494,5937,274,176,98,113,63,50,170
2021,Coventry 004,E02001961,7403,6743,260,176,84,175,79,96,225
2021,Coventry 005,E02001962,6645,6136,199,133,66,144,61,83,166
2021,Coventry 006,E02001963,5882,5214,310,202,108,152,81,71,206
2021,Coventry 007,E02001964,10067,9218,275,179,96,214,83,131,360
2021,Coventry 008,E02001965,7653,6980,307,209,98,143,76,67,223
2021,Coventry 009,E02001966,6805,6247,166,89,77,177,85,92,215
2021,Coventry 010,E02001967,6613,5981,360,271,89,112,61,51,160
2021,Coventry 011,E02001968,7463,6816,276,182,94,156,68,88,215
2021,Coventry 012,E02001969,6344,5767,222,135,87,149,74,75,206
2021,Coventry 013,E02001970,5392,4890,249,172,77,89,33,56,164
2021,Coventry 014,E02001971,5921,5374,286,212,74,104,51,53,157
2021,Coventry 015,E02001972,10686,9898,292,178,114,224,74,150,272
2021,Coventry 016,E02001973,7965,7280,275,179,96,176,76,100,234
2021,Coventry 017,E02001974,8969,8115,486,364,122,161,84,77,207
2021,Coventry 018,E02001975,7225,6549,342,239,103,135,67,68,199
2021,Coventry 019,E02001976,7135,6528,266,179,87,140,59,81,201
2021,Coventry 020,E02001977,9372,8702,267,171,96,189,78,111,214
2021,Coventry 021,E02001978,6290,5744,238,159,79,137,59,78,171
2021,Coventry 022,E02001979,5323,4775,303,216,87,100,45,55,145
2021,Coventry 023,E02001980,5516,4971,308,239,69,84,34,50,153
2021,Coventry 024,E02001981,12313,11564,303,194,109,229,101,128,217
2021,Coventry 025,E02001982,7910,7153,399,306,93,151,76,75,207
2021,Coventry 026,E02001983,7191,6542,327,253,74,131,58,73,191
2021,Coventry 027,E02001984,9782,8933,439,298,141,185,85,100,225
2021,Coventry 028,E02001985,8943,8536,200,135,65,100,52,48,107
2021,Coventry 029,E02001986,7468,6770,282,204,78,161,62,99,255
2021,Coventry 030,E02001987,5660,5275,200,145,55,64,31,33,121
2021,Coventry 031,E02001988,10844,10397,249,180,69,94,52,42,104
2021,Coventry 032,E02001989,5909,5369,259,186,73,117,58,59,164
2021,Coventry 033,E02001990,8779,7918,457,319,138,157,78,79,247
2021,Coventry 034,E02001991,8160,7412,469,362,107,121,59,62,158
2021,Coventry 035,E02001992,10056,9205,319,214,105,212,94,118,320
2021,Coventry 036,E02001993,8574,7899,297,218,79,159,72,87,219
2021,Coventry 037,E02001994,7521,6876,309,232,77,142,72,70,194
2021,Coventry 038,E02001995,8743,8101,283,196,87,175,62,113,184
2021,Coventry 039,E02001996,7059,6454,217,130,87,151,69,82,237
2021,Coventry 040,E02001997,8121,7263,490,364,126,151,71,80,217
2021,Coventry 041,E02001998,5754,5143,341,257,84,115,57,58,155
2021,Coventry 042,E02001999,8912,8281,384,274,110,110,65,45,137
2021,Dudley 001,E02002000,7949,7062,397,240,157,192,85,107,298
2021,Dudley 002,E02002001,5819,5180,291,211,80,150,61,89,198
2021,Dudley 003,E02002002,6637,5865,432,313,119,117,56,61,223
2021,Dudley 004,E02002003,8554,7593,431,292,139,203,95,108,327
2021,Dudley 005,E02002004,7168,6397,318,202,116,183,87,96,270
2021,Dudley 006,E02002005,9159,8226,305,197,108,266,106,160,362
2021,Dudley 007,E02002006,6061,5401,299,167,132,144,55,89,217
2021,Dudley 008,E02002007,8528,7566,452,318,134,195,91,104,315
2021,Dudley 009,E02002008,7759,6913,485,366,119,166,80,86,195
2021,Dudley 010,E02002009,6551,5987,203,128,75,168,86,82,193
2021,Dudley 011,E02002010,7737,7089,281,191,90,176,76,100,191
2021,Dudley 012,E02002011,5651,5076,318,226,92,100,52,48,157
2021,Dudley 013,E02002012,7857,6992,321,208,113,210,80,130,334
2021,Dudley 014,E02002013,6337,5520,473,340,133,107,49,58,237
2021,Dudley 015,E02002014,7666,6988,264,162,102,199,97,102,215
2021,Dudley 016,E02002015,6615,5933,348,246,102,136,56,80,198
2021,Dudley 017,E02002016,7493,6685,279,194,85,214,87,127,315
2021,Dudley 018,E02002017,7569,6757,371,251,120,201,87,114,240
2021,Dudley 019,E02002018,8582,7636,496,345,151,159,75,84,291
2021,Dudley 020,E02002019,7283,6479,320,221,99,189,88,101,295
2021,Dudley 021,E02002020,9028,8081,505,360,145,165,93,72,277
2021,Dudley 022,E02002021,7211,6562,257,188,69,193,80,113,199
2021,Dudley 023,E02002022,8196,7386,377,268,109,194,89,105,239
2021,Dudley 024,E02002023,5087,4577,265,195,70,89,52,37,156
2021,Dudley 025,E02002024,8210,7420,377,263,114,165,62,103,248
2021,Dudley 026,E02002025,8287,7452,376,269,107,191,72,119,268
2021,Dudley 027,E02002026,6478,5805,335,245,90,130,65,65,208
2021,Dudley 028,E02002027,5171,4668,312,225,87,92,52,40,99
2021,Dudley 029,E02002028,5470,4877,323,230,93,98,49,49,172
2021,Dudley 030,E02002029,5903,5341,293,215,78,100,46,54,169
2021,Dudley 031,E02002030,6395,5779,283,192,91,136,60,76,197
2021,Dudley 032,E02002031,5911,5309,289,203,86,130,62,68,183
2021,Dudley 033,E02002032,9591,8548,417,295,122,222,104,118,404
2021,Dudley 034,E02002033,7426,6646,409,291,118,162,65,97,209
2021,Dudley 035,E02002034,7796,7118,372,283,89,132,68,64,174
2021,Dudley 036,E02002035,5844,5290,311,223,88,107,65,42,136
2021,Dudley 037,E02002036,6229,5649,199,137,62,167,70,97,214
2021,Dudley 038,E02002037,5639,5004,314,220,94,135,70,65,186
2021,Dudley 039,E02002038,9126,8205,459,329,130,210,108,102,252
2021,Dudley 040,E02002039,5953,5357,346,257,89,112,49,63,138
2021,Dudley 041,E02002040,5710,5115,346,257,89,80,41,39,169
2021,Dudley 042,E02002041,5993,5386,298,218,80,111,52,59,198
2021,Dudley 043,E02002042,7692,6878,457,342,115,142,69,73,215
2021,Sandwell 001,E02002043,8185,7325,314,201,113,242,115,127,304
2021,Sandwell 002,E02002044,7471,6743,317,191,126,190,70,120,221
2021,Sandwell 003,E02002045,7335,6617,306,194,112,160,61,99,252
2021,Sandwell 004,E02002046,5344,4737,167,110,57,169,53,116,271
2021,Sandwell 005,E02002047,7104,6360,289,193,96,175,68,107,280
2021,Sandwell 006,E02002048,6505,5850,305,210,95,123,58,65,227
2021,Sandwell 007,E02002049,5880,5251,247,158,89,145,61,84,237
2021,Sandwell 009,E02002051,5711,5105,172,118,54,154,64,90,280
2021,Sandwell 010,E02002052,10633,9582,364,199,165,302,127,175,385
2021,Sandwell 011,E02002053,5960,5354,286,182,104,148,74,74,172
2021,Sandwell 012,E02002054,5501,4948,274,206,68,113,57,56,166
2021,Sandwell 013,E02002055,10432,9423,363,222,141,281,114,167,365
2021,Sandwell 014,E02002056,9190,8248,289,192,97,250,100,150,403
2021,Sandwell 015,E02002057,10071,9139,363,237,126,260,107,153,309
2021,Sandwell 016,E02002058,12587,11552,400,263,137,282,129,153,353
2021,Sandwell 017,E02002059,11103,10155,340,225,115,283,116,167,325
2021,Sandwell 018,E02002060,6854,6276,185,105,80,179,81,98,214
2021,Sandwell 019,E02002061,6652,6066,218,109,109,155,66,89,213
2021,Sandwell 020,E02002062,8365,7730,215,129,86,192,84,108,228
2021,Sandwell 021,E02002063,9614,8813,327,207,120,224,87,137,250
2021,Sandwell 022,E02002064,11648,10644,442,292,150,243,113,130,319
2021,Sandwell 023,E02002065,13116,12116,369,217,152,335,142,193,296
2021,Sandwell 024,E02002066,7672,7031,235,128,107,205,88,117,201
2021,Sandwell 025,E02002067,5964,5360,256,183,73,135,56,79,213
2021,Sandwell 027,E02002069,6669,6013,262,190,72,175,74,101,219
2021,Sandwell 028,E02002070,9572,8923,238,134,104,205,96,109,206
2021,Sandwell 029,E02002071,6281,5611,262,179,83,186,73,113,222
2021,Sandwell 030,E02002072,8422,7642,375,245,130,178,86,92,227
2021,Sandwell 031,E02002073,7903,7105,263,175,88,239,94,145,296
2021,Sandwell 032,E02002074,7795,7043,278,176,102,208,84,124,266
2021,Sandwell 033,E02002075,8270,7397,398,286,112,198,94,104,277
2021,Sandwell 034,E02002076,10021,9229,422,307,115,166,77,89,204
2021,Sandwell 035,E02002077,10151,9062,433,292,141,274,104,170,382
2021,Sandwell 036,E02002078,6202,5561,326,240,86,138,66,72,177
2021,Sandwell 037,E02002079,8155,7369,329,218,111,182,79,103,275
2021,Sandwell 038,E02002080,6943,6245,280,187,93,172,89,83,246
2021,Solihull 001,E02002081,5186,4616,273,189,84,109,57,52,188
2021,Solihull 002,E02002082,5444,4798,221,123,98,155,58,97,270
2021,Solihull 003,E02002083,5736,5118,305,204,101,135,70,65,178
2021,Solihull 004,E02002084,6221,5563,244,168,76,169,85,84,245
2021,Solihull 005,E02002085,6183,5518,234,149,85,176,77,99,255
2021,Solihull 006,E02002086,5436,4933,150,100,50,150,71,79,203
2021,Solihull 007,E02002087,5802,5163,195,133,62,186,87,99,258
2021,Solihull 008,E02002088,8868,7893,332,217,115,247,88,159,396
2021,Solihull 009,E02002089,7686,6877,383,260,123,180,92,88,246
2021,Solihull 010,E02002090,5589,5043,278,174,104,101,50,51,167
2021,Solihull 011,E02002091,7241,6530,357,253,104,148,67,81,206
2021,Solihull 012,E02002092,6879,6155,345,251,94,148,69,79,231
2021,Solihull 013,E02002093,6384,5767,331,236,95,122,53,69,164
2021,Solihull 014,E02002094,5734,5171,352,265,87,84,40,44,127
2021,Solihull 015,E02002095,8172,7387,438,326,112,150,75,75,197
2021,Solihull 016,E02002096,9868,8966,487,371,116,153,77,76,262
2021,Solihull 017,E02002097,7040,6300,398,304,94,123,56,67,219
2021,Solihull 018,E02002098,9261,8355,453,341,112,183,104,79,270
2021,Solihull 019,E02002099,6642,6044,363,263,100,82,46,36,153
2021,Solihull 021,E02002101,5935,5378,281,198,83,104,44,60,172
2021,Solihull 022,E02002102,8336,7531,451,340,111,155,72,83,199
2021,Solihull 023,E02002103,5792,5221,287,213,74,101,52,49,183
2021,Solihull 024,E02002104,5653,5159,321,252,69,64,39,25,109
2021,Solihull 025,E02002105,7905,7122,479,366,113,112,55,57,192
2021,Solihull 026,E02002106,9338,8521,464,360,104,130,65,65,223
2021,Solihull 027,E02002107,5167,4672,306,225,81,81,34,47,108
2021,Solihull 028,E02002108,9403,8541,552,429,123,127,54,73,183
2021,Solihull 029,E02002109,11352,10444,523,399,124,149,71,78,236
2021,Walsall 001,E02002110,6641,5904,328,230,98,163,59,104,246
2021,Walsall 002,E02002111,6064,5444,228,150,78,163,69,94,229
2021,Walsall 003,E02002112,5039,4466,273,204,69,119,58,61,181
2021,Walsall 004,E02002113,6039,5372,296,205,91,143,66,77,228
2021,Walsall 005,E02002114,5769,5114,291,213,78,143,66,77,221
2021,Walsall 006,E02002115,6390,5631,304,212,92,181,68,113,274
2021,Walsall 007,E02002116,6455,5715,371,274,97,156,82,74,213
2021,Walsall 008,E02002117,5973,5392,276,199,77,139,57,82,166
2021,Walsall 009,E02002118,6913,6166,255,166,89,200,90,110,292
2021,Walsall 010,E02002119,5685,5050,282,205,77,124,53,71,229
2021,Walsall 011,E02002120,5795,5196,280,208,72,113,40,73,206
2021,Walsall 012,E02002121,6202,5544,181,102,79,167,61,106,310
2021,Walsall 013,E02002122,6549,5942,167,93,74,201,79,122,239
2021,Walsall 014,E02002123,6119,5520,243,174,69,142,62,80,214
2021,Walsall 015,E02002124,6585,5856,328,237,91,175,79,96,226
2021,Walsall 016,E02002125,6060,5407,271,206,65,152,70,82,230
2021,Walsall 017,E02002126,6064,5444,179,113,66,179,76,103,262
2021,Walsall 018,E02002127,8997,8200,248,163,85,240,93,147,309
2021,Walsall 019,E02002128,5335,4770,209,132,77,139,60,79,217
2021,Walsall 020,E02002129,5739,5133,263,176,87,127,62,65,216
2021,Walsall 021,E02002130,6344,5691,197,118,79,165,54,111,291
2021,Walsall 022,E02002131,7454,6611,443,326,117,158,88,70,242
2021,Walsall 023,E02002132,6081,5437,213,123,90,174,73,101,257
2021,Walsall 024,E02002133,6530,5831,303,206,97,166,78,88,230
2021,Walsall 025,E02002134,8592,7775,300,188,112,212,88,124,305
2021,Walsall 026,E02002135,7363,6707,209,116,93,216,97,119,231
2021,Walsall 027,E02002136,7488,6870,229,151,78,176,76,100,213
2021,Walsall 028,E02002137,5860,5286,342,260,82,103,54,49,129
2021,Walsall 029,E02002138,5998,5393,304,211,93,138,58,80,163
2021,Walsall 030,E02002139,9915,9135,296,209,87,225,90,135,259
2021,Walsall 031,E02002140,7852,7178,229,142,87,217,97,120,228
2021,Walsall 032,E02002141,6109,5466,325,249,76,112,54,58,206
2021,Walsall 033,E02002142,7014,6409,228,154,74,164,80,84,213
2021,Walsall 034,E02002143,9374,8615,263,163,100,228,104,124,268
2021,Walsall 035,E02002144,6539,5879,361,240,121,128,59,69,171
2021,Walsall 036,E02002145,7787,7093,231,141,90,209,103,106,254
2021,Walsall 037,E02002146,6050,5510,222,148,74,125,53,72,193
2021,Walsall 038,E02002147,8349,7602,229,148,81,204,85,119,314
2021,Walsall 039,E02002148,10803,9761,524,348,176,221,116,105,297
2021,Wolverhampton 001,E02002149,9577,8544,465,328,137,230,101,129,338
2021,Wolverhampton 002,E02002150,5440,4876,215,144,71,147,59,88,202
2021,Wolverhampton 003,E02002151,5256,4688,261,186,75,125,55,70,182
2021,Wolverhampton 004,E02002152,5898,5317,188,122,66,150,53,97,243
2021,Wolverhampton 005,E02002153,7001,6255,291,190,101,178,82,96,277
2021,Wolverhampton 006,E02002154,6889,6308,228,148,80,141,63,78,212
2021,Wolverhampton 007,E02002155,6003,5502,143,95,48,147,54,93,211
2021,Wolverhampton 008,E02002156,7864,7117,366,257,109,160,79,81,221
2021,Wolverhampton 009,E02002157,7389,6692,350,234,116,155,74,81,192
2021,Wolverhampton 010,E02002158,7072,6261,349,244,105,182,79,103,280
2021,Wolverhampton 011,E02002159,5777,5314,156,96,60,120,56,64,187
2021,Wolverhampton 012,E02002160,7150,6449,294,208,86,177,88,89,230
2021,Wolverhampton 013,E02002161,6493,5989,203,130,73,147,70,77,154
2021,Wolverhampton 014,E02002162,7478,6722,374,266,108,137,74,63,245
2021,Wolverhampton 015,E02002163,10901,10095,292,177,115,244,102,142,270
2021,Wolverhampton 016,E02002164,6245,5877,149,95,54,112,39,73,107
2021,Wolverhampton 017,E02002165,7439,6804,317,233,84,156,63,93,162
2021,Wolverhampton 018,E02002166,8872,8041,283,185,98,204,83,121,344
2021,Wolverhampton 019,E02002167,6334,5667,359,267,92,129,65,64,179
2021,Wolverhampton 020,E02002168,10793,10054,331,208,123,220,90,130,188
2021,Wolverhampton 021,E02002169,8430,7513,522,368,154,173,94,79,222
2021,Wolverhampton 022,E02002170,5907,5316,214,142,72,164,66,98,213
2021,Wolverhampton 023,E02002171,7205,6456,258,166,92,206,90,116,285
2021,Wolverhampton 026,E02002174,7275,6479,424,299,125,165,74,91,207
2021,Wolverhampton 027,E02002175,7320,6669,205,142,63,195,86,109,251
2021,Wolverhampton 028,E02002176,7306,6645,309,227,82,172,68,104,180
2021,Wolverhampton 029,E02002177,10612,9793,320,195,125,234,108,126,265
2021,Wolverhampton 030,E02002178,7747,6995,349,235,114,177,89,88,226
2021,Wolverhampton 031,E02002179,6235,5606,348,250,98,115,56,59,166
2021,Wolverhampton 032,E02002180,6145,5516,263,172,91,142,64,78,224
2021,Wolverhampton 033,E02002181,7856,7091,266,180,86,202,83,119,297
2021,Wolverhampton 034,E02002182,6250,5590,261,180,81,171,84,87,228
2021,Bradford 001,E02002183,5542,4997,337,276,61,68,45,23,140
2021,Bradford 002,E02002184,12658,11570,654,529,125,156,92,64,278
2021,Bradford 003,E02002185,5573,5082,306,242,64,71,43,28,114
2021,Bradford 005,E02002187,5911,5418,294,226,68,85,47,38,114
2021,Bradford 006,E02002188,7410,6726,361,262,99,137,70,67,186
2021,Bradford 007,E02002189,6731,6104,250,164,86,202,86,116,175
2021,Bradford 008,E02002190,11017,10098,359,245,114,259,141,118,301
2021,Bradford 009,E02002191,8976,8163,295,183,112,242,81,161,276
2021,Bradford 010,E02002192,8764,7947,494,369,125,133,77,56,190
2021,Bradford 011,E02002193,6076,5561,183,132,51,143,66,77,189
2021,Bradford 012,E02002194,6976,6265,325,238,87,144,54,90,242
2021,Bradford 013,E02002195,6119,5514,362,291,71,86,46,40,157
2021,Bradford 014,E02002196,6073,5447,350,260,90,95,45,50,181
2021,Bradford 015,E02002197,8304,7575,401,291,110,134,65,69,194
2021,Bradford 016,E02002198,7928,7196,395,310,85,144,63,81,193
2021,Bradford 017,E02002199,6826,6182,378,281,97,90,39,51,176
2021,Bradford 018,E02002200,8642,7847,463,352,111,151,76,75,181
2021,Bradford 019,E02002201,11501,10470,561,394,167,183,93,90,287
2021,Bradford 020,E02002202,7079,6477,307,237,70,120,63,57,175
2021,Bradford 021,E02002203,7224,6595,273,188,85,152,67,85,204
2021,Bradford 022,E02002204,10929,9901,552,438,114,174,83,91,302
2021,Bradford 023,E02002205,9371,8531,440,324,116,159,67,92,241
2021,Bradford 024,E02002206,8261,7471,339,233,106,205,92,113,246
2021,Bradford 025,E02002207,7003,6327,292,185,107,192,89,103,192
2021,Bradford 026,E02002208,7598,6892,303,202,101,163,73,90,240
2021,Bradford 027,E02002209,6466,5927,184,119,65,151,60,91,204
2021,Bradford 028,E02002210,7184,6491,298,198,100,183,83,100,212
2021,Bradford 029,E02002211,7164,6512,272,152,120,219,96,123,161
2021,Bradford 030,E02002212,8599,7886,209,128,81,269,98,171,235
2021,Bradford 031,E02002213,7278,6562,373,264,109,126,67,59,217
2021,Bradford 032,E02002214,6121,5581,251,160,91,117,57,60,172
2021,Bradford 033,E02002215,9962,9040,285,142,143,333,151,182,304
2021,Bradford 034,E02002216,9421,8685,256,144,112,255,108,147,225
2021,Bradford 035,E02002217,9606,8863,271,160,111,238,86,152,234
2021,Bradford 036,E02002218,9462,8566,356,224,132,264,113,151,276
2021,Bradford 037,E02002219,7579,6929,187,111,76,242,116,126,221
2021,Bradford 038,E02002220,8832,8043,266,157,109,289,119,170,234
2021,Bradford 040,E02002222,8504,7749,266,165,101,210,75,135,279
2021,Bradford 041,E02002223,7225,6550,189,108,81,231,91,140,255
2021,Bradford 042,E02002224,10034,9250,254,144,110,281,115,166,249
2021,Bradford 043,E02002225,8089,7294,381,259,122,162,87,75,252
2021,Bradford 044,E02002226,12996,12038,320,188,132,351,141,210,287
2021,Bradford 045,E02002227,5688,5214,141,92,49,145,53,92,188
2021,Bradford 046,E02002228,6969,6350,231,150,81,172,75,97,216
2021,Bradford 047,E02002229,7854,7126,347,229,118,169,77,92,212
2021,Bradford 048,E02002230,7837,7213,218,116,102,225,88,137,181
2021,Bradford 049,E02002231,12412,11215,446,301,145,343,182,161,408
2021,Bradford 050,E02002232,6625,6061,189,112,77,172,64,108,203
2021,Bradford 051,E02002233,9012,8285,188,125,63,236,83,153,303
2021,Bradford 052,E02002234,6987,6323,182,121,61,206,71,135,276
2021,Bradford 053,E02002235,6545,5967,213,117,96,171,75,96,194
2021,Bradford 054,E02002236,6036,5456,270,185,85,156,88,68,154
2021,Bradford 055,E02002237,8162,7400,299,204,95,204,98,106,259
2021,Bradford 056,E02002238,6007,5434,193,127,66,180,65,115,200
2021,Bradford 057,E02002239,10072,9199,367,257,110,240,90,150,266
2021,Bradford 058,E02002240,10870,9890,501,385,116,186,95,91,293
2021,Bradford 059,E02002241,11411,10371,441,297,144,254,117,137,345
2021,Bradford 060,E02002242,7478,6746,338,236,102,150,63,87,244
2021,Bradford 061,E02002243,9038,8088,397,274,123,186,93,93,367
2021,Calderdale 001,E02002244,5786,5244,270,189,81,109,59,50,163
2021,Calderdale 002,E02002245,4984,4457,207,134,73,150,55,95,170
2021,Calderdale 003,E02002246,9142,8247,534,421,113,138,69,69,223
2021,Calderdale 004,E02002247,8599,7698,565,432,133,140,62,78,196
2021,Calderdale 005,E02002248,7275,6536,292,202,90,183,72,111,264
2021,Calderdale 006,E02002249,5175,4742,172,123,49,110,50,60,151
2021,Calderdale 007,E02002250,7884,7156,404,316,88,138,57,81,186
2021,Calderdale 008,E02002251,7504,6899,301,207,94,140,60,80,164
2021,Calderdale 009,E02002252,6361,5719,325,221,104,153,80,73,164
2021,Calderdale 010,E02002253,7868,7255,220,147,73,208,84,124,185
2021,Calderdale 011,E02002254,5920,5397,329,265,64,73,40,33,121
2021,Calderdale 012,E02002255,7138,6535,186,99,87,241,98,143,176
2021,Calderdale 013,E02002256,8963,8096,440,311,129,178,91,87,249
2021,Calderdale 014,E02002257,5975,5533,154,79,75,148,55,93,140
2021,Calderdale 015,E02002258,8465,7676,407,309,98,170,66,104,212
2021,Calderdale 016,E02002259,6740,6170,297,228,69,115,66,49,158
2021,Calderdale 017,E02002260,8612,7792,421,311,110,176,75,101,223
2021,Calderdale 018,E02002261,7499,6760,360,270,90,153,67,86,226
2021,Calderdale 019,E02002262,7312,6609,365,290,75,135,63,72,203
2021,Calderdale 020,E02002263,6185,5602,293,220,73,120,57,63,170
2021,Calderdale 021,E02002264,6724,6130,353,257,96,99,58,41,142
2021,Calderdale 022,E02002265,5349,4879,275,207,68,84,44,40,111
2021,Calderdale 023,E02002266,5472,4989,278,204,74,91,43,48,114
2021,Calderdale 024,E02002267,7593,6872,381,287,94,116,54,62,224
2021,Calderdale 025,E02002268,9744,8832,450,326,124,191,95,96,271
2021,Calderdale 026,E02002269,8907,8105,445,332,113,136,66,70,221
2021,Calderdale 027,E02002270,8131,7407,466,351,115,102,41,61,156
2021,Kirklees 001,E02002271,7120,6489,342,260,82,116,59,57,173
2021,Kirklees 002,E02002272,9089,8276,394,294,100,181,84,97,238
2021,Kirklees 003,E02002273,6214,5654,313,228,85,93,46,47,154
2021,Kirklees 004,E02002274,6551,5927,331,247,84,110,48,62,183
2021,Kirklees 005,E02002275,8086,7428,343,246,97,127,53,74,188
2021,Kirklees 006,E02002276,7314,6608,348,234,114,153,46,107,205
2021,Kirklees 007,E02002277,6447,5853,264,187,77,142,57,85,188
2021,Kirklees 008,E02002278,6348,5753,301,222,79,116,45,71,178
2021,Kirklees 009,E02002279,5885,5306,289,211,78,96,40,56,194
2021,Kirklees 010,E02002280,6374,5856,191,125,66,136,57,79,191
2021,Kirklees 011,E02002281,10899,9941,397,283,114,228,97,131,333
2021,Kirklees 012,E02002282,6851,6237,276,173,103,162,74,88,176
2021,Kirklees 013,E02002283,6731,6177,222,140,82,157,75,82,175
2021,Kirklees 014,E02002284,5869,5348,276,198,78,95,39,56,150
2021,Kirklees 015,E02002285,7585,6876,368,267,101,142,76,66,199
2021,Kirklees 016,E02002286,5789,5321,196,143,53,124,50,74,148
2021,Kirklees 017,E02002287,6741,6212,252,160,92,128,50,78,149
2021,Kirklees 018,E02002288,9493,8596,378,264,114,207,87,120,312
2021,Kirklees 019,E02002289,6511,5979,202,127,75,176,83,93,154
2021,Kirklees 020,E02002290,6019,5454,322,235,87,97,59,38,146
2021,Kirklees 021,E02002291,6215,5662,283,204,79,126,64,62,144
2021,Kirklees 022,E02002292,5372,4861,268,196,72,99,54,45,144
2021,Kirklees 023,E02002293,8103,7485,192,111,81,206,86,120,220
2021,Kirklees 024,E02002294,10365,9462,325,202,123,258,116,142,320
2021,Kirklees 025,E02002295,6718,6198,211,141,70,129,59,70,180
2021,Kirklees 026,E02002296,6588,5942,354,274,80,113,50,63,179
2021,Kirklees 027,E02002297,6615,5909,379,269,110,140,73,67,187
2021,Kirklees 028,E02002298,6281,5640,306,202,104,131,54,77,204
2021,Kirklees 029,E02002299,6716,6184,228,151,77,157,65,92,147
2021,Kirklees 030,E02002300,8047,7348,393,298,95,132,60,72,174
2021,Kirklees 031,E02002301,7616,6971,284,190,94,192,78,114,169
2021,Kirklees 032,E02002302,5891,5285,324,237,87,118,67,51,164
2021,Kirklees 033,E02002303,6285,5740,281,218,63,113,57,56,151
2021,Kirklees 034,E02002304,6230,5714,257,190,67,116,50,66,143
2021,Kirklees 035,E02002305,5800,5275,208,134,74,146,65,81,171
2021,Kirklees 036,E02002306,5929,5304,380,279,101,94,43,51,151
2021,Kirklees 037,E02002307,5579,5025,243,172,71,111,59,52,200
2021,Kirklees 038,E02002308,6426,5787,342,264,78,111,65,46,186
2021,Kirklees 039,E02002309,6395,5892,195,127,68,145,67,78,163
2021,Kirklees 040,E02002310,5430,4948,232,165,67,89,45,44,161
2021,Kirklees 041,E02002311,6170,5603,277,198,79,129,65,64,161
2021,Kirklees 042,E02002312,7699,7171,269,191,78,115,50,65,144
2021,Kirklees 043,E02002313,7191,6532,248,155,93,201,87,114,210
2021,Kirklees 044,E02002314,5613,5037,309,238,71,104,50,54,163
2021,Kirklees 045,E02002315,6310,5696,306,222,84,140,66,74,168
2021,Kirklees 046,E02002316,6376,5763,348,246,102,98,38,60,167
2021,Kirklees 047,E02002317,6937,6238,301,206,95,179,76,103,219
2021,Kirklees 048,E02002318,5821,5288,270,185,85,114,50,64,149
2021,Kirklees 049,E02002319,6570,6008,315,250,65,98,52,46,149
2021,Kirklees 050,E02002320,5758,5194,349,273,76,91,41,50,124
2021,Kirklees 051,E02002321,6528,5979,333,240,93,89,46,43,127
2021,Kirklees 052,E02002322,6071,5413,366,275,91,122,57,65,170
2021,Kirklees 053,E02002323,7852,7038,445,331,114,126,71,55,243
2021,Kirklees 054,E02002324,6290,5676,344,259,85,93,42,51,177
2021,Kirklees 055,E02002325,8632,7844,451,348,103,113,53,60,224
2021,Kirklees 056,E02002326,5720,5197,311,241,70,85,47,38,127
2021,Kirklees 057,E02002327,9598,8704,530,411,119,146,80,66,218
2021,Kirklees 058,E02002328,6740,6073,435,350,85,89,34,55,143
2021,Kirklees 059,E02002329,11684,10661,620,465,155,168,83,85,235
2021,Leeds 001,E02002330,6669,6084,373,287,86,73,43,30,139
2021,Leeds 002,E02002331,7043,6467,295,210,85,106,49,57,175
2021,Leeds 003,E02002332,6170,5566,325,230,95,108,51,57,171
2021,Leeds 004,E02002333,7498,6821,403,301,102,102,52,50,172
2021,Leeds 005,E02002334,7207,6551,389,307,82,101,56,45,166
2021,Leeds 006,E02002335,7142,6558,380,288,92,67,39,28,137
2021,Leeds 007,E02002336,6633,6025,385,282,103,70,39,31,153
2021,Leeds 008,E02002337,7338,6722,399,313,86,81,41,40,136
2021,Leeds 009,E02002338,6921,6358,330,247,83,73,40,33,160
2021,Leeds 010,E02002339,5306,4791,276,207,69,93,43,50,146
2021,Leeds 011,E02002340,5599,5035,312,219,93,99,51,48,153
2021,Leeds 012,E02002341,7059,6418,392,302,90,102,50,52,147
2021,Leeds 013,E02002342,5737,5200,313,225,88,84,44,40,140
2021,Leeds 014,E02002343,5603,5139,278,218,60,75,36,39,111
2021,Leeds 015,E02002344,7363,6700,343,264,79,149,78,71,171
2021,Leeds 016,E02002345,5867,5359,299,243,56,88,45,43,121
2021,Leeds 017,E02002346,5744,5198,267,190,77,112,64,48,167
2021,Leeds 018,E02002347,6015,5484,234,156,78,131,72,59,166
2021,Leeds 019,E02002348,6140,5588,276,202,74,98,56,42,178
2021,Leeds 020,E02002349,5504,5028,316,257,59,71,35,36,89
2021,Leeds 021,E02002350,6349,5832,341,271,70,69,34,35,107
2021,Leeds 022,E02002351,5350,4827,315,248,67,63,29,34,145
2021,Leeds 023,E02002352,7314,6725,327,246,81,106,54,52,156
2021,Leeds 024,E02002353,5610,5089,309,242,67,85,44,41,127
2021,Leeds 025,E02002354,7665,6951,377,269,108,140,65,75,197
2021,Leeds 027,E02002356,8656,8093,342,274,68,113,55,58,108
2021,Leeds 028,E02002357,7854,7185,333,257,76,142,66,76,194
2021,Leeds 029,E02002358,8036,7255,344,264,80,173,88,85,264
2021,Leeds 030,E02002359,6197,5599,337,251,86,94,44,50,167
2021,Leeds 031,E02002360,6487,5931,301,227,74,96,42,54,159
2021,Leeds 032,E02002361,5690,5207,286,213,73,85,43,42,112
2021,Leeds 033,E02002362,7560,6894,289,183,106,173,70,103,204
2021,Leeds 034,E02002363,6721,6254,287,227,60,95,45,50,85
2021,Leeds 035,E02002364,5564,5029,202,138,64,117,49,68,216
2021,Leeds 037,E02002366,7907,7203,378,276,102,148,78,70,178
2021,Leeds 038,E02002367,6055,5537,222,154,68,142,71,71,154
2021,Leeds 039,E02002368,8109,7430,412,319,93,110,52,58,157
2021,Leeds 040,E02002369,7368,6696,231,149,82,139,62,77,302
2021,Leeds 041,E02002370,6692,6065,248,176,72,165,63,102,214
2021,Leeds 042,E02002371,9940,9106,390,262,128,218,110,108,226
2021,Leeds 044,E02002373,8385,8079,197,164,33,55,23,32,54
2021,Leeds 045,E02002374,6526,6052,264,192,72,92,43,49,118
2021,Leeds 046,E02002375,6135,5680,201,150,51,94,38,56,160
2021,Leeds 047,E02002376,7249,6717,195,127,68,159,72,87,178
2021,Leeds 048,E02002377,6941,6490,170,109,61,156,67,89,125
2021,Leeds 050,E02002379,5514,4959,208,145,63,130,58,72,217
2021,Leeds 051,E02002380,5252,4773,239,173,66,98,33,65,142
2021,Leeds 052,E02002381,5904,5385,282,213,69,87,52,35,150
2021,Leeds 053,E02002382,6446,6019,175,100,75,130,58,72,122
2021,Leeds 054,E02002383,7981,7717,164,135,29,49,20,29,51
2021,Leeds 055,E02002384,11715,11206,223,155,68,140,68,72,146
2021,Leeds 056,E02002385,8228,7821,236,184,52,87,38,49,84
2021,Leeds 057,E02002386,8713,7818,486,354,132,148,78,70,261
2021,Leeds 058,E02002387,5696,5169,215,141,74,105,34,71,207
2021,Leeds 059,E02002388,7542,6942,281,204,77,121,51,70,198
2021,Leeds 060,E02002389,7148,6543,191,116,75,166,92,74,248
2021,Leeds 061,E02002390,6641,6038,278,191,87,146,62,84,179
2021,Leeds 062,E02002391,7479,6861,307,234,73,120,60,60,191
2021,Leeds 063,E02002392,9821,9551,165,130,35,54,21,33,51
2021,Leeds 064,E02002393,8046,7620,163,107,56,141,63,78,122
2021,Leeds 065,E02002394,6938,6510,161,103,58,122,50,72,145
2021,Leeds 066,E02002395,6898,6233,321,216,105,154,83,71,190
2021,Leeds 067,E02002396,8486,7831,312,230,82,136,60,76,207
2021,Leeds 068,E02002397,7256,6583,321,227,94,147,59,88,205
2021,Leeds 069,E02002398,7154,6451,355,261,94,145,81,64,203
2021,Leeds 070,E02002399,6010,5490,188,129,59,136,57,79,196
2021,Leeds 071,E02002400,9062,8446,245,142,103,170,72,98,201
2021,Leeds 072,E02002401,6095,5595,146,92,54,147,58,89,207
2021,Leeds 073,E02002402,5508,4983,322,251,71,67,36,31,136
2021,Leeds 074,E02002403,6047,5486,305,210,95,104,47,57,152
2021,Leeds 075,E02002404,10289,9752,218,159,59,157,83,74,162
2021,Leeds 076,E02002405,8618,7914,370,274,96,146,64,82,188
2021,Leeds 077,E02002406,6892,6261,370,283,87,83,51,32,178
2021,Leeds 078,E02002407,6007,5482,211,127,84,132,48,84,182
2021,Leeds 079,E02002408,7169,6494,331,231,100,127,61,66,217
2021,Leeds 080,E02002409,5755,5201,260,177,83,117,57,60,177
2021,Leeds 081,E02002410,6534,6019,261,184,77,109,50,59,145
2021,Leeds 082,E02002411,8473,7998,176,129,47,138,66,72,161
2021,Leeds 083,E02002412,6829,6267,290,226,64,113,49,64,159
2021,Leeds 085,E02002414,6291,5889,131,83,48,125,50,75,146
2021,Leeds 086,E02002415,7194,6725,154,100,54,158,91,67,157
2021,Leeds 087,E02002416,6600,5925,303,209,94,150,75,75,222
2021,Leeds 088,E02002417,6887,6198,315,223,92,150,81,69,224
2021,Leeds 089,E02002418,6723,6071,325,221,104,123,58,65,204
2021,Leeds 090,E02002419,7572,6910,247,166,81,189,75,114,226
2021,Leeds 091,E02002420,7781,7192,278,188,90,142,61,81,169
2021,Leeds 092,E02002421,5896,5366,174,96,78,151,54,97,205
2021,Leeds 093,E02002422,6129,5600,283,207,76,92,46,46,154
2021,Leeds 094,E02002423,5426,4885,209,129,80,130,53,77,202
2021,Leeds 095,E02002424,7215,6577,333,254,79,113,65,48,192
2021,Leeds 096,E02002425,8247,7454,412,306,106,136,61,75,245
2021,Leeds 097,E02002426,7350,6681,337,262,75,114,51,63,218
2021,Leeds 098,E02002427,6333,5687,321,235,86,122,66,56,203
2021,Leeds 099,E02002428,7503,6878,264,198,66,138,64,74,223
2021,Leeds 100,E02002429,8037,7329,395,292,103,132,63,69,181
2021,Leeds 101,E02002430,7509,6885,197,126,71,171,71,100,256
2021,Leeds 102,E02002431,8305,7631,347,260,87,123,60,63,204
2021,Leeds 103,E02002432,7279,6578,366,274,92,144,70,74,191
2021,Leeds 104,E02002433,6434,5862,285,210,75,129,64,65,158
2021,Leeds 105,E02002434,9548,8762,399,297,102,153,69,84,234
2021,Leeds 106,E02002435,7796,7152,342,251,91,129,54,75,173
2021,Leeds 107,E02002436,6497,5816,357,263,94,125,59,66,199
2021,Leeds 108,E02002437,5889,5288,353,270,83,121,53,68,127
2021,Wakefield 001,E02002438,8274,7430,252,160,92,235,89,146,357
2021,Wakefield 002,E02002439,8188,7468,295,189,106,203,97,106,222
2021,Wakefield 003,E02002440,7467,6679,290,185,105,191,87,104,307
2021,Wakefield 004,E02002441,9167,8317,326,230,96,214,79,135,310
2021,Wakefield 005,E02002442,6870,6215,297,216,81,137,62,75,221
2021,Wakefield 006,E02002443,5825,5343,262,195,67,96,40,56,124
2021,Wakefield 007,E02002444,6526,5972,288,203,85,101,47,54,165
2021,Wakefield 008,E02002445,8025,7299,353,239,114,144,61,83,229
2021,Wakefield 009,E02002446,5662,5127,270,184,86,106,53,53,159
2021,Wakefield 010,E02002447,5784,5186,236,161,75,125,63,62,237
2021,Wakefield 011,E02002448,7555,6845,266,186,80,160,62,98,284
2021,Wakefield 012,E02002449,9201,8342,395,280,115,195,92,103,269
2021,Wakefield 013,E02002450,7463,6825,268,195,73,148,62,86,222
2021,Wakefield 014,E02002451,7571,6837,390,281,109,136,67,69,208
2021,Wakefield 015,E02002452,8649,7880,337,228,109,162,63,99,270
2021,Wakefield 016,E02002453,9120,8286,325,216,109,213,88,125,296
2021,Wakefield 017,E02002454,8626,8067,247,168,79,137,53,84,175
2021,Wakefield 018,E02002455,6097,5531,194,127,67,154,63,91,218
2021,Wakefield 019,E02002456,7635,7100,238,174,64,121,56,65,176
2021,Wakefield 020,E02002457,7421,6756,224,136,88,195,76,119,246
2021,Wakefield 021,E02002458,8588,7799,404,303,101,156,74,82,229
2021,Wakefield 022,E02002459,9402,8547,375,273,102,196,97,99,284
2021,Wakefield 023,E02002460,7156,6401,401,304,97,141,65,76,213
2021,Wakefield 024,E02002461,11191,10181,412,271,141,239,102,137,359
2021,Wakefield 025,E02002462,7082,6405,348,253,95,137,65,72,192
2021,Wakefield 026,E02002463,9654,8706,335,212,123,236,91,145,377
2021,Wakefield 027,E02002464,8443,7653,303,225,78,178,83,95,309
2021,Wakefield 028,E02002465,5832,5263,295,205,90,98,45,53,176
2021,Wakefield 029,E02002466,8615,7741,418,304,114,183,93,90,273
2021,Wakefield 030,E02002467,8362,7698,273,193,80,169,76,93,222
2021,Wakefield 031,E02002468,5871,5286,300,215,85,109,55,54,176
2021,Wakefield 032,E02002469,6174,5551,294,201,93,115,54,61,214
2021,Wakefield 033,E02002470,5767,5186,319,261,58,95,54,41,167
2021,Wakefield 034,E02002471,10882,9786,561,393,168,192,80,112,343
2021,Wakefield 035,E02002472,5537,4969,334,251,83,79,48,31,155
2021,Wakefield 036,E02002473,6376,5743,320,255,65,120,53,67,193
2021,Wakefield 037,E02002474,6535,5890,303,215,88,134,58,76,208
2021,Wakefield 038,E02002475,6007,5407,317,252,65,85,38,47,198
2021,Wakefield 039,E02002476,6228,5562,234,156,78,159,51,108,273
2021,Wakefield 040,E02002477,5946,5248,271,178,93,156,71,85,271
2021,Wakefield 041,E02002478,5877,5215,261,174,87,178,79,99,223
2021,Wakefield 042,E02002479,7763,6870,345,230,115,218,81,137,330
2021,Wakefield 043,E02002480,5219,4659,201,120,81,148,70,78,211
2021,Wakefield 044,E02002481,6947,6302,255,180,75,140,62,78,250
2021,Wakefield 045,E02002482,6710,5988,237,156,81,166,76,90,319
2021,Hartlepool 001,E02002483,9673,8722,406,284,122,218,102,116,327
2021,Hartlepool 002,E02002484,9616,8517,345,224,121,345,128,217,409
2021,Hartlepool 003,E02002485,7514,6608,271,167,104,261,116,145,374
2021,Hartlepool 007,E02002489,6764,6052,254,165,89,213,102,111,245
2021,Hartlepool 008,E02002490,5445,4864,220,135,85,156,60,96,205
2021,Hartlepool 009,E02002491,6132,5411,218,139,79,222,89,133,281
2021,Hartlepool 010,E02002492,6391,5687,230,125,105,182,76,106,292
2021,Hartlepool 011,E02002493,6442,5747,319,229,90,154,72,82,222
2021,Hartlepool 012,E02002494,7079,6272,270,173,97,254,85,169,283
2021,Middlesbrough 001,E02002496,11207,10461,252,156,96,238,97,141,256
2021,Middlesbrough 002,E02002497,5675,5159,170,96,74,148,54,94,198
2021,Middlesbrough 003,E02002498,7891,7363,171,96,75,176,72,104,181
2021,Middlesbrough 004,E02002499,7055,6342,200,124,76,230,90,140,283
2021,Middlesbrough 005,E02002500,5543,4994,207,146,61,157,71,86,185
2021,Middlesbrough 006,E02002501,5837,5313,176,97,79,130,57,73,218
2021,Middlesbrough 007,E02002502,9108,8139,263,143,120,314,122,192,392
2021,Middlesbrough 008,E02002503,6340,5710,222,136,86,198,107,91,210
2021,Middlesbrough 009,E02002504,9151,8372,347,240,107,170,78,92,262
2021,Middlesbrough 010,E02002505,5863,5241,151,94,57,200,86,114,271
2021,Middlesbrough 011,E02002506,5279,4762,138,83,55,178,77,101,201
2021,Middlesbrough 012,E02002507,5867,5331,258,172,86,114,56,58,164
2021,Middlesbrough 013,E02002508,5135,4629,220,146,74,103,43,60,183
2021,Middlesbrough 014,E02002509,4835,4340,178,114,64,132,57,75,185
2021,Middlesbrough 015,E02002510,6672,6084,279,203,76,119,60,59,190
2021,Middlesbrough 017,E02002512,5104,4588,288,211,77,88,42,46,140
2021,Middlesbrough 018,E02002513,9636,8684,344,227,117,269,111,158,339
2021,Middlesbrough 019,E02002514,8016,7162,385,262,123,197,91,106,272
2021,Redcar and Cleveland 001,E02002515,6175,5608,244,155,89,161,64,97,162
2021,Redcar and Cleveland 002,E02002516,5491,4921,216,146,70,130,54,76,224
2021,Redcar and Cleveland 003,E02002517,5000,4432,184,116,68,148,57,91,236
2021,Redcar and Cleveland 004,E02002518,10378,9215,569,412,157,217,105,112,377
2021,Redcar and Cleveland 005,E02002519,7064,6227,261,163,98,216,80,136,360
2021,Redcar and Cleveland 006,E02002520,12590,11262,644,450,194,273,134,139,411
2021,Redcar and Cleveland 007,E02002521,5708,5091,305,212,93,100,48,52,212
2021,Redcar and Cleveland 009,E02002523,5819,5153,158,92,66,229,85,144,279
2021,Redcar and Cleveland 010,E02002524,5153,4554,216,140,76,132,53,79,251
2021,Redcar and Cleveland 011,E02002525,7636,6875,265,172,93,195,85,110,301
2021,Redcar and Cleveland 012,E02002526,7326,6485,337,213,124,208,94,114,296
2021,Redcar and Cleveland 013,E02002527,4750,4256,183,118,65,124,46,78,187
2021,Redcar and Cleveland 015,E02002529,5446,4883,249,173,76,137,55,82,177
2021,Redcar and Cleveland 016,E02002530,5913,5242,233,145,88,155,69,86,283
2021,Redcar and Cleveland 018,E02002532,6383,5786,247,164,83,143,58,85,207
2021,Redcar and Cleveland 019,E02002533,6269,5678,293,217,76,117,56,61,181
2021,Redcar and Cleveland 020,E02002534,5392,4841,284,223,61,96,48,48,171
2021,Stockton-on-Tees 001,E02002535,8775,7809,478,321,157,198,86,112,290
2021,Stockton-on-Tees 002,E02002536,8848,7813,407,289,118,248,116,132,380
2021,Stockton-on-Tees 003,E02002537,7782,6932,255,161,94,244,95,149,351
2021,Stockton-on-Tees 004,E02002538,5356,4798,217,146,71,116,40,76,225
2021,Stockton-on-Tees 005,E02002539,10026,8992,536,385,151,200,97,103,298
2021,Stockton-on-Tees 006,E02002540,5810,5250,265,201,64,88,42,46,207
2021,Stockton-on-Tees 007,E02002541,5729,5152,269,189,80,115,56,59,193
2021,Stockton-on-Tees 008,E02002542,7548,6682,244,132,112,262,119,143,360
2021,Stockton-on-Tees 009,E02002543,8580,7699,292,182,110,218,82,136,371
2021,Stockton-on-Tees 010,E02002544,8476,7741,296,187,109,189,82,107,250
2021,Stockton-on-Tees 011,E02002545,4810,4299,255,182,73,93,43,50,163
2021,Stockton-on-Tees 012,E02002546,6991,6271,236,150,86,195,78,117,289
2021,Stockton-on-Tees 013,E02002547,5849,5161,312,212,100,143,73,70,233
2021,Stockton-on-Tees 015,E02002549,7152,6395,359,235,124,140,69,71,258
2021,Stockton-on-Tees 016,E02002550,5730,5171,257,169,88,140,60,80,162
2021,Stockton-on-Tees 017,E02002551,5041,4581,149,101,48,146,58,88,165
2021,Stockton-on-Tees 018,E02002552,6732,6076,258,173,85,171,69,102,227
2021,Stockton-on-Tees 019,E02002553,5487,4971,192,126,66,147,56,91,177
2021,Stockton-on-Tees 020,E02002554,4791,4276,160,98,62,135,47,88,220
2021,Stockton-on-Tees 021,E02002555,9837,8903,457,325,132,181,84,97,296
2021,Stockton-on-Tees 022,E02002556,6940,6263,357,259,98,140,56,84,180
2021,Stockton-on-Tees 024,E02002558,10516,9575,486,376,110,197,106,91,258
2021,Darlington 001,E02002559,9197,8273,536,400,136,149,67,82,239
2021,Darlington 002,E02002560,5939,5425,237,173,64,106,46,60,171
2021,Darlington 003,E02002561,5216,4686,272,216,56,97,44,53,161
2021,Darlington 004,E02002562,5320,4857,207,141,66,104,44,60,152
2021,Darlington 005,E02002563,5321,4774,211,146,65,140,54,86,196
2021,Darlington 006,E02002564,9197,8244,375,251,124,243,107,136,335
2021,Darlington 009,E02002567,8722,7884,295,195,100,240,94,146,303
2021,Darlington 010,E02002568,5817,5279,351,264,87,67,38,29,120
2021,Darlington 011,E02002569,8820,7907,517,383,134,135,66,69,261
2021,Darlington 012,E02002570,7130,6452,271,183,88,153,63,90,254
2021,Darlington 013,E02002571,5927,5327,239,145,94,163,65,98,198
2021,Darlington 014,E02002572,5892,5328,220,147,73,135,55,80,209
2021,Darlington 015,E02002573,8944,8105,439,335,104,150,69,81,250
2021,Halton 001,E02002574,8219,7350,499,353,146,185,105,80,185
2021,Halton 002,E02002575,9082,8151,510,334,176,163,87,76,258
2021,Halton 003,E02002576,7071,6304,302,191,111,201,84,117,264
2021,Halton 004,E02002577,6852,6057,281,179,102,207,103,104,307
2021,Halton 005,E02002578,7973,7125,360,262,98,229,113,116,259
2021,Halton 006,E02002579,7396,6602,316,215,101,181,65,116,297
2021,Halton 007,E02002580,7337,6576,254,161,93,234,117,117,273
2021,Halton 008,E02002581,6766,6014,291,187,104,198,84,114,263
2021,Halton 009,E02002582,8855,7978,483,352,131,155,81,74,239
2021,Halton 010,E02002583,7142,6149,301,184,117,268,96,172,424
2021,Halton 011,E02002584,6939,6152,340,236,104,168,71,97,279
2021,Halton 012,E02002585,10075,9051,473,332,141,231,107,124,320
2021,Halton 013,E02002586,8933,7762,359,216,143,329,140,189,483
2021,Halton 014,E02002587,6094,5296,266,172,94,193,74,119,339
2021,Halton 015,E02002588,6777,5887,302,186,116,250,104,146,338
2021,Halton 016,E02002589,6013,5337,322,217,105,133,68,65,221
2021,Warrington 001,E02002590,7046,6370,402,299,103,112,67,45,162
2021,Warrington 002,E02002591,6215,5564,310,233,77,129,76,53,212
2021,Warrington 003,E02002592,5963,5267,382,269,113,127,55,72,187
2021,Warrington 004,E02002593,4847,4321,253,175,78,109,47,62,164
2021,Warrington 005,E02002594,5242,4709,241,165,76,105,55,50,187
2021,Warrington 006,E02002595,7532,6783,254,157,97,232,93,139,263
2021,Warrington 007,E02002596,7705,6870,421,299,122,155,71,84,259
2021,Warrington 008,E02002597,8627,7695,362,240,122,225,97,128,345
2021,Warrington 009,E02002598,10488,9722,458,342,116,138,70,68,170
2021,Warrington 010,E02002599,10569,9585,568,437,131,167,75,92,249
2021,Warrington 011,E02002600,8664,7774,386,255,131,195,105,90,309
2021,Warrington 012,E02002601,8569,7723,443,307,136,150,76,74,253
2021,Warrington 013,E02002602,7582,6951,229,148,81,203,76,127,199
2021,Warrington 014,E02002603,6665,5981,349,261,88,134,62,72,201
2021,Warrington 015,E02002604,7403,6602,477,360,117,128,61,67,196
2021,Warrington 016,E02002605,8524,7695,427,288,139,176,81,95,226
2021,Warrington 017,E02002606,10623,9820,376,245,131,208,104,104,219
2021,Warrington 018,E02002607,10640,9788,394,305,89,202,91,111,256
2021,Warrington 019,E02002608,7912,6980,496,364,132,158,85,73,278
2021,Warrington 020,E02002609,9028,8252,347,232,115,181,78,103,248
2021,Warrington 021,E02002610,12098,11073,639,509,130,155,87,68,231
2021,Warrington 022,E02002611,7444,6745,410,327,83,99,49,50,190
2021,Warrington 023,E02002612,8755,7955,463,342,121,133,59,74,204
2021,Warrington 024,E02002613,6573,5973,376,293,83,97,46,51,127
2021,Warrington 025,E02002614,5628,5045,378,308,70,83,53,30,122
2021,Blackburn with Darwen 001,E02002615,9993,9075,410,270,140,234,105,129,274
2021,Blackburn with Darwen 002,E02002616,8878,8065,383,240,143,196,104,92,234
2021,Blackburn with Darwen 003,E02002617,8992,8212,263,156,107,252,117,135,265
2021,Blackburn with Darwen 004,E02002618,7441,6827,222,135,87,185,88,97,207
2021,Blackburn with Darwen 005,E02002619,8707,8023,256,147,109,217,94,123,211
2021,Blackburn with Darwen 006,E02002620,8450,7736,234,145,89,206,87,119,274
2021,Blackburn with Darwen 007,E02002621,7989,7335,228,132,96,197,88,109,229
2021,Blackburn with Darwen 008,E02002622,10212,9323,281,176,105,253,109,144,355
2021,Blackburn with Darwen 009,E02002623,9652,8779,316,202,114,276,118,158,281
2021,Blackburn with Darwen 010,E02002624,8334,7529,425,307,118,151,66,85,229
2021,Blackburn with Darwen 011,E02002625,9384,8494,331,225,106,244,107,137,315
2021,Blackburn with Darwen 012,E02002626,6890,6125,299,188,111,154,71,83,312
2021,Blackburn with Darwen 013,E02002627,7134,6502,323,236,87,130,53,77,179
2021,Blackburn with Darwen 014,E02002628,6486,5800,295,203,92,149,69,80,242
2021,Blackburn with Darwen 015,E02002629,5578,4985,242,170,72,143,58,85,208
2021,Blackburn with Darwen 016,E02002630,5986,5413,216,154,62,145,68,77,212
2021,Blackburn with Darwen 017,E02002631,8497,7707,370,254,116,171,76,95,249
2021,Blackburn with Darwen 018,E02002632,6079,5473,390,308,82,94,54,40,122
2021,Blackpool 001,E02002633,7333,6499,352,239,113,182,75,107,300
2021,Blackpool 002,E02002634,7678,6806,374,257,117,171,89,82,327
2021,Blackpool 003,E02002635,7477,6588,396,267,129,188,83,105,305
2021,Blackpool 004,E02002636,7577,6725,356,227,129,194,90,104,302
2021,Blackpool 005,E02002637,5906,5251,296,204,92,115,56,59,244
2021,Blackpool 006,E02002638,6219,5588,234,157,77,156,62,94,241
2021,Blackpool 007,E02002639,5707,5033,215,144,71,184,84,100,275
2021,Blackpool 008,E02002640,6596,5917,222,144,78,202,76,126,255
2021,Blackpool 009,E02002641,7540,6817,311,223,88,187,86,101,225
2021,Blackpool 010,E02002642,6706,6022,198,130,68,224,80,144,262
2021,Blackpool 011,E02002643,7260,6516,253,155,98,201,79,122,290
2021,Blackpool 012,E02002644,7433,6648,407,297,110,149,66,83,229
2021,Blackpool 013,E02002645,5982,5403,163,78,85,164,50,114,252
2021,Blackpool 014,E02002646,6712,5893,308,186,122,200,83,117,311
2021,Blackpool 015,E02002647,7523,6723,289,173,116,230,100,130,281
2021,Blackpool 016,E02002648,6666,5929,266,159,107,174,79,95,297
2021,Blackpool 017,E02002649,7961,7065,404,282,122,226,115,111,266
2021,Blackpool 018,E02002650,7882,6979,389,268,121,192,88,104,322
2021,Blackpool 019,E02002651,7515,6661,395,266,129,183,91,92,276
2021,Kingston upon Hull 002,E02002653,7615,6789,230,144,86,225,82,143,371
2021,Kingston upon Hull 003,E02002654,7519,6908,160,104,56,160,52,108,291
2021,Kingston upon Hull 004,E02002655,8161,7334,249,154,95,222,72,150,356
2021,Kingston upon Hull 005,E02002656,4911,4372,257,178,79,93,41,52,189
2021,Kingston upon Hull 006,E02002657,7135,6477,241,167,74,164,64,100,253
2021,Kingston upon Hull 007,E02002658,6283,5723,270,171,99,106,58,48,184
2021,Kingston upon Hull 008,E02002659,10506,9523,283,173,110,299,102,197,401
2021,Kingston upon Hull 009,E02002660,6588,5935,206,130,76,172,78,94,275
2021,Kingston upon Hull 010,E02002661,7967,7230,280,176,104,162,55,107,295
2021,Kingston upon Hull 011,E02002662,6992,6346,246,168,78,141,61,80,259
2021,Kingston upon Hull 012,E02002663,7860,7406,237,195,42,84,40,44,133
2021,Kingston upon Hull 013,E02002664,6884,6215,360,263,97,120,59,61,189
2021,Kingston upon Hull 014,E02002665,7561,6885,353,258,95,138,68,70,185
2021,Kingston upon Hull 015,E02002666,7726,7335,146,99,47,111,51,60,134
2021,Kingston upon Hull 016,E02002667,6897,6365,235,148,87,126,59,67,171
2021,Kingston upon Hull 017,E02002668,7801,7014,192,115,77,213,72,141,382
2021,Kingston upon Hull 018,E02002669,7624,7121,262,190,72,114,53,61,127
2021,Kingston upon Hull 019,E02002670,7481,6731,268,177,91,185,76,109,297
2021,Kingston upon Hull 020,E02002671,8495,7773,291,208,83,183,72,111,248
2021,Kingston upon Hull 021,E02002672,6717,6124,146,83,63,166,42,124,281
2021,Kingston upon Hull 022,E02002673,7057,6475,231,150,81,159,65,94,192
2021,Kingston upon Hull 023,E02002674,6226,5693,277,208,69,102,49,53,154
2021,Kingston upon Hull 024,E02002675,8026,7437,171,108,63,206,75,131,212
2021,Kingston upon Hull 025,E02002676,6872,6346,229,167,62,105,45,60,192
2021,Kingston upon Hull 026,E02002677,7833,7219,260,195,65,131,42,89,223
2021,Kingston upon Hull 027,E02002678,7988,7376,291,203,88,135,62,73,186
2021,Kingston upon Hull 028,E02002679,7340,6618,336,245,91,148,67,81,238
2021,Kingston upon Hull 029,E02002680,9243,8685,205,135,70,178,61,117,175
2021,Kingston upon Hull 030,E02002681,8466,7870,200,126,74,154,44,110,242
2021,Kingston upon Hull 031,E02002682,9953,9036,264,163,101,254,102,152,399
2021,East Riding of Yorkshire 001,E02002684,9794,8597,456,329,127,257,115,142,484
2021,East Riding of Yorkshire 002,E02002685,7564,6747,347,238,109,151,71,80,319
2021,East Riding of Yorkshire 003,E02002686,7314,6548,243,151,92,200,81,119,323
2021,East Riding of Yorkshire 004,E02002687,5642,5097,201,136,65,144,56,88,200
2021,East Riding of Yorkshire 005,E02002688,5189,4665,198,144,54,125,54,71,201
2021,East Riding of Yorkshire 006,E02002689,5530,4953,280,210,70,116,45,71,181
2021,East Riding of Yorkshire 008,E02002691,7964,7233,373,264,109,132,63,69,226
2021,East Riding of Yorkshire 009,E02002692,9236,8461,460,365,95,118,60,58,197
2021,East Riding of Yorkshire 010,E02002693,6771,6045,362,257,105,128,59,69,236
2021,East Riding of Yorkshire 011,E02002694,12202,11222,575,442,133,138,82,56,267
2021,East Riding of Yorkshire 012,E02002695,7934,7061,384,262,122,154,77,77,335
2021,East Riding of Yorkshire 013,E02002696,6043,5519,307,226,81,80,39,41,137
2021,East Riding of Yorkshire 014,E02002697,7275,6503,401,292,109,135,63,72,236
2021,East Riding of Yorkshire 015,E02002698,8103,7428,328,255,73,129,63,66,218
2021,East Riding of Yorkshire 016,E02002699,9437,8619,473,372,101,129,64,65,216
2021,East Riding of Yorkshire 017,E02002700,5709,5160,258,184,74,112,49,63,179
2021,East Riding of Yorkshire 018,E02002701,8301,7532,410,324,86,124,69,55,235
2021,East Riding of Yorkshire 019,E02002702,9396,8566,480,372,108,125,58,67,225
2021,East Riding of Yorkshire 020,E02002703,8952,8116,517,410,107,111,55,56,208
2021,East Riding of Yorkshire 021,E02002704,6910,6191,335,234,101,136,62,74,248
2021,East Riding of Yorkshire 022,E02002705,6753,6152,308,232,76,108,54,54,185
2021,East Riding of Yorkshire 023,E02002706,6933,6262,371,279,92,114,55,59,186
2021,East Riding of Yorkshire 024,E02002707,6516,5914,360,260,100,88,42,46,154
2021,East Riding of Yorkshire 025,E02002708,5598,5107,242,173,69,95,49,46,154
2021,East Riding of Yorkshire 026,E02002709,8012,7334,348,255,93,128,63,65,202
2021,East Riding of Yorkshire 027,E02002710,6922,6261,351,273,78,113,53,60,197
2021,East Riding of Yorkshire 028,E02002711,7559,6836,425,324,101,100,52,48,198
2021,East Riding of Yorkshire 029,E02002712,7055,6404,332,237,95,95,52,43,224
2021,East Riding of Yorkshire 031,E02002714,7559,6784,356,254,102,136,63,73,283
2021,East Riding of Yorkshire 032,E02002715,12895,11854,597,457,140,174,84,90,270
2021,East Riding of Yorkshire 033,E02002716,8090,7290,378,272,106,157,77,80,265
2021,East Riding of Yorkshire 034,E02002717,7508,6863,332,241,91,122,61,61,191
2021,East Riding of Yorkshire 035,E02002718,7735,7027,422,323,99,99,48,51,187
2021,East Riding of Yorkshire 036,E02002719,6407,5853,326,256,70,95,40,55,133
2021,East Riding of Yorkshire 037,E02002720,7283,6679,338,248,90,115,61,54,151
2021,East Riding of Yorkshire 038,E02002721,6371,5739,329,239,90,115,50,65,188
2021,East Riding of Yorkshire 039,E02002722,8115,7204,301,203,98,210,87,123,400
2021,East Riding of Yorkshire 040,E02002723,8026,7413,264,184,80,141,60,81,208
2021,East Riding of Yorkshire 041,E02002724,8993,8280,264,195,69,170,66,104,279
2021,East Riding of Yorkshire 042,E02002725,6599,6003,308,225,83,109,52,57,179
2021,North East Lincolnshire 001,E02002726,9869,8949,349,235,114,206,88,118,365
2021,North East Lincolnshire 002,E02002727,4642,4196,150,98,52,119,44,75,177
2021,North East Lincolnshire 003,E02002728,7024,6407,231,136,95,171,77,94,215
2021,North East Lincolnshire 004,E02002729,5354,4810,247,168,79,118,49,69,179
2021,North East Lincolnshire 005,E02002730,6581,5977,195,118,77,170,65,105,239
2021,North East Lincolnshire 006,E02002731,5176,4730,144,94,50,121,33,88,181
2021,North East Lincolnshire 007,E02002732,7589,6836,416,293,123,139,62,77,198
2021,North East Lincolnshire 008,E02002733,5462,4948,217,151,66,132,55,77,165
2021,North East Lincolnshire 009,E02002734,5227,4798,165,120,45,102,43,59,162
2021,North East Lincolnshire 011,E02002736,5175,4728,160,102,58,130,50,80,157
2021,North East Lincolnshire 012,E02002737,6731,6090,288,188,100,149,75,74,204
2021,North East Lincolnshire 013,E02002738,6525,5939,240,169,71,137,54,83,209
2021,North East Lincolnshire 014,E02002739,5453,4945,207,145,62,109,47,62,192
2021,North East Lincolnshire 015,E02002740,5139,4672,158,110,48,120,52,68,189
2021,North East Lincolnshire 016,E02002741,8464,7699,374,268,106,174,90,84,217
2021,North East Lincolnshire 018,E02002743,5221,4654,218,154,64,118,56,62,231
2021,North East Lincolnshire 019,E02002744,6431,5732,169,103,66,183,64,119,347
2021,North East Lincolnshire 020,E02002745,6961,6225,353,258,95,150,73,77,233
2021,North East Lincolnshire 021,E02002746,9335,8504,416,300,116,161,60,101,254
2021,North East Lincolnshire 022,E02002747,8823,7934,470,347,123,159,87,72,260
2021,North East Lincolnshire 023,E02002748,7656,6880,418,319,99,129,56,73,229
2021,North Lincolnshire 001,E02002749,11304,10234,501,358,143,222,111,111,347
2021,North Lincolnshire 002,E02002750,6121,5512,294,198,96,121,63,58,194
2021,North Lincolnshire 003,E02002751,6087,5443,305,206,99,140,60,80,199
2021,North Lincolnshire 004,E02002752,6762,6081,277,169,108,176,89,87,228
2021,North Lincolnshire 005,E02002753,8111,7234,403,284,119,177,95,82,297
2021,North Lincolnshire 006,E02002754,7874,7045,349,220,129,202,76,126,278
2021,North Lincolnshire 007,E02002755,7047,6562,199,139,60,137,56,81,149
2021,North Lincolnshire 008,E02002756,8423,7835,181,119,62,183,68,115,224
2021,North Lincolnshire 009,E02002757,5949,5418,229,161,68,107,51,56,195
2021,North Lincolnshire 010,E02002758,6014,5480,199,146,53,155,63,92,180
2021,North Lincolnshire 011,E02002759,9203,8324,415,303,112,175,71,104,289
2021,North Lincolnshire 012,E02002760,5494,4942,284,196,88,104,42,62,164
2021,North Lincolnshire 013,E02002761,6186,5568,327,230,97,116,56,60,175
2021,North Lincolnshire 014,E02002762,6085,5509,238,168,70,146,61,85,192
2021,North Lincolnshire 015,E02002763,8191,7414,285,188,97,179,74,105,313
2021,North Lincolnshire 016,E02002764,5560,5050,151,99,52,133,69,64,226
2021,North Lincolnshire 017,E02002765,5803,5253,200,123,77,120,53,67,230
2021,North Lincolnshire 018,E02002766,8477,7677,366,255,111,173,85,88,261
2021,North Lincolnshire 019,E02002767,6364,5753,293,208,85,129,69,60,189
2021,North Lincolnshire 020,E02002768,7179,6432,381,283,98,132,64,68,234
2021,North Lincolnshire 021,E02002769,5412,4837,297,209,88,111,58,53,167
2021,North Lincolnshire 022,E02002770,6744,6054,316,227,89,136,64,72,238
2021,North Lincolnshire 023,E02002771,6835,6148,345,243,102,127,64,63,215
2021,York 001,E02002772,6632,6051,352,284,68,83,33,50,146
2021,York 002,E02002773,5452,4910,309,231,78,70,38,32,163
2021,York 003,E02002774,5845,5334,296,222,74,69,28,41,146
2021,York 004,E02002775,5508,4958,298,232,66,86,42,44,166
2021,York 005,E02002776,6371,5851,279,204,75,101,47,54,140
2021,York 006,E02002777,8470,7817,373,294,79,112,53,59,168
2021,York 007,E02002778,7578,6971,382,290,92,93,49,44,132
2021,York 008,E02002779,9170,8399,457,359,98,111,56,55,203
2021,York 009,E02002780,7692,7121,280,195,85,114,55,59,177
2021,York 010,E02002781,9686,9103,329,257,72,113,54,59,141
2021,York 011,E02002782,6193,5615,351,269,82,73,49,24,154
2021,York 012,E02002783,9768,8923,470,363,107,148,85,63,227
2021,York 013,E02002784,11027,10431,364,287,77,112,49,63,120
2021,York 014,E02002785,7734,7135,331,254,77,96,52,44,172
2021,York 015,E02002786,9785,9230,282,205,77,115,61,54,158
2021,York 016,E02002787,8433,7742,403,297,106,119,59,60,169
2021,York 017,E02002788,7893,7308,389,310,79,90,50,40,106
2021,York 018,E02002789,8654,7947,309,218,91,164,73,91,234
2021,York 019,E02002790,11398,10763,407,312,95,99,47,52,129
2021,York 020,E02002791,6361,5839,319,242,77,73,35,38,130
2021,York 021,E02002792,7420,6890,356,266,90,73,42,31,101
2021,York 022,E02002793,8825,7999,453,317,136,148,76,72,225
2021,York 023,E02002794,10320,9759,370,284,86,82,47,35,109
2021,York 024,E02002795,7992,7242,464,362,102,100,49,51,186
2021,Derby 001,E02002796,5910,5272,369,273,96,91,53,38,178
2021,Derby 002,E02002797,7090,6329,405,302,103,129,73,56,227
2021,Derby 003,E02002798,9879,9006,503,397,106,127,66,61,243
2021,Derby 004,E02002799,5942,5440,188,126,62,125,54,71,189
2021,Derby 005,E02002800,6710,6144,350,281,69,77,48,29,139
2021,Derby 006,E02002801,7095,6371,312,223,89,168,81,87,244
2021,Derby 007,E02002802,7458,6751,220,151,69,195,70,125,292
2021,Derby 008,E02002803,7975,7454,294,202,92,103,45,58,124
2021,Derby 009,E02002804,8531,7664,339,240,99,197,81,116,331
2021,Derby 010,E02002805,5381,4783,351,260,91,92,44,48,155
2021,Derby 011,E02002806,6098,5716,171,123,48,86,38,48,125
2021,Derby 012,E02002807,8528,7617,395,284,111,181,97,84,335
2021,Derby 013,E02002808,11582,10954,310,217,93,153,60,93,165
2021,Derby 014,E02002809,6679,6003,285,203,82,151,64,87,240
2021,Derby 015,E02002810,8633,7744,470,369,101,121,63,58,298
2021,Derby 016,E02002811,10097,9283,284,175,109,288,113,175,242
2021,Derby 017,E02002812,7436,6812,304,221,83,128,56,72,192
2021,Derby 018,E02002813,10609,9738,290,163,127,324,137,187,257
2021,Derby 019,E02002814,6895,6191,404,307,97,122,58,64,178
2021,Derby 020,E02002815,8154,7548,218,113,105,191,79,112,197
2021,Derby 021,E02002816,8896,8051,482,350,132,183,94,89,180
2021,Derby 022,E02002817,5954,5328,300,190,110,149,74,75,177
2021,Derby 023,E02002818,7935,7283,234,145,89,192,87,105,226
2021,Derby 024,E02002819,7136,6486,282,204,78,135,61,74,233
2021,Derby 025,E02002820,9158,8356,323,211,112,200,89,111,279
2021,Derby 026,E02002821,11548,10510,343,230,113,314,152,162,381
2021,Derby 027,E02002822,6489,5832,300,192,108,173,87,86,184
2021,Derby 028,E02002823,7271,6430,313,197,116,209,115,94,319
2021,Derby 029,E02002824,10069,9099,348,248,100,276,117,159,346
2021,Derby 030,E02002825,8290,7563,332,238,94,173,90,83,222
2021,Derby 031,E02002826,6721,6117,338,262,76,104,45,59,162
2021,Leicester 001,E02002827,6396,5841,239,167,72,142,63,79,174
2021,Leicester 002,E02002828,7818,7008,357,230,127,205,85,120,248
2021,Leicester 003,E02002829,10951,9967,342,232,110,272,121,151,370
2021,Leicester 004,E02002830,10169,9296,333,222,111,238,94,144,302
2021,Leicester 005,E02002831,6893,6263,262,146,116,190,91,99,178
2021,Leicester 006,E02002832,9781,8990,302,179,123,231,105,126,258
2021,Leicester 007,E02002833,8487,7816,244,144,100,202,93,109,225
2021,Leicester 008,E02002834,11191,10278,432,295,137,198,105,93,283
2021,Leicester 010,E02002836,10654,9909,241,135,106,239,113,126,265
2021,Leicester 011,E02002837,9289,8650,221,128,93,198,91,107,220
2021,Leicester 012,E02002838,8004,7342,198,129,69,183,71,112,281
2021,Leicester 013,E02002839,7967,7245,302,201,101,209,107,102,211
2021,Leicester 016,E02002842,8088,7641,190,132,58,125,58,67,132
2021,Leicester 017,E02002843,14716,13836,290,172,118,262,116,146,328
2021,Leicester 018,E02002844,11550,10781,241,120,121,236,97,139,292
2021,Leicester 019,E02002845,10419,9643,307,194,113,209,94,115,260
2021,Leicester 020,E02002846,7146,6537,324,239,85,129,60,69,156
2021,Leicester 021,E02002847,9997,9227,301,182,119,234,108,126,235
2021,Leicester 022,E02002848,10353,9607,284,170,114,212,113,99,250
2021,Leicester 023,E02002849,13116,12397,366,236,130,183,86,97,170
2021,Leicester 025,E02002851,8309,7509,357,252,105,205,108,97,238
2021,Leicester 026,E02002852,6926,6308,151,80,71,192,72,120,275
2021,Leicester 027,E02002853,12590,11661,412,281,131,246,122,124,271
2021,Leicester 028,E02002854,7940,7199,248,156,92,189,84,105,304
2021,Leicester 029,E02002855,7647,7137,228,158,70,133,71,62,149
2021,Leicester 030,E02002856,10879,10190,419,326,93,120,55,65,150
2021,Leicester 031,E02002857,6736,6251,239,166,73,122,55,67,124
2021,Leicester 032,E02002858,6990,6371,368,281,87,118,72,46,133
2021,Leicester 034,E02002860,7905,7218,338,238,100,152,71,81,197
2021,Leicester 035,E02002861,7705,6893,244,142,102,218,101,117,350
2021,Leicester 036,E02002862,8069,7341,280,190,90,184,77,107,264
2021,Rutland 001,E02002863,8558,7971,326,252,74,92,41,51,169
2021,Rutland 002,E02002864,7861,7202,343,270,73,117,58,59,199
2021,Rutland 003,E02002865,7601,6955,386,288,98,84,38,46,176
2021,Rutland 004,E02002866,7201,6598,360,284,76,88,44,44,155
2021,Rutland 005,E02002867,8187,7508,404,326,78,97,46,51,178
2021,Nottingham 001,E02002868,5674,5014,283,191,92,121,58,63,256
2021,Nottingham 002,E02002869,6978,6249,267,195,72,204,93,111,258
2021,Nottingham 004,E02002871,7489,6729,332,238,94,171,62,109,257
2021,Nottingham 005,E02002872,8136,7326,328,205,123,211,80,131,271
2021,Nottingham 006,E02002873,8756,7998,280,196,84,219,110,109,259
2021,Nottingham 007,E02002874,7653,6942,333,250,83,149,58,91,229
2021,Nottingham 008,E02002875,7896,7151,332,218,114,197,79,118,216
2021,Nottingham 009,E02002876,7537,6780,321,227,94,186,93,93,250
2021,Nottingham 010,E02002877,7352,6686,392,312,80,123,62,61,151
2021,Nottingham 011,E02002878,8577,7802,242,141,101,218,84,134,315
2021,Nottingham 012,E02002879,9263,8466,408,268,140,167,88,79,222
2021,Nottingham 013,E02002880,8118,7373,248,140,108,224,98,126,273
2021,Nottingham 014,E02002881,6379,5781,222,132,90,187,92,95,189
2021,Nottingham 015,E02002882,8378,7766,370,284,86,122,48,74,120
2021,Nottingham 016,E02002883,7172,6529,286,198,88,169,87,82,188
2021,Nottingham 017,E02002884,6845,6297,226,152,74,179,85,94,143
2021,Nottingham 018,E02002885,7976,7483,182,114,68,165,74,91,146
2021,Nottingham 019,E02002886,9478,8629,368,263,105,231,93,138,250
2021,Nottingham 020,E02002887,6329,5556,256,167,89,206,106,100,311
2021,Nottingham 021,E02002888,7087,6505,239,160,79,147,67,80,196
2021,Nottingham 022,E02002889,11158,10817,205,161,44,65,32,33,71
2021,Nottingham 023,E02002890,11193,10672,210,150,60,157,70,87,154
2021,Nottingham 024,E02002891,7978,7162,344,209,135,230,112,118,242
2021,Nottingham 025,E02002892,5836,5195,211,136,75,176,75,101,254
2021,Nottingham 026,E02002893,13278,12704,267,185,82,149,63,86,158
2021,Nottingham 028,E02002895,9456,9088,234,186,48,67,35,32,67
2021,Nottingham 029,E02002896,9418,8769,252,166,86,214,82,132,183
2021,Nottingham 030,E02002897,7523,6764,420,308,112,135,62,73,204
2021,Nottingham 031,E02002898,10738,10347,221,160,61,77,37,40,93
2021,Nottingham 034,E02002901,5845,5335,267,198,69,92,41,51,151
2021,Nottingham 035,E02002902,8922,8102,340,236,104,190,73,117,290
2021,Nottingham 036,E02002903,5583,5002,231,150,81,128,56,72,222
2021,Nottingham 037,E02002904,6007,5431,218,154,64,133,57,76,225
2021,Herefordshire 001,E02002905,6060,5442,379,289,90,92,52,40,147
2021,Herefordshire 002,E02002906,5317,4778,237,151,86,120,55,65,182
2021,Herefordshire 003,E02002907,5961,5393,276,199,77,123,54,69,169
2021,Herefordshire 004,E02002908,8502,7699,460,345,115,119,69,50,224
2021,Herefordshire 005,E02002909,10290,9323,485,350,135,191,93,98,291
2021,Herefordshire 006,E02002910,7542,6856,376,276,100,105,48,57,205
2021,Herefordshire 007,E02002911,9130,8284,463,342,121,144,68,76,239
2021,Herefordshire 008,E02002912,7239,6600,354,266,88,103,45,58,182
2021,Herefordshire 009,E02002913,5625,5011,366,270,96,90,46,44,158
2021,Herefordshire 010,E02002914,8546,7847,337,241,96,125,62,63,237
2021,Herefordshire 011,E02002915,7565,6943,343,267,76,118,58,60,161
2021,Herefordshire 012,E02002916,9278,8509,380,277,103,156,63,93,233
2021,Herefordshire 013,E02002917,6545,6007,296,222,74,97,35,62,145
2021,Herefordshire 014,E02002918,5545,5007,304,242,62,79,47,32,155
2021,Herefordshire 015,E02002919,8485,7753,332,230,102,166,70,96,234
2021,Herefordshire 016,E02002920,6199,5605,303,232,71,117,69,48,174
2021,Herefordshire 017,E02002921,7282,6635,237,152,85,149,65,84,261
2021,Herefordshire 018,E02002922,6347,5654,372,287,85,109,57,52,212
2021,Herefordshire 019,E02002923,9082,8296,429,310,119,114,54,60,243
2021,Herefordshire 020,E02002924,5826,5206,351,260,91,120,76,44,149
2021,Herefordshire 021,E02002925,10343,9366,534,393,141,172,88,84,271
2021,Herefordshire 022,E02002926,10513,9546,529,388,141,162,89,73,276
2021,Herefordshire 023,E02002927,11377,10269,668,518,150,178,85,93,262
2021,Telford and Wrekin 001,E02002928,5831,5253,305,228,77,106,66,40,167
2021,Telford and Wrekin 002,E02002929,6438,5823,350,295,55,110,56,54,155
2021,Telford and Wrekin 003,E02002930,6660,6060,295,231,64,118,70,48,187
2021,Telford and Wrekin 004,E02002931,6322,5677,354,276,78,113,54,59,178
2021,Telford and Wrekin 005,E02002932,8417,7541,345,217,128,208,87,121,323
2021,Telford and Wrekin 006,E02002933,7652,6826,414,313,101,169,87,82,243
2021,Telford and Wrekin 007,E02002934,5869,5264,284,208,76,137,77,60,184
2021,Telford and Wrekin 008,E02002935,6373,5627,316,223,93,175,83,92,255
2021,Telford and Wrekin 009,E02002936,10332,9414,394,279,115,214,77,137,310
2021,Telford and Wrekin 010,E02002937,10301,9145,631,493,138,201,102,99,324
2021,Telford and Wrekin 011,E02002938,6866,6173,278,198,80,191,81,110,224
2021,Telford and Wrekin 012,E02002939,7168,6455,355,265,90,141,67,74,217
2021,Telford and Wrekin 013,E02002940,5571,4961,284,208,76,124,64,60,202
2021,Telford and Wrekin 014,E02002941,9904,8761,473,325,148,256,104,152,414
2021,Telford and Wrekin 015,E02002942,7579,6892,376,274,102,116,56,60,195
2021,Telford and Wrekin 017,E02002944,7791,6944,301,210,91,200,88,112,346
2021,Telford and Wrekin 018,E02002945,8950,8031,398,266,132,200,89,111,321
2021,Telford and Wrekin 019,E02002946,7163,6355,341,240,101,188,93,95,279
2021,Telford and Wrekin 020,E02002947,6629,5913,286,189,97,176,60,116,254
2021,Telford and Wrekin 021,E02002948,7003,6210,261,174,87,204,69,135,328
2021,Telford and Wrekin 022,E02002949,5113,4493,295,206,89,135,61,74,190
2021,Telford and Wrekin 023,E02002950,5488,4870,205,139,66,163,72,91,250
2021,Stoke-on-Trent 001,E02002951,7462,6683,345,240,105,161,70,91,273
2021,Stoke-on-Trent 002,E02002952,7052,6433,253,164,89,155,54,101,211
2021,Stoke-on-Trent 003,E02002953,6933,6126,265,180,85,206,92,114,336
2021,Stoke-on-Trent 004,E02002954,7790,6964,326,225,101,205,92,113,295
2021,Stoke-on-Trent 005,E02002955,6826,6315,198,133,65,151,69,82,162
2021,Stoke-on-Trent 006,E02002956,8700,7796,364,224,140,205,89,116,335
2021,Stoke-on-Trent 007,E02002957,9119,8113,548,396,152,176,92,84,282
2021,Stoke-on-Trent 008,E02002958,7988,7204,350,243,107,187,86,101,247
2021,Stoke-on-Trent 009,E02002959,8387,7692,280,176,104,195,81,114,220
2021,Stoke-on-Trent 010,E02002960,5467,4878,279,184,95,128,67,61,182
2021,Stoke-on-Trent 011,E02002961,6755,6182,226,146,80,155,62,93,192
2021,Stoke-on-Trent 012,E02002962,7325,6561,287,173,114,185,89,96,292
2021,Stoke-on-Trent 013,E02002963,6671,6065,248,165,83,150,72,78,208
2021,Stoke-on-Trent 014,E02002964,8191,7277,340,225,115,226,92,134,348
2021,Stoke-on-Trent 015,E02002965,7735,7247,195,127,68,134,60,74,159
2021,Stoke-on-Trent 016,E02002966,9631,9003,280,191,89,148,62,86,200
2021,Stoke-on-Trent 017,E02002967,9673,8746,281,186,95,244,81,163,402
2021,Stoke-on-Trent 018,E02002968,8954,8152,412,325,87,176,81,95,214
2021,Stoke-on-Trent 019,E02002969,8870,8131,383,270,113,157,68,89,199
2021,Stoke-on-Trent 020,E02002970,7398,6681,306,201,105,177,71,106,234
2021,Stoke-on-Trent 023,E02002973,7666,6902,327,224,103,182,82,100,255
2021,Stoke-on-Trent 024,E02002974,5823,5171,286,191,95,140,76,64,226
2021,Stoke-on-Trent 025,E02002975,6790,6108,340,219,121,129,51,78,213
2021,Stoke-on-Trent 026,E02002976,5659,5007,296,194,102,136,66,70,220
2021,Stoke-on-Trent 027,E02002977,5350,4751,257,196,61,124,48,76,218
2021,Stoke-on-Trent 028,E02002978,6308,5662,220,136,84,175,92,83,251
2021,Stoke-on-Trent 029,E02002979,5582,5119,199,128,71,113,49,64,151
2021,Stoke-on-Trent 030,E02002980,5762,5134,309,217,92,123,69,54,196
2021,Stoke-on-Trent 031,E02002981,8041,7228,329,215,114,219,87,132,265
2021,Stoke-on-Trent 032,E02002982,8134,7318,289,191,98,214,90,124,313
2021,Stoke-on-Trent 033,E02002983,5079,4487,306,228,78,99,43,56,187
2021,Stoke-on-Trent 034,E02002984,5256,4774,273,196,77,66,27,39,143
2021,Bath and North East Somerset 001,E02002985,6369,5814,266,203,63,113,58,55,176
2021,Bath and North East Somerset 002,E02002986,6514,5927,298,222,76,103,50,53,186
2021,Bath and North East Somerset 003,E02002987,5503,5001,312,230,82,89,57,32,101
2021,Bath and North East Somerset 004,E02002988,5317,4895,262,205,57,75,37,38,85
2021,Bath and North East Somerset 005,E02002989,5288,4802,279,211,68,82,44,38,125
2021,Bath and North East Somerset 006,E02002990,5596,5198,252,173,79,62,34,28,84
2021,Bath and North East Somerset 007,E02002991,10698,10039,439,350,89,95,50,45,125
2021,Bath and North East Somerset 008,E02002992,5496,5060,269,228,41,68,29,39,99
2021,Bath and North East Somerset 009,E02002993,5853,5563,169,147,22,61,30,31,60
2021,Bath and North East Somerset 010,E02002994,10152,9301,554,446,108,122,65,57,175
2021,Bath and North East Somerset 011,E02002995,5401,4941,187,122,65,108,41,67,165
2021,Bath and North East Somerset 012,E02002996,11494,10870,442,348,94,73,41,32,109
2021,Bath and North East Somerset 013,E02002997,8064,7667,247,197,50,67,33,34,83
2021,Bath and North East Somerset 014,E02002998,5747,5338,232,173,59,60,28,32,117
2021,Bath and North East Somerset 015,E02002999,5356,4831,260,195,65,118,59,59,147
2021,Bath and North East Somerset 016,E02003000,9194,8310,516,376,140,140,63,77,228
2021,Bath and North East Somerset 017,E02003001,5342,4958,243,186,57,56,32,24,85
2021,Bath and North East Somerset 018,E02003002,5935,5418,267,221,46,104,51,53,146
2021,Bath and North East Somerset 019,E02003003,5576,5011,332,244,88,88,45,43,145
2021,Bath and North East Somerset 020,E02003004,6979,6338,369,270,99,94,44,50,178
2021,Bath and North East Somerset 021,E02003005,6439,5875,357,278,79,73,42,31,134
2021,Bath and North East Somerset 022,E02003006,9585,8793,433,315,118,133,74,59,226
2021,Bath and North East Somerset 023,E02003007,9013,8197,458,345,113,152,74,78,206
2021,Bath and North East Somerset 024,E02003008,5732,5172,288,187,101,112,58,54,160
2021,Bath and North East Somerset 025,E02003009,5885,5351,300,226,74,87,40,47,147
2021,Bath and North East Somerset 026,E02003010,6188,5620,283,204,79,115,59,56,170
2021,Bath and North East Somerset 027,E02003011,5671,5128,261,189,72,97,43,54,185
2021,Bristol 001,E02003012,11292,10253,439,304,135,234,102,132,366
2021,Bristol 002,E02003013,12013,10919,444,294,150,305,139,166,345
2021,Bristol 003,E02003014,7807,7036,302,188,114,198,81,117,271
2021,Bristol 004,E02003015,6431,5930,258,192,66,104,53,51,139
2021,Bristol 005,E02003016,7641,7026,276,197,79,144,75,69,195
2021,Bristol 006,E02003017,5980,5434,312,250,62,103,50,53,131
2021,Bristol 007,E02003018,5828,5245,279,207,72,113,58,55,191
2021,Bristol 008,E02003019,9645,8777,412,289,123,184,83,101,272
2021,Bristol 009,E02003020,6179,5749,294,243,51,49,27,22,87
2021,Bristol 010,E02003021,7045,6633,234,185,49,81,31,50,97
2021,Bristol 011,E02003022,5873,5332,365,298,67,60,38,22,116
2021,Bristol 012,E02003023,6371,5779,322,236,86,126,67,59,144
2021,Bristol 013,E02003024,9457,8708,366,272,94,164,80,84,219
2021,Bristol 014,E02003025,7293,6652,286,211,75,154,60,94,201
2021,Bristol 015,E02003026,9919,9226,434,354,80,98,60,38,161
2021,Bristol 016,E02003027,12429,11726,499,407,92,94,47,47,110
2021,Bristol 017,E02003028,8420,7872,391,328,63,70,32,38,87
2021,Bristol 018,E02003029,6284,5690,239,161,78,129,65,64,226
2021,Bristol 019,E02003030,7466,6902,310,244,66,135,55,80,119
2021,Bristol 020,E02003031,10096,9476,456,369,87,88,52,36,76
2021,Bristol 021,E02003032,7888,7272,300,218,82,147,65,82,169
2021,Bristol 022,E02003033,8583,8214,273,228,45,50,20,30,46
2021,Bristol 025,E02003036,8429,8064,242,195,47,62,32,30,61
2021,Bristol 026,E02003037,8923,8578,270,225,45,37,22,15,38
2021,Bristol 027,E02003038,6457,5904,282,217,65,117,59,58,154
2021,Bristol 028,E02003039,8302,7586,355,252,103,148,74,74,213
2021,Bristol 029,E02003040,9255,8680,333,264,69,129,56,73,113
2021,Bristol 030,E02003041,6054,5749,225,181,44,37,15,22,43
2021,Bristol 033,E02003044,5799,5272,295,233,62,98,49,49,134
2021,Bristol 034,E02003045,6770,6433,243,200,43,47,18,29,47
2021,Bristol 035,E02003046,9333,8571,370,254,116,142,69,73,250
2021,Bristol 036,E02003047,10531,9871,392,304,88,103,53,50,165
2021,Bristol 037,E02003048,6455,6024,266,204,62,87,40,47,78
2021,Bristol 038,E02003049,7388,6747,326,231,95,115,56,59,200
2021,Bristol 039,E02003050,9678,9067,292,221,71,143,61,82,176
2021,Bristol 040,E02003051,7043,6551,243,184,59,109,55,54,140
2021,Bristol 041,E02003052,6778,6258,253,180,73,96,43,53,171
2021,Bristol 042,E02003053,8119,7421,400,296,104,127,59,68,171
2021,Bristol 043,E02003054,6483,5894,336,246,90,105,52,53,148
2021,Bristol 044,E02003055,8583,7736,346,228,118,206,86,120,295
2021,Bristol 045,E02003056,7204,6400,295,178,117,204,75,129,305
2021,Bristol 046,E02003057,5850,5269,309,223,86,106,60,46,166
2021,Bristol 047,E02003058,9254,8318,409,306,103,192,83,109,335
2021,Bristol 048,E02003059,6302,5734,275,197,78,116,45,71,177
2021,Bristol 049,E02003060,10493,9429,528,381,147,216,103,113,320
2021,Bristol 050,E02003061,5820,5241,236,167,69,139,54,85,204
2021,Bristol 051,E02003062,5552,4929,226,143,83,174,69,105,223
2021,Bristol 052,E02003063,6885,6205,342,256,86,113,50,63,225
2021,Bristol 053,E02003064,6734,6029,237,155,82,202,69,133,266
2021,North Somerset 001,E02003065,9324,8565,451,353,98,110,59,51,198
2021,North Somerset 002,E02003066,5885,5352,348,267,81,64,36,28,121
2021,North Somerset 003,E02003067,7748,7149,351,271,80,92,43,49,156
2021,North Somerset 004,E02003068,6080,5548,315,258,57,73,32,41,144
2021,North Somerset 005,E02003069,5462,4962,321,267,54,64,37,27,115
2021,North Somerset 006,E02003070,12633,11573,644,500,144,158,83,75,258
2021,North Somerset 007,E02003071,7671,6940,399,317,82,119,62,57,213
2021,North Somerset 008,E02003072,8869,8012,508,377,131,117,54,63,232
2021,North Somerset 009,E02003073,6054,5519,337,274,63,71,37,34,127
2021,North Somerset 010,E02003074,7302,6677,353,270,83,103,50,53,169
2021,North Somerset 011,E02003075,5919,5394,316,240,76,75,40,35,134
2021,North Somerset 012,E02003076,9409,8550,515,401,114,128,65,63,216
2021,North Somerset 013,E02003077,6065,5560,296,229,67,73,35,38,136
2021,North Somerset 014,E02003078,7067,6378,361,268,93,131,68,63,197
2021,North Somerset 015,E02003079,8813,8011,433,328,105,151,75,76,218
2021,North Somerset 016,E02003080,8329,7435,410,285,125,171,89,82,313
2021,North Somerset 017,E02003081,9020,7997,565,427,138,163,95,68,295
2021,North Somerset 018,E02003082,8725,8011,379,285,94,149,70,79,186
2021,North Somerset 020,E02003084,10060,9199,393,280,113,180,72,108,288
2021,North Somerset 021,E02003085,7262,6464,286,184,102,233,97,136,279
2021,North Somerset 022,E02003086,5898,5304,298,219,79,132,73,59,164
2021,North Somerset 023,E02003087,10308,9239,543,409,134,199,100,99,327
2021,North Somerset 024,E02003088,8655,7813,493,386,107,125,67,58,224
2021,North Somerset 025,E02003089,5657,5064,272,188,84,112,50,62,209
2021,South Gloucestershire 001,E02003090,8823,8056,424,332,92,124,67,57,219
2021,South Gloucestershire 002,E02003091,6404,5738,415,310,105,113,48,65,138
2021,South Gloucestershire 003,E02003092,8367,7618,441,336,105,129,53,76,179
2021,South Gloucestershire 004,E02003093,6406,5769,394,294,100,81,42,39,162
2021,South Gloucestershire 005,E02003094,8423,7629,453,344,109,124,58,66,217
2021,South Gloucestershire 006,E02003095,8123,7446,391,300,91,106,61,45,180
2021,South Gloucestershire 007,E02003096,5943,5401,273,194,79,106,47,59,163
2021,South Gloucestershire 008,E02003097,6216,5610,328,228,100,102,46,56,176
2021,South Gloucestershire 009,E02003098,9443,8775,421,316,105,102,47,55,145
2021,South Gloucestershire 010,E02003099,7209,6576,305,228,77,121,68,53,207
2021,South Gloucestershire 012,E02003101,10081,9396,394,299,95,117,56,61,174
2021,South Gloucestershire 013,E02003102,6797,6191,330,244,86,83,46,37,193
2021,South Gloucestershire 014,E02003103,6698,6111,321,227,94,105,49,56,161
2021,South Gloucestershire 015,E02003104,7151,6521,334,256,78,109,51,58,187
2021,South Gloucestershire 016,E02003105,6122,5581,305,227,78,92,49,43,144
2021,South Gloucestershire 018,E02003107,10733,9951,403,298,105,179,86,93,200
2021,South Gloucestershire 019,E02003108,11867,10825,546,416,130,190,100,90,306
2021,South Gloucestershire 020,E02003109,5857,5314,318,247,71,94,54,40,131
2021,South Gloucestershire 021,E02003110,11580,10742,486,363,123,158,79,79,194
2021,South Gloucestershire 022,E02003111,6359,5843,297,222,75,78,40,38,141
2021,South Gloucestershire 023,E02003112,6159,5546,295,198,97,133,71,62,185
2021,South Gloucestershire 024,E02003113,10006,9064,574,438,136,138,73,65,230
2021,South Gloucestershire 025,E02003114,6793,6212,298,225,73,105,57,48,178
2021,South Gloucestershire 026,E02003115,9155,8355,423,306,117,167,95,72,210
2021,South Gloucestershire 027,E02003116,7316,6627,293,215,78,171,70,101,225
2021,South Gloucestershire 028,E02003117,8833,8038,396,286,110,143,59,84,256
2021,South Gloucestershire 029,E02003118,9402,8552,482,352,130,137,71,66,231
2021,South Gloucestershire 030,E02003119,9798,8838,512,366,146,195,94,101,253
2021,South Gloucestershire 031,E02003120,8730,7885,465,340,125,139,74,65,241
2021,South Gloucestershire 032,E02003121,9670,8682,584,453,131,160,90,70,244
2021,Plymouth 001,E02003122,6989,6221,357,264,93,149,69,80,262
2021,Plymouth 002,E02003123,8169,7313,301,215,86,202,97,105,353
2021,Plymouth 003,E02003124,7749,6860,365,248,117,193,80,113,331
2021,Plymouth 004,E02003125,5717,5048,251,179,72,168,77,91,250
2021,Plymouth 005,E02003126,8037,7241,339,240,99,152,64,88,305
2021,Plymouth 006,E02003127,7130,6262,284,189,95,220,99,121,364
2021,Plymouth 007,E02003128,8619,7710,358,250,108,218,96,122,333
2021,Plymouth 008,E02003129,6076,5448,342,257,85,99,48,51,187
2021,Plymouth 009,E02003130,9978,8900,392,245,147,279,133,146,407
2021,Plymouth 010,E02003131,6934,6205,302,216,86,187,77,110,240
2021,Plymouth 011,E02003132,8352,7485,376,261,115,189,88,101,302
2021,Plymouth 012,E02003133,6799,6077,320,224,96,144,58,86,258
2021,Plymouth 013,E02003134,6503,5812,256,164,92,178,78,100,257
2021,Plymouth 014,E02003135,6609,5963,217,160,57,180,83,97,249
2021,Plymouth 015,E02003136,7480,6760,355,259,96,124,60,64,241
2021,Plymouth 016,E02003137,7534,6845,375,294,81,97,52,45,217
2021,Plymouth 017,E02003138,7130,6526,353,265,88,103,51,52,148
2021,Plymouth 018,E02003139,6310,5778,296,223,73,105,60,45,131
2021,Plymouth 019,E02003140,7448,6720,385,284,101,140,61,79,203
2021,Plymouth 020,E02003141,7537,6800,350,253,97,168,80,88,219
2021,Plymouth 021,E02003142,8706,7723,377,275,102,229,112,117,377
2021,Plymouth 022,E02003143,6956,6297,309,237,72,155,74,81,195
2021,Plymouth 023,E02003144,8290,7877,231,175,56,77,30,47,105
2021,Plymouth 024,E02003145,6384,5822,288,212,76,113,56,57,161
2021,Plymouth 025,E02003146,8178,7652,247,184,63,124,44,80,155
2021,Plymouth 026,E02003147,8528,7760,248,168,80,240,92,148,280
2021,Plymouth 027,E02003148,10989,10406,282,206,76,141,70,71,160
2021,Plymouth 028,E02003149,8895,8240,289,207,82,157,69,88,209
2021,Plymouth 030,E02003151,8052,7175,429,307,122,151,74,77,297
2021,Plymouth 031,E02003152,10747,9672,542,390,152,209,105,104,324
2021,Plymouth 032,E02003153,7076,6326,397,291,106,135,69,66,218
2021,Torbay 001,E02003154,6900,6054,325,204,121,199,76,123,322
2021,Torbay 002,E02003155,5659,5023,295,204,91,126,61,65,215
2021,Torbay 003,E02003156,10028,8896,507,346,161,252,121,131,373
2021,Torbay 004,E02003157,6453,5722,267,165,102,185,90,95,279
2021,Torbay 005,E02003158,5529,4907,281,179,102,135,73,62,206
2021,Torbay 006,E02003159,5666,5131,254,179,75,123,58,65,158
2021,Torbay 008,E02003161,7405,6741,235,145,90,190,86,104,239
2021,Torbay 010,E02003163,7948,7153,374,267,107,143,77,66,278
2021,Torbay 011,E02003164,8680,7685,456,309,147,196,100,96,343
2021,Torbay 012,E02003165,6962,6162,369,257,112,161,75,86,270
2021,Torbay 013,E02003166,12161,10661,610,417,193,325,155,170,565
2021,Torbay 014,E02003167,9493,8463,451,309,142,234,108,126,345
2021,Torbay 015,E02003168,6869,6110,353,242,111,156,87,69,250
2021,Torbay 016,E02003169,6450,5658,358,267,91,149,86,63,285
2021,Torbay 017,E02003170,9172,8104,461,341,120,224,114,110,383
2021,Torbay 018,E02003171,7096,6248,365,249,116,170,74,96,313
2021,"Bournemouth, Christchurch and Poole 003",E02003172,6167,5486,302,206,96,157,71,86,222
2021,"Bournemouth, Christchurch and Poole 005",E02003173,6520,5785,330,243,87,147,66,81,258
2021,"Bournemouth, Christchurch and Poole 006",E02003174,7919,7116,398,296,102,142,76,66,263
2021,"Bournemouth, Christchurch and Poole 007",E02003175,8882,8077,423,305,118,159,68,91,223
2021,"Bournemouth, Christchurch and Poole 010",E02003176,7034,6180,339,222,117,206,101,105,309
2021,"Bournemouth, Christchurch and Poole 009",E02003177,7964,7270,388,285,103,111,52,59,195
2021,"Bournemouth, Christchurch and Poole 011",E02003178,8320,7548,361,277,84,169,78,91,242
2021,"Bournemouth, Christchurch and Poole 012",E02003179,6165,5524,256,180,76,142,66,76,243
2021,"Bournemouth, Christchurch and Poole 015",E02003180,9623,8996,317,225,92,130,61,69,180
2021,"Bournemouth, Christchurch and Poole 017",E02003181,8412,7786,373,286,87,105,56,49,148
2021,"Bournemouth, Christchurch and Poole 020",E02003182,6268,5732,303,225,78,104,46,58,129
2021,"Bournemouth, Christchurch and Poole 028",E02003183,7103,6544,367,274,93,80,36,44,112
2021,"Bournemouth, Christchurch and Poole 027",E02003184,7657,7192,244,193,51,112,57,55,109
2021,"Bournemouth, Christchurch and Poole 026",E02003185,7190,6477,403,295,108,129,63,66,181
2021,"Bournemouth, Christchurch and Poole 025",E02003186,8863,8166,322,244,78,165,64,101,210
2021,"Bournemouth, Christchurch and Poole 035",E02003187,8986,8193,409,308,101,175,81,94,209
2021,"Bournemouth, Christchurch and Poole 038",E02003188,12766,12191,311,233,78,116,44,72,148
2021,"Bournemouth, Christchurch and Poole 036",E02003189,8186,7522,390,286,104,103,59,44,171
2021,"Bournemouth, Christchurch and Poole 037",E02003190,9829,9152,313,218,95,180,77,103,184
2021,"Bournemouth, Christchurch and Poole 039",E02003191,8054,7330,410,301,109,127,61,66,187
2021,"Bournemouth, Christchurch and Poole 041",E02003192,12703,12009,355,259,96,155,78,77,184
2021,"Bournemouth, Christchurch and Poole 001",E02003194,6112,5528,345,280,65,93,47,46,146
2021,"Bournemouth, Christchurch and Poole 008",E02003195,5603,5012,280,201,79,120,57,63,191
2021,"Bournemouth, Christchurch and Poole 004",E02003196,9998,9038,613,475,138,115,61,54,232
2021,"Bournemouth, Christchurch and Poole 013",E02003197,6478,5854,319,237,82,118,57,61,187
2021,"Bournemouth, Christchurch and Poole 016",E02003198,7121,6486,326,232,94,142,61,81,167
2021,"Bournemouth, Christchurch and Poole 021",E02003199,8968,8108,436,325,111,156,77,79,268
2021,"Bournemouth, Christchurch and Poole 022",E02003200,9801,8736,464,330,134,236,94,142,365
2021,"Bournemouth, Christchurch and Poole 023",E02003201,10467,9493,476,342,134,201,94,107,297
2021,"Bournemouth, Christchurch and Poole 029",E02003202,5828,5359,262,193,69,87,39,48,120
2021,"Bournemouth, Christchurch and Poole 032",E02003203,7165,6545,318,234,84,123,61,62,179
2021,"Bournemouth, Christchurch and Poole 030",E02003204,8843,7995,417,311,106,175,95,80,256
2021,"Bournemouth, Christchurch and Poole 034",E02003205,8049,7320,394,296,98,130,58,72,205
2021,"Bournemouth, Christchurch and Poole 043",E02003206,9568,8816,462,372,90,131,69,62,159
2021,"Bournemouth, Christchurch and Poole 042",E02003207,6956,6324,303,205,98,129,59,70,200
2021,"Bournemouth, Christchurch and Poole 044",E02003208,10769,9800,483,354,129,197,82,115,289
2021,"Bournemouth, Christchurch and Poole 046",E02003209,6422,5778,337,229,108,128,64,64,179
2021,"Bournemouth, Christchurch and Poole 047",E02003210,9363,8592,489,377,112,94,43,51,188
2021,"Bournemouth, Christchurch and Poole 048",E02003211,8284,7580,413,308,105,90,48,42,201
2021,Swindon 001,E02003212,8054,7344,407,301,106,112,55,57,191
2021,Swindon 003,E02003214,6223,5592,220,141,79,160,66,94,251
2021,Swindon 004,E02003215,6453,5813,334,240,94,126,63,63,180
2021,Swindon 005,E02003216,9435,8482,445,316,129,177,82,95,331
2021,Swindon 006,E02003217,6950,6292,289,189,100,139,60,79,230
2021,Swindon 007,E02003218,6201,5533,257,179,78,153,70,83,258
2021,Swindon 008,E02003219,12029,11109,516,406,110,170,80,90,234
2021,Swindon 009,E02003220,9787,8902,451,340,111,167,89,78,267
2021,Swindon 010,E02003221,6858,6363,217,142,75,139,74,65,139
2021,Swindon 011,E02003222,5677,5205,266,196,70,82,42,40,124
2021,Swindon 012,E02003223,10232,9501,366,264,102,161,65,96,204
2021,Swindon 013,E02003224,8168,7377,438,329,109,142,71,71,211
2021,Swindon 014,E02003225,6082,5601,274,213,61,75,26,49,132
2021,Swindon 015,E02003226,9973,9539,174,125,49,148,55,93,112
2021,Swindon 016,E02003227,6539,5897,220,127,93,172,69,103,250
2021,Swindon 017,E02003228,7323,6749,285,211,74,125,59,66,164
2021,Swindon 018,E02003229,5346,4875,246,175,71,96,53,43,129
2021,Swindon 019,E02003230,8235,7807,236,179,57,98,35,63,94
2021,Swindon 020,E02003231,7986,7188,278,187,91,209,98,111,311
2021,Swindon 021,E02003232,8157,7513,382,296,86,131,71,60,131
2021,Swindon 022,E02003233,8233,7434,348,262,86,186,94,92,265
2021,Swindon 023,E02003234,7974,7198,373,272,101,158,74,84,245
2021,Swindon 024,E02003235,8829,8116,430,318,112,119,57,62,164
2021,Swindon 025,E02003236,12117,10940,601,437,164,205,89,116,371
2021,Peterborough 001,E02003237,5955,5361,358,269,89,94,43,51,142
2021,Peterborough 002,E02003238,5467,4946,275,200,75,90,43,47,156
2021,Peterborough 003,E02003239,7914,7176,412,321,91,129,67,62,197
2021,Peterborough 004,E02003240,6526,5997,299,233,66,91,50,41,139
2021,Peterborough 005,E02003241,6789,6086,379,295,84,130,54,76,194
2021,Peterborough 006,E02003242,8011,7272,321,245,76,183,76,107,235
2021,Peterborough 007,E02003243,11132,10212,345,218,127,235,97,138,340
2021,Peterborough 008,E02003244,9286,8560,239,147,92,192,78,114,295
2021,Peterborough 009,E02003245,7656,7034,215,140,75,177,69,108,230
2021,Peterborough 010,E02003246,9325,8693,219,140,79,192,90,102,221
2021,Peterborough 011,E02003247,8318,7616,268,189,79,174,71,103,260
2021,Peterborough 012,E02003248,10760,9947,338,215,123,258,103,155,217
2021,Peterborough 013,E02003249,11862,10940,345,220,125,248,96,152,329
2021,Peterborough 014,E02003250,11197,10483,293,206,87,214,99,115,207
2021,Peterborough 015,E02003251,7557,6816,383,279,104,146,67,79,212
2021,Peterborough 016,E02003252,11607,10860,339,236,103,189,77,112,219
2021,Peterborough 017,E02003253,9616,8879,316,209,107,183,93,90,238
2021,Peterborough 018,E02003254,8788,7958,452,354,98,147,74,73,231
2021,Peterborough 019,E02003255,12706,11684,479,340,139,220,102,118,323
2021,Peterborough 021,E02003257,8982,8172,304,213,91,198,95,103,308
2021,Luton 001,E02003258,8159,7474,361,251,110,157,74,83,167
2021,Luton 002,E02003259,6320,5809,256,196,60,101,47,54,154
2021,Luton 003,E02003260,8202,7511,265,176,89,193,84,109,233
2021,Luton 004,E02003261,6107,5495,277,203,74,135,73,62,200
2021,Luton 005,E02003262,10447,9518,424,277,147,219,95,124,286
2021,Luton 006,E02003263,12022,11022,470,335,135,237,109,128,293
2021,Luton 007,E02003264,9254,8461,417,308,109,174,100,74,202
2021,Luton 008,E02003265,7773,7075,379,272,107,142,65,77,177
2021,Luton 009,E02003266,9449,8691,292,189,103,206,104,102,260
2021,Luton 010,E02003267,13482,12482,396,250,146,257,132,125,347
2021,Luton 011,E02003268,11902,11110,330,206,124,224,89,135,238
2021,Luton 012,E02003269,10048,9210,437,305,132,172,72,100,229
2021,Luton 013,E02003270,8246,7542,287,189,98,188,82,106,229
2021,Luton 014,E02003271,9595,8774,439,312,127,177,91,86,205
2021,Luton 015,E02003272,10398,9591,278,157,121,244,116,128,285
2021,Luton 016,E02003273,11256,10315,395,251,144,235,109,126,311
2021,Luton 017,E02003274,10562,9923,239,127,112,213,105,108,187
2021,Luton 019,E02003276,8368,7858,220,126,94,122,61,61,168
2021,Luton 020,E02003277,10829,9926,319,205,114,274,137,137,310
2021,Luton 021,E02003278,12302,11587,331,212,119,194,81,113,190
2021,Southend-on-Sea 001,E02003279,9002,8202,407,294,113,133,70,63,260
2021,Southend-on-Sea 002,E02003280,9975,9041,430,297,133,189,90,99,315
2021,Southend-on-Sea 003,E02003281,9044,8147,459,339,120,154,80,74,284
2021,Southend-on-Sea 004,E02003282,10092,9182,411,317,94,188,88,100,311
2021,Southend-on-Sea 005,E02003283,10362,9271,529,373,156,208,93,115,354
2021,Southend-on-Sea 006,E02003284,10506,9500,491,339,152,211,95,116,304
2021,Southend-on-Sea 007,E02003285,10489,9669,387,275,112,186,75,111,247
2021,Southend-on-Sea 008,E02003286,8825,8155,423,322,101,98,54,44,149
2021,Southend-on-Sea 009,E02003287,9625,8663,436,313,123,194,94,100,332
2021,Southend-on-Sea 010,E02003288,12076,11169,358,237,121,262,99,163,287
2021,Southend-on-Sea 011,E02003289,9365,8653,442,338,104,101,48,53,169
2021,Southend-on-Sea 012,E02003290,9434,8744,403,293,110,113,55,58,174
2021,Southend-on-Sea 013,E02003291,11077,9972,502,357,145,242,107,135,361
2021,Southend-on-Sea 014,E02003292,11215,10265,421,290,131,250,98,152,279
2021,Southend-on-Sea 015,E02003293,11040,10217,417,303,114,186,74,112,220
2021,Southend-on-Sea 016,E02003294,8729,7913,473,350,123,126,69,57,217
2021,Southend-on-Sea 017,E02003295,9582,8660,412,280,132,207,101,106,303
2021,Thurrock 001,E02003296,6760,6155,321,244,77,105,52,53,179
2021,Thurrock 002,E02003297,6913,6307,250,178,72,135,57,78,221
2021,Thurrock 003,E02003298,6719,6090,292,219,73,134,67,67,203
2021,Thurrock 004,E02003299,6123,5541,327,261,66,97,56,41,158
2021,Thurrock 005,E02003300,8321,7665,336,250,86,120,54,66,200
2021,Thurrock 006,E02003301,11101,10250,370,277,93,206,87,119,275
2021,Thurrock 007,E02003302,9672,8887,332,207,125,195,89,106,258
2021,Thurrock 008,E02003303,8839,8117,301,187,114,172,67,105,249
2021,Thurrock 009,E02003304,9178,8317,377,257,120,187,84,103,297
2021,Thurrock 010,E02003305,6636,6044,290,208,82,110,52,58,192
2021,Thurrock 012,E02003307,9884,9001,333,235,98,210,91,119,340
2021,Thurrock 013,E02003308,7076,6543,249,177,72,136,64,72,148
2021,Thurrock 014,E02003309,7342,6725,297,210,87,133,73,60,187
2021,Thurrock 016,E02003311,8657,8094,261,178,83,143,72,71,159
2021,Thurrock 017,E02003312,8469,7984,204,139,65,124,48,76,157
2021,Thurrock 018,E02003313,13599,12523,373,246,127,271,105,166,432
2021,Medway 001,E02003314,6404,5749,258,172,86,149,58,91,248
2021,Medway 002,E02003315,5434,4936,252,188,64,71,37,34,175
2021,Medway 003,E02003316,11389,10425,459,344,115,176,80,96,329
2021,Medway 004,E02003317,6632,6027,294,208,86,126,64,62,185
2021,Medway 005,E02003318,5665,5162,262,198,64,94,48,46,147
2021,Medway 006,E02003319,7672,7071,264,187,77,137,60,77,200
2021,Medway 007,E02003320,8765,8162,305,217,88,128,60,68,170
2021,Medway 008,E02003321,6073,5540,179,114,65,136,63,73,218
2021,Medway 009,E02003322,7522,6955,225,150,75,153,55,98,189
2021,Medway 010,E02003323,6897,6218,249,171,78,199,82,117,231
2021,Medway 011,E02003324,9343,8560,343,225,118,174,77,97,266
2021,Medway 012,E02003325,6783,6271,199,128,71,152,67,85,161
2021,Medway 013,E02003326,7271,6653,267,182,85,142,60,82,209
2021,Medway 014,E02003327,6997,6446,295,232,63,93,33,60,163
2021,Medway 015,E02003328,9093,8464,247,181,66,182,105,77,200
2021,Medway 016,E02003329,6407,5908,212,148,64,151,54,97,136
2021,Medway 017,E02003330,6337,5786,271,188,83,104,56,48,176
2021,Medway 018,E02003331,8368,7548,326,210,116,209,96,113,285
2021,Medway 019,E02003332,5980,5403,250,173,77,107,53,54,220
2021,Medway 020,E02003333,6214,5716,197,138,59,140,46,94,161
2021,Medway 021,E02003334,5772,5317,205,134,71,92,44,48,158
2021,Medway 022,E02003335,6769,6217,169,108,61,176,60,116,207
2021,Medway 023,E02003336,6028,5421,305,223,82,105,46,59,197
2021,Medway 024,E02003337,7016,6450,272,186,86,133,53,80,161
2021,Medway 025,E02003338,6865,6277,284,215,69,130,57,73,174
2021,Medway 026,E02003339,6133,5578,264,177,87,108,40,68,183
2021,Medway 027,E02003340,7616,6845,319,206,113,166,72,94,286
2021,Medway 028,E02003341,6210,5663,278,220,58,103,48,55,166
2021,Medway 029,E02003342,6099,5560,283,211,72,108,57,51,148
2021,Medway 030,E02003343,5766,5211,318,234,84,88,48,40,149
2021,Medway 031,E02003344,6417,5778,276,178,98,148,72,76,215
2021,Medway 032,E02003345,5846,5406,234,165,69,76,33,43,130
2021,Medway 033,E02003346,6682,6087,270,200,70,119,57,62,206
2021,Medway 034,E02003347,5686,5266,209,156,53,83,38,45,128
2021,Medway 035,E02003348,7720,7085,389,297,92,89,39,50,157
2021,Medway 036,E02003349,7005,6384,293,199,94,113,57,56,215
2021,Medway 037,E02003350,6139,5553,273,180,93,119,53,66,194
2021,Medway 038,E02003351,7433,6746,310,225,85,143,58,85,234
2021,Bracknell Forest 001,E02003352,5573,5097,275,210,65,59,30,29,142
2021,Bracknell Forest 002,E02003353,11260,10455,491,384,107,127,56,71,187
2021,Bracknell Forest 003,E02003354,9705,9021,426,334,92,104,49,55,154
2021,Bracknell Forest 004,E02003355,6536,5991,267,189,78,100,42,58,178
2021,Bracknell Forest 005,E02003356,6809,6318,273,206,67,75,43,32,143
2021,Bracknell Forest 006,E02003357,9508,8818,315,217,98,151,70,81,224
2021,Bracknell Forest 007,E02003358,11152,10358,399,297,102,164,68,96,231
2021,Bracknell Forest 008,E02003359,5908,5465,226,178,48,90,37,53,127
2021,Bracknell Forest 009,E02003360,10855,10017,419,312,107,173,70,103,246
2021,Bracknell Forest 010,E02003361,7009,6406,317,231,86,107,46,61,179
2021,Bracknell Forest 011,E02003362,6290,5715,313,228,85,108,51,57,154
2021,Bracknell Forest 012,E02003363,6836,6388,266,207,59,59,36,23,123
2021,Bracknell Forest 013,E02003364,6658,6221,259,195,64,67,24,43,111
2021,Bracknell Forest 014,E02003365,6609,6129,285,228,57,85,43,42,110
2021,Bracknell Forest 015,E02003366,6775,6318,269,211,58,84,44,40,104
2021,West Berkshire 001,E02003367,6291,5775,307,244,63,72,39,33,137
2021,West Berkshire 002,E02003368,5440,5046,217,155,62,62,30,32,115
2021,West Berkshire 003,E02003369,6121,5635,317,238,79,65,33,32,104
2021,West Berkshire 004,E02003370,6406,5863,339,264,75,78,36,42,126
2021,West Berkshire 005,E02003371,5679,5149,316,245,71,75,38,37,139
2021,West Berkshire 006,E02003372,7434,6787,380,311,69,89,40,49,178
2021,West Berkshire 007,E02003373,8281,7694,347,261,86,103,54,49,137
2021,West Berkshire 008,E02003374,5518,5061,265,208,57,82,38,44,110
2021,West Berkshire 009,E02003375,5873,5387,259,191,68,84,36,48,143
2021,West Berkshire 010,E02003376,5547,5109,269,209,60,55,33,22,114
2021,West Berkshire 011,E02003377,9931,9203,434,328,106,103,50,53,191
2021,West Berkshire 012,E02003378,7634,6996,354,270,84,104,49,55,180
2021,West Berkshire 013,E02003379,6540,6030,239,175,64,105,43,62,166
2021,West Berkshire 014,E02003380,7687,7091,302,227,75,104,56,48,190
2021,West Berkshire 015,E02003381,5775,5332,273,221,52,50,24,26,120
2021,West Berkshire 016,E02003382,7101,6494,294,223,71,123,54,69,190
2021,West Berkshire 017,E02003383,6544,6047,289,215,74,78,36,42,130
2021,West Berkshire 018,E02003384,6212,5706,316,248,68,77,41,36,113
2021,West Berkshire 019,E02003385,10374,9762,317,248,69,125,43,82,170
2021,West Berkshire 020,E02003386,7856,7248,340,266,74,105,48,57,163
2021,West Berkshire 021,E02003387,9129,8412,432,359,73,113,63,50,172
2021,West Berkshire 022,E02003388,5762,5283,279,219,60,76,39,37,124
2021,Reading 001,E02003389,7618,6985,375,281,94,108,60,48,150
2021,Reading 002,E02003390,7423,6882,343,263,80,77,47,30,121
2021,Reading 003,E02003391,8118,7509,361,269,92,95,48,47,153
2021,Reading 004,E02003392,8134,7568,293,220,73,98,42,56,175
2021,Reading 005,E02003393,7692,7025,415,325,90,116,47,69,136
2021,Reading 006,E02003394,8039,7415,268,192,76,147,64,83,209
2021,Reading 007,E02003395,10483,9914,248,182,66,178,64,114,143
2021,Reading 008,E02003396,9194,8566,305,215,90,172,70,102,151
2021,Reading 009,E02003397,7701,7025,329,242,87,127,49,78,220
2021,Reading 010,E02003398,10798,10173,274,182,92,169,67,102,182
2021,Reading 012,E02003400,8630,8195,255,199,56,92,43,49,88
2021,Reading 013,E02003401,8595,8011,284,211,73,133,57,76,167
2021,Reading 014,E02003402,10152,9643,261,197,64,136,55,81,112
2021,Reading 015,E02003403,8831,8102,346,249,97,161,77,84,222
2021,Reading 016,E02003404,8246,7788,211,154,57,93,47,46,154
2021,Reading 017,E02003405,12177,11273,333,229,104,258,82,176,313
2021,Reading 018,E02003406,7742,7048,278,186,92,176,87,89,240
2021,Slough 001,E02003407,10170,9421,332,216,116,196,97,99,221
2021,Slough 002,E02003408,10428,9711,312,208,104,192,90,102,213
2021,Slough 003,E02003409,9745,9024,334,242,92,187,78,109,200
2021,Slough 004,E02003410,11366,10457,325,180,145,261,111,150,323
2021,Slough 005,E02003411,11538,10754,338,229,109,213,89,124,233
2021,Slough 006,E02003412,9738,9053,325,238,87,178,72,106,182
2021,Slough 008,E02003414,12558,11764,371,277,94,180,88,92,243
2021,Slough 009,E02003415,12337,11589,267,168,99,237,111,126,244
2021,Slough 010,E02003416,9104,8510,314,210,104,125,60,65,155
2021,Slough 011,E02003417,11786,11032,396,280,116,172,87,85,186
2021,Slough 012,E02003418,9719,8972,351,251,100,161,81,80,235
2021,Slough 013,E02003419,8342,7697,298,179,119,159,78,81,188
2021,Slough 014,E02003420,5931,5548,177,120,57,104,54,50,102
2021,Windsor and Maidenhead 001,E02003421,5410,4974,266,211,55,75,40,35,95
2021,Windsor and Maidenhead 002,E02003422,11268,10370,555,428,127,128,76,52,215
2021,Windsor and Maidenhead 003,E02003423,6214,5733,237,180,57,103,54,49,141
2021,Windsor and Maidenhead 004,E02003424,8789,8160,388,284,104,109,50,59,132
2021,Windsor and Maidenhead 005,E02003425,12151,11402,399,308,91,151,66,85,199
2021,Windsor and Maidenhead 006,E02003426,9322,8590,417,337,80,121,65,56,194
2021,Windsor and Maidenhead 007,E02003427,7616,7037,281,211,70,154,66,88,144
2021,Windsor and Maidenhead 008,E02003428,8637,7970,359,264,95,103,44,59,205
2021,Windsor and Maidenhead 009,E02003429,7415,6883,329,274,55,75,32,43,128
2021,Windsor and Maidenhead 010,E02003430,7222,6805,270,207,63,61,31,30,86
2021,Windsor and Maidenhead 011,E02003431,6628,6052,296,211,85,116,60,56,164
2021,Windsor and Maidenhead 012,E02003432,6696,6310,237,189,48,56,33,23,93
2021,Windsor and Maidenhead 013,E02003433,6050,5533,286,223,63,87,51,36,144
2021,Windsor and Maidenhead 014,E02003434,8677,7996,361,259,102,146,65,81,174
2021,Windsor and Maidenhead 015,E02003435,6772,6315,283,226,57,56,39,17,118
2021,Windsor and Maidenhead 016,E02003436,8654,7890,409,299,110,146,65,81,209
2021,Windsor and Maidenhead 017,E02003437,7138,6600,335,251,84,71,39,32,132
2021,Windsor and Maidenhead 018,E02003438,10814,10081,464,363,101,117,69,48,152
2021,Wokingham 001,E02003439,5295,4869,271,214,57,53,30,23,102
2021,Wokingham 002,E02003440,8804,8146,421,343,78,87,37,50,150
2021,Wokingham 003,E02003441,7342,6683,383,303,80,101,48,53,175
2021,Wokingham 004,E02003442,7875,7316,371,291,80,84,36,48,104
2021,Wokingham 005,E02003443,6576,6045,241,176,65,122,53,69,168
2021,Wokingham 006,E02003444,8900,8134,439,316,123,133,77,56,194
2021,Wokingham 007,E02003445,8250,7590,377,282,95,103,55,48,180
2021,Wokingham 008,E02003446,9483,8863,381,290,91,104,55,49,135
2021,Wokingham 009,E02003447,10075,9315,444,338,106,130,59,71,186
2021,Wokingham 010,E02003448,7662,7125,315,243,72,79,36,43,143
2021,Wokingham 011,E02003449,7087,6619,283,217,66,85,37,48,100
2021,Wokingham 012,E02003450,12293,11512,436,330,106,158,79,79,187
2021,Wokingham 013,E02003451,9180,8574,305,240,65,104,62,42,197
2021,Wokingham 014,E02003452,8882,8298,327,263,64,113,58,55,144
2021,Wokingham 015,E02003453,6679,6197,335,284,51,62,36,26,85
2021,Wokingham 016,E02003454,8281,7670,367,281,86,93,49,44,151
2021,Wokingham 017,E02003455,9814,9181,368,296,72,104,56,48,161
2021,Wokingham 018,E02003456,7688,7190,273,215,58,86,41,45,139
2021,Wokingham 019,E02003457,9440,8701,460,363,97,100,57,43,179
2021,Wokingham 020,E02003458,8040,7427,396,313,83,82,35,47,135
2021,Milton Keynes 001,E02003459,8625,7914,433,336,97,106,62,44,172
2021,Milton Keynes 002,E02003460,11046,10132,524,403,121,157,87,70,233
2021,Milton Keynes 003,E02003461,7138,6506,330,245,85,115,52,63,187
2021,Milton Keynes 004,E02003462,7631,7061,349,270,79,82,46,36,139
2021,Milton Keynes 005,E02003463,6475,5881,292,195,97,134,68,66,168
2021,Milton Keynes 006,E02003464,6639,5997,291,197,94,148,71,77,203
2021,Milton Keynes 007,E02003465,5829,5290,297,228,69,82,35,47,160
2021,Milton Keynes 008,E02003466,7268,6721,293,214,79,96,43,53,158
2021,Milton Keynes 009,E02003467,6204,5695,216,154,62,143,59,84,150
2021,Milton Keynes 010,E02003468,8114,7415,376,283,93,111,54,57,212
2021,Milton Keynes 011,E02003469,5425,4914,273,202,71,80,39,41,158
2021,Milton Keynes 012,E02003470,5759,5283,164,110,54,140,55,85,172
2021,Milton Keynes 013,E02003471,6288,5738,237,166,71,134,65,69,179
2021,Milton Keynes 014,E02003472,9615,9099,221,155,66,163,76,87,132
2021,Milton Keynes 015,E02003473,5315,4894,236,178,58,84,39,45,101
2021,Milton Keynes 016,E02003474,8511,7882,324,230,94,127,67,60,178
2021,Milton Keynes 018,E02003476,8222,7555,226,148,78,205,89,116,236
2021,Milton Keynes 020,E02003478,6466,5971,247,199,48,102,54,48,146
2021,Milton Keynes 021,E02003479,7210,6674,213,155,58,140,53,87,183
2021,Milton Keynes 022,E02003480,7661,7060,328,240,88,122,51,71,151
2021,Milton Keynes 023,E02003481,7795,7074,265,167,98,175,74,101,281
2021,Milton Keynes 024,E02003482,8169,7570,358,283,75,96,56,40,145
2021,Milton Keynes 025,E02003483,10623,9898,400,313,87,129,63,66,196
2021,Milton Keynes 026,E02003484,6759,6219,286,218,68,113,49,64,141
2021,Milton Keynes 027,E02003485,7747,7077,299,214,85,145,72,73,226
2021,Milton Keynes 028,E02003486,9594,8965,348,266,82,120,52,68,161
2021,Milton Keynes 029,E02003487,7014,6352,313,218,95,145,74,71,204
2021,Milton Keynes 030,E02003488,7917,7215,290,199,91,193,88,105,219
2021,Milton Keynes 031,E02003489,7187,6534,312,229,83,124,58,66,217
2021,Milton Keynes 032,E02003490,10280,9539,290,193,97,202,94,108,249
2021,Brighton and Hove 001,E02003491,7413,6712,370,267,103,135,75,60,196
2021,Brighton and Hove 002,E02003492,9905,9234,314,234,80,119,52,67,238
2021,Brighton and Hove 003,E02003493,7717,6996,410,329,81,129,69,60,182
2021,Brighton and Hove 004,E02003494,6368,5786,365,270,95,84,38,46,133
2021,Brighton and Hove 005,E02003495,6734,6066,313,230,83,121,58,63,234
2021,Brighton and Hove 006,E02003496,7325,6571,358,273,85,162,88,74,234
2021,Brighton and Hove 007,E02003497,7248,6679,337,260,77,102,54,48,130
2021,Brighton and Hove 008,E02003498,8141,7367,340,238,102,176,90,86,258
2021,Brighton and Hove 009,E02003499,7489,6704,303,210,93,184,77,107,298
2021,Brighton and Hove 010,E02003500,7672,7071,400,332,68,98,49,49,103
2021,Brighton and Hove 011,E02003501,8045,7499,351,277,74,82,38,44,113
2021,Brighton and Hove 012,E02003502,7354,6647,323,224,99,174,87,87,210
2021,Brighton and Hove 013,E02003503,8611,7750,421,306,115,192,99,93,248
2021,Brighton and Hove 014,E02003504,8203,7667,359,300,59,72,38,34,105
2021,Brighton and Hove 015,E02003505,8663,8172,347,290,57,66,34,32,78
2021,Brighton and Hove 016,E02003506,6689,6265,249,198,51,75,34,41,100
2021,Brighton and Hove 017,E02003507,9293,8349,441,327,114,198,102,96,305
2021,Brighton and Hove 018,E02003508,8329,7781,346,275,71,86,51,35,116
2021,Brighton and Hove 019,E02003509,8483,7983,308,229,79,88,40,48,104
2021,Brighton and Hove 020,E02003510,8289,7737,362,286,76,80,35,45,110
2021,Brighton and Hove 021,E02003511,8117,7458,373,309,64,122,56,66,164
2021,Brighton and Hove 022,E02003512,8537,8018,306,251,55,107,60,47,106
2021,Brighton and Hove 023,E02003513,6203,5698,292,231,61,89,34,55,124
2021,Brighton and Hove 024,E02003514,8165,7717,304,242,62,80,55,25,64
2021,Brighton and Hove 025,E02003515,8617,7604,333,213,120,269,123,146,411
2021,Brighton and Hove 026,E02003516,7944,7479,289,226,63,86,36,50,90
2021,Brighton and Hove 027,E02003517,10446,9803,382,297,85,115,47,68,146
2021,Brighton and Hove 028,E02003518,7336,6837,304,239,65,88,37,51,107
2021,Brighton and Hove 029,E02003519,8020,7583,292,232,60,88,45,43,57
2021,Brighton and Hove 030,E02003520,8847,8214,303,216,87,151,68,83,179
2021,Brighton and Hove 031,E02003521,7882,7347,301,228,73,110,54,56,124
2021,Brighton and Hove 032,E02003522,7459,6889,314,240,74,118,58,60,138
2021,Brighton and Hove 033,E02003523,9798,8865,518,396,122,187,99,88,228
2021,Portsmouth 001,E02003524,7684,6880,266,182,84,210,102,108,328
2021,Portsmouth 002,E02003525,6025,5434,190,115,75,158,51,107,243
2021,Portsmouth 003,E02003526,6566,5992,335,253,82,77,42,35,162
2021,Portsmouth 004,E02003527,5975,5480,223,151,72,116,46,70,156
2021,Portsmouth 006,E02003529,7869,7153,375,297,78,119,52,67,222
2021,Portsmouth 007,E02003530,7407,6801,277,174,103,133,56,77,196
2021,Portsmouth 008,E02003531,7362,6759,321,238,83,119,67,52,163
2021,Portsmouth 009,E02003532,7420,6841,307,238,69,105,56,49,167
2021,Portsmouth 010,E02003533,5383,4909,182,114,68,119,54,65,173
2021,Portsmouth 011,E02003534,8339,7673,324,228,96,147,75,72,195
2021,Portsmouth 012,E02003535,8984,8304,315,210,105,148,68,80,217
2021,Portsmouth 013,E02003536,7392,6714,215,147,68,199,74,125,264
2021,Portsmouth 014,E02003537,9698,8852,458,340,118,147,67,80,241
2021,Portsmouth 015,E02003538,9633,8952,306,210,96,170,75,95,205
2021,Portsmouth 017,E02003540,8907,8178,377,276,101,144,77,67,208
2021,Portsmouth 018,E02003541,10359,9691,273,188,85,171,82,89,224
2021,Portsmouth 019,E02003542,8372,7780,306,232,74,117,64,53,169
2021,Portsmouth 020,E02003543,8395,7973,253,189,64,67,31,36,102
2021,Portsmouth 021,E02003544,5939,5462,264,192,72,101,48,53,112
2021,Portsmouth 022,E02003545,6536,6138,223,156,67,90,37,53,85
2021,Portsmouth 023,E02003546,7510,6908,338,247,91,115,53,62,149
2021,Portsmouth 024,E02003547,7823,7284,300,225,75,97,41,56,142
2021,Portsmouth 025,E02003548,5895,5496,243,188,55,79,41,38,77
2021,Southampton 001,E02003549,8188,7634,301,222,79,95,48,47,158
2021,Southampton 002,E02003550,7437,6753,305,236,69,143,52,91,236
2021,Southampton 003,E02003551,6219,5797,211,163,48,72,34,38,139
2021,Southampton 004,E02003552,5842,5291,179,124,55,152,70,82,220
2021,Southampton 005,E02003553,6932,6419,222,156,66,114,51,63,177
2021,Southampton 006,E02003554,5764,5278,257,191,66,92,49,43,137
2021,Southampton 007,E02003555,8135,7429,283,189,94,168,68,100,255
2021,Southampton 008,E02003556,5432,4963,233,162,71,93,50,43,143
2021,Southampton 009,E02003557,6549,6137,241,193,48,70,32,38,101
2021,Southampton 010,E02003558,6769,6225,209,152,57,139,65,74,196
2021,Southampton 011,E02003559,7418,6779,368,277,91,117,65,52,154
2021,Southampton 012,E02003560,6929,6211,263,180,83,184,72,112,271
2021,Southampton 013,E02003561,7542,7049,237,182,55,106,41,65,150
2021,Southampton 014,E02003562,7830,7213,354,256,98,123,58,65,140
2021,Southampton 015,E02003563,7502,6944,263,192,71,128,58,70,167
2021,Southampton 016,E02003564,7579,6851,349,248,101,147,63,84,232
2021,Southampton 017,E02003565,6474,6181,151,120,31,63,34,29,79
2021,Southampton 018,E02003566,6043,5442,237,159,78,136,56,80,228
2021,Southampton 019,E02003567,7571,6880,290,201,89,170,68,102,231
2021,Southampton 020,E02003568,7870,7370,292,222,70,114,50,64,94
2021,Southampton 021,E02003569,7371,6858,264,200,64,123,48,75,126
2021,Southampton 022,E02003570,10839,10239,251,168,83,159,70,89,190
2021,Southampton 023,E02003571,8677,8355,183,131,52,70,29,41,69
2021,Southampton 024,E02003572,5826,5292,260,210,50,95,43,52,179
2021,Southampton 025,E02003573,7416,6687,291,200,91,178,74,104,260
2021,Southampton 026,E02003574,7249,6588,321,232,89,141,56,85,199
2021,Southampton 027,E02003575,6054,5440,222,158,64,153,64,89,239
2021,Southampton 028,E02003576,7636,6988,298,205,93,138,73,65,212
2021,Southampton 030,E02003578,6007,5452,262,197,65,97,47,50,196
2021,Southampton 031,E02003579,8993,8320,340,259,81,139,56,83,194
2021,Southampton 032,E02003580,5698,5144,180,125,55,138,54,84,236
2021,Isle of Wight 001,E02003581,7387,6710,346,261,85,121,53,68,210
2021,Isle of Wight 002,E02003582,8244,7405,438,329,109,143,75,68,258
2021,Isle of Wight 003,E02003583,7368,6592,332,248,84,141,68,73,303
2021,Isle of Wight 004,E02003584,5877,5321,281,200,81,105,59,46,170
2021,Isle of Wight 005,E02003585,6399,5671,382,281,101,98,50,48,248
2021,Isle of Wight 006,E02003586,7380,6592,351,257,94,165,80,85,272
2021,Isle of Wight 007,E02003587,8095,7267,329,248,81,178,76,102,321
2021,Isle of Wight 008,E02003588,8798,7879,371,265,106,179,91,88,369
2021,Isle of Wight 009,E02003589,6975,6332,296,215,81,148,62,86,199
2021,Isle of Wight 010,E02003590,7146,6388,387,293,94,116,75,41,255
2021,Isle of Wight 011,E02003591,9014,8085,449,331,118,197,96,101,283
2021,Isle of Wight 012,E02003592,9402,8351,472,351,121,212,101,111,367
2021,Isle of Wight 013,E02003593,5140,4517,331,229,102,96,48,48,196
2021,Isle of Wight 014,E02003594,8942,7974,427,297,130,201,98,103,340
2021,Isle of Wight 015,E02003595,7749,6837,423,301,122,155,72,83,334
2021,Isle of Wight 016,E02003596,8405,7580,380,256,124,162,77,85,283
2021,Isle of Wight 017,E02003597,5515,4879,306,212,94,108,44,64,222
2021,Isle of Wight 018,E02003598,7075,6318,355,246,109,143,66,77,259
2021,Central Bedfordshire 001,E02003599,5399,4936,230,169,61,97,43,54,136
2021,Central Bedfordshire 002,E02003600,6132,5558,295,219,76,111,51,60,168
2021,Central Bedfordshire 003,E02003601,7705,7054,363,265,98,113,62,51,175
2021,Central Bedfordshire 004,E02003602,6265,5659,356,268,88,95,50,45,155
2021,Central Bedfordshire 005,E02003603,10534,9628,471,360,111,184,83,101,251
2021,Central Bedfordshire 006,E02003604,10377,9496,463,335,128,173,81,92,245
2021,Central Bedfordshire 007,E02003605,9656,8972,398,312,86,121,66,55,165
2021,Central Bedfordshire 008,E02003606,8854,8018,500,383,117,122,65,57,214
2021,Central Bedfordshire 009,E02003607,10408,9531,492,357,135,150,80,70,235
2021,Central Bedfordshire 010,E02003608,11469,10486,582,442,140,141,62,79,260
2021,Central Bedfordshire 011,E02003609,11112,10154,521,388,133,158,67,91,279
2021,Central Bedfordshire 012,E02003610,8506,7828,429,329,100,110,59,51,139
2021,Central Bedfordshire 013,E02003611,9277,8432,450,328,122,149,74,75,246
2021,Central Bedfordshire 014,E02003612,11582,10685,502,368,134,149,66,83,246
2021,Central Bedfordshire 015,E02003613,5465,4936,281,195,86,92,43,49,156
2021,Central Bedfordshire 016,E02003614,7648,7011,397,310,87,97,51,46,143
2021,Central Bedfordshire 017,E02003615,9950,9051,550,420,130,134,65,69,215
2021,Bedford 001,E02003616,5464,4976,297,222,75,72,42,30,119
2021,Bedford 002,E02003617,8671,7792,507,385,122,140,71,69,232
2021,Bedford 003,E02003618,8350,7586,435,320,115,134,68,66,195
2021,Bedford 004,E02003619,11267,10305,550,417,133,173,85,88,239
2021,Bedford 005,E02003620,7766,7051,401,301,100,134,64,70,180
2021,Bedford 006,E02003621,7758,7018,423,298,125,117,54,63,200
2021,Bedford 007,E02003622,8687,7918,350,251,99,164,89,75,255
2021,Bedford 008,E02003623,11924,11015,542,415,127,162,76,86,205
2021,Bedford 009,E02003624,5694,5312,220,175,45,61,32,29,101
2021,Bedford 010,E02003625,8420,7870,292,215,77,125,53,72,133
2021,Bedford 011,E02003626,5331,4837,272,201,71,108,48,60,114
2021,Bedford 012,E02003627,10011,9346,347,265,82,166,68,98,152
2021,Bedford 013,E02003628,8968,8255,299,181,118,233,91,142,181
2021,Bedford 014,E02003629,9989,9208,309,220,89,241,98,143,231
2021,Bedford 015,E02003630,10623,9801,306,193,113,241,95,146,275
2021,Bedford 016,E02003631,5238,4760,228,164,64,109,53,56,141
2021,Bedford 017,E02003632,5815,5310,267,193,74,106,52,54,132
2021,Bedford 018,E02003633,9832,9039,382,268,114,184,95,89,227
2021,Bedford 020,E02003635,9413,8601,435,336,99,144,63,81,233
2021,Central Bedfordshire 018,E02003636,6970,6303,400,318,82,107,56,51,160
2021,Central Bedfordshire 019,E02003637,10137,9148,594,447,147,144,73,71,251
2021,Central Bedfordshire 020,E02003638,7259,6632,328,233,95,114,62,52,185
2021,Central Bedfordshire 021,E02003639,8993,8318,319,237,82,158,74,84,198
2021,Central Bedfordshire 022,E02003640,5736,5280,246,197,49,73,31,42,137
2021,Central Bedfordshire 023,E02003641,5065,4629,260,190,70,60,32,28,116
2021,Central Bedfordshire 025,E02003642,8916,8149,298,212,86,193,85,108,276
2021,Central Bedfordshire 024,E02003643,12545,11630,463,357,106,181,86,95,271
2021,Central Bedfordshire 026,E02003644,9349,8613,342,246,96,161,79,82,233
2021,Central Bedfordshire 027,E02003645,6634,6065,323,240,83,88,51,37,158
2021,Central Bedfordshire 028,E02003646,9941,9116,409,291,118,195,101,94,221
2021,Central Bedfordshire 029,E02003647,9818,9092,401,291,110,116,51,65,209
2021,Central Bedfordshire 030,E02003648,5154,4685,231,170,61,110,43,67,128
2021,Central Bedfordshire 031,E02003649,6289,5741,304,232,72,90,46,44,154
2021,Central Bedfordshire 032,E02003650,6695,6051,356,245,111,89,46,43,199
2021,Central Bedfordshire 033,E02003651,6604,6008,332,248,84,100,54,46,164
2021,Buckinghamshire 001,E02003652,10033,9290,453,352,101,118,61,57,172
2021,Buckinghamshire 002,E02003653,6436,5983,236,173,63,89,46,43,128
2021,Buckinghamshire 003,E02003654,5550,5068,280,223,57,79,42,37,123
2021,Buckinghamshire 004,E02003655,9840,9026,476,354,122,129,69,60,209
2021,Buckinghamshire 005,E02003656,6327,5793,307,241,66,95,44,51,132
2021,Buckinghamshire 006,E02003657,7116,6530,357,256,101,87,44,43,142
2021,Buckinghamshire 007,E02003658,9329,8580,458,352,106,115,56,59,176
2021,Buckinghamshire 009,E02003659,9281,8553,372,291,81,141,60,81,215
2021,Buckinghamshire 008,E02003660,10264,9376,545,433,112,111,55,56,232
2021,Buckinghamshire 010,E02003661,5640,5176,285,225,60,61,33,28,118
2021,Buckinghamshire 012,E02003662,5811,5344,240,190,50,123,60,63,104
2021,Buckinghamshire 011,E02003663,12640,11772,377,264,113,233,95,138,258
2021,Buckinghamshire 013,E02003664,7494,6916,261,180,81,140,71,69,177
2021,Buckinghamshire 014,E02003665,5780,5343,239,183,56,82,34,48,116
2021,Buckinghamshire 015,E02003666,7094,6576,234,170,64,129,59,70,155
2021,Buckinghamshire 016,E02003667,8723,8054,386,279,107,113,58,55,170
2021,Buckinghamshire 018,E02003668,8372,7637,428,326,102,120,62,58,187
2021,Buckinghamshire 017,E02003669,6906,6279,267,175,92,161,68,93,199
2021,Buckinghamshire 019,E02003670,8632,7921,376,283,93,121,51,70,214
2021,Buckinghamshire 020,E02003671,5554,5121,195,135,60,108,50,58,130
2021,Buckinghamshire 021,E02003672,11735,10731,586,449,137,161,85,76,257
2021,Buckinghamshire 022,E02003673,8923,8171,446,351,95,104,53,51,202
2021,Buckinghamshire 023,E02003674,5305,4880,273,224,49,57,27,30,95
2021,Buckinghamshire 024,E02003675,9140,8436,443,362,81,105,65,40,156
2021,Buckinghamshire 029,E02003676,7845,7176,442,337,105,83,48,35,144
2021,Buckinghamshire 027,E02003677,9755,8891,458,340,118,165,87,78,241
2021,Buckinghamshire 028,E02003678,5500,5077,268,217,51,62,26,36,93
2021,Buckinghamshire 030,E02003679,6417,5899,309,239,70,89,43,46,120
2021,Buckinghamshire 031,E02003680,9419,8645,467,389,78,111,57,54,196
2021,Buckinghamshire 032,E02003681,10008,9284,432,338,94,106,57,49,186
2021,Buckinghamshire 034,E02003682,7203,6674,336,264,72,84,45,39,109
2021,Buckinghamshire 035,E02003683,6779,6248,323,257,66,75,37,38,133
2021,Buckinghamshire 047,E02003685,7592,6979,401,329,72,67,31,36,145
2021,Buckinghamshire 050,E02003686,7215,6678,339,263,76,94,48,46,104
2021,Buckinghamshire 054,E02003687,5470,5024,269,206,63,76,35,41,101
2021,Buckinghamshire 053,E02003688,11613,10774,514,400,114,111,50,61,214
2021,Buckinghamshire 058,E02003689,8830,8125,438,327,111,91,43,48,176
2021,Buckinghamshire 059,E02003690,7015,6406,306,227,79,113,50,63,190
2021,Buckinghamshire 063,E02003691,6923,6341,348,264,84,84,49,35,150
2021,Buckinghamshire 064,E02003692,8464,7621,483,333,150,173,82,91,187
2021,Buckinghamshire 065,E02003693,6874,6256,369,271,98,104,48,56,145
2021,Buckinghamshire 066,E02003694,7961,7319,330,241,89,128,60,68,184
2021,Buckinghamshire 067,E02003695,10193,9275,512,384,128,174,86,88,232
2021,Buckinghamshire 026,E02003696,8162,7393,442,343,99,106,50,56,221
2021,Buckinghamshire 025,E02003697,5998,5503,301,251,50,78,47,31,116
2021,Buckinghamshire 033,E02003698,7922,7209,465,370,95,91,42,49,157
2021,Buckinghamshire 037,E02003699,5548,5079,279,222,57,66,30,36,124
2021,Buckinghamshire 038,E02003701,11625,10692,511,410,101,164,74,90,258
2021,Buckinghamshire 040,E02003702,7825,7153,436,354,82,111,46,65,125
2021,Buckinghamshire 041,E02003703,8425,7834,341,252,89,109,48,61,141
2021,Buckinghamshire 045,E02003704,5481,5078,255,202,53,56,27,29,92
2021,Buckinghamshire 042,E02003705,6597,6112,224,154,70,103,46,57,158
2021,Buckinghamshire 043,E02003706,6372,5905,218,164,54,97,55,42,152
2021,Buckinghamshire 044,E02003707,6278,5870,216,160,56,96,31,65,96
2021,Buckinghamshire 046,E02003708,9062,8422,261,167,94,202,92,110,177
2021,Buckinghamshire 048,E02003709,5369,4959,178,130,48,102,43,59,130
2021,Buckinghamshire 049,E02003710,12114,11310,446,328,118,171,92,79,187
2021,Buckinghamshire 051,E02003711,9065,8451,346,264,82,121,49,72,147
2021,Buckinghamshire 052,E02003712,7709,7039,332,255,77,142,72,70,196
2021,Buckinghamshire 055,E02003713,5630,5131,288,236,52,78,48,30,133
2021,Buckinghamshire 056,E02003714,6343,5888,264,209,55,76,36,40,115
2021,Buckinghamshire 057,E02003715,6313,5804,319,260,59,68,35,33,122
2021,Buckinghamshire 060,E02003716,5573,5096,278,218,60,83,44,39,116
2021,Buckinghamshire 062,E02003717,8749,8037,441,344,97,119,73,46,152
2021,Buckinghamshire 061,E02003718,5373,5007,209,158,51,60,29,31,97
2021,Cambridge 001,E02003719,9711,8960,399,309,90,181,82,99,171
2021,Cambridge 002,E02003720,9160,8519,357,271,86,120,45,75,164
2021,Cambridge 003,E02003721,9212,8529,346,266,80,126,62,64,211
2021,Cambridge 004,E02003722,8171,7659,356,287,69,73,41,32,83
2021,Cambridge 005,E02003723,12630,11990,497,422,75,62,29,33,81
2021,Cambridge 006,E02003724,9820,9130,341,255,86,142,70,72,207
2021,Cambridge 007,E02003725,15978,15253,551,464,87,79,51,28,95
2021,Cambridge 008,E02003726,7975,7546,292,244,48,64,30,34,73
2021,Cambridge 009,E02003727,9733,9173,333,258,75,118,58,60,109
2021,Cambridge 010,E02003728,10429,9758,380,284,96,109,47,62,182
2021,Cambridge 011,E02003729,8794,8135,349,279,70,131,71,60,179
2021,Cambridge 013,E02003731,11520,10709,437,361,76,147,57,90,227
2021,East Cambridgeshire 001,E02003732,9292,8449,422,302,120,152,76,76,269
2021,East Cambridgeshire 002,E02003733,8036,7234,474,353,121,126,62,64,202
2021,East Cambridgeshire 003,E02003734,11361,10440,505,388,117,138,69,69,278
2021,East Cambridgeshire 004,E02003735,8229,7646,343,271,72,101,62,39,139
2021,East Cambridgeshire 005,E02003736,9773,8899,494,368,126,136,70,66,244
2021,East Cambridgeshire 006,E02003737,12439,11422,566,421,145,182,77,105,269
2021,East Cambridgeshire 007,E02003738,6074,5533,299,220,79,111,56,55,131
2021,East Cambridgeshire 008,E02003739,6129,5580,347,268,79,74,34,40,128
2021,East Cambridgeshire 009,E02003740,6018,5464,333,258,75,89,41,48,132
2021,Fenland 001,E02003742,6517,5767,317,213,104,168,81,87,265
2021,Fenland 002,E02003743,10454,9573,301,205,96,213,79,134,367
2021,Fenland 003,E02003744,12943,11912,411,286,125,241,100,141,379
2021,Fenland 004,E02003745,9873,8884,413,304,109,217,95,122,359
2021,Fenland 005,E02003746,7481,6752,357,253,104,150,70,80,222
2021,Fenland 006,E02003747,12041,10945,493,354,139,237,107,130,366
2021,Fenland 007,E02003748,7260,6483,323,225,98,168,75,93,286
2021,Fenland 008,E02003749,5847,5285,281,199,82,114,58,56,167
2021,Fenland 009,E02003750,7155,6383,362,260,102,146,73,73,264
2021,Fenland 010,E02003751,7153,6424,339,254,85,142,75,67,248
2021,Fenland 011,E02003752,10567,9563,451,317,134,202,84,118,351
2021,Huntingdonshire 001,E02003753,10537,9551,483,365,118,198,104,94,305
2021,Huntingdonshire 002,E02003754,5422,4917,294,208,86,83,34,49,128
2021,Huntingdonshire 003,E02003755,8142,7391,392,277,115,118,53,65,241
2021,Huntingdonshire 004,E02003756,6729,6169,303,231,72,93,52,41,164
2021,Huntingdonshire 005,E02003757,6521,5921,320,242,78,110,56,54,170
2021,Huntingdonshire 006,E02003758,9117,8389,421,311,110,124,60,64,183
2021,Huntingdonshire 007,E02003759,5630,5160,291,223,68,61,35,26,118
2021,Huntingdonshire 008,E02003760,8467,7814,243,156,87,170,64,106,240
2021,Huntingdonshire 009,E02003761,5724,5238,253,188,65,95,52,43,138
2021,Huntingdonshire 010,E02003762,10733,9873,456,348,108,148,75,73,256
2021,Huntingdonshire 011,E02003763,9134,8443,386,278,108,130,69,61,175
2021,Huntingdonshire 012,E02003764,9789,9130,361,273,88,127,57,70,171
2021,Huntingdonshire 013,E02003765,6914,6363,309,230,79,93,48,45,149
2021,Huntingdonshire 014,E02003766,7384,6836,306,232,74,95,57,38,147
2021,Huntingdonshire 015,E02003767,6135,5605,322,258,64,76,42,34,132
2021,Huntingdonshire 016,E02003768,9573,8746,468,366,102,126,60,66,233
2021,Huntingdonshire 017,E02003769,7183,6596,324,264,60,86,44,42,177
2021,Huntingdonshire 018,E02003770,10205,9424,449,344,105,110,52,58,222
2021,Huntingdonshire 019,E02003771,5986,5486,269,196,73,101,48,53,130
2021,Huntingdonshire 020,E02003772,6417,5900,313,247,66,82,44,38,122
2021,Huntingdonshire 021,E02003773,9964,9142,391,291,100,151,82,69,280
2021,Huntingdonshire 022,E02003774,5461,4926,287,212,75,90,43,47,158
2021,South Cambridgeshire 001,E02003775,6847,6226,387,295,92,86,41,45,148
2021,South Cambridgeshire 002,E02003776,6465,5893,345,258,87,103,43,60,124
2021,South Cambridgeshire 003,E02003777,9245,8596,373,292,81,110,54,56,166
2021,South Cambridgeshire 004,E02003778,6074,5588,296,233,63,78,40,38,112
2021,South Cambridgeshire 006,E02003780,10876,9951,545,423,122,162,77,85,218
2021,South Cambridgeshire 007,E02003781,5782,5295,318,252,66,64,34,30,105
2021,South Cambridgeshire 010,E02003784,8546,7801,487,392,95,98,54,44,160
2021,South Cambridgeshire 011,E02003785,8392,7675,452,346,106,104,48,56,161
2021,South Cambridgeshire 012,E02003786,6198,5689,290,233,57,85,32,53,134
2021,South Cambridgeshire 013,E02003787,7267,6545,446,320,126,93,50,43,183
2021,South Cambridgeshire 014,E02003788,7649,7044,373,292,81,94,49,45,138
2021,South Cambridgeshire 015,E02003789,6857,6276,317,226,91,103,48,55,161
2021,South Cambridgeshire 016,E02003790,8923,8098,529,434,95,105,56,49,191
2021,South Cambridgeshire 017,E02003791,7861,7146,449,353,96,114,55,59,152
2021,South Cambridgeshire 018,E02003792,9351,8539,492,386,106,134,81,53,186
2021,South Cambridgeshire 019,E02003793,6862,6264,362,284,78,97,48,49,139
2021,Cheshire West and Chester 022,E02003794,8262,7372,485,355,130,156,74,82,249
2021,Cheshire West and Chester 025,E02003795,6064,5461,322,236,86,110,67,43,171
2021,Cheshire West and Chester 027,E02003796,6905,6279,313,224,89,121,62,59,192
2021,Cheshire West and Chester 028,E02003797,9533,8694,512,386,126,141,63,78,186
2021,Cheshire West and Chester 029,E02003798,5902,5293,221,132,89,156,72,84,232
2021,Cheshire West and Chester 031,E02003799,6865,6132,304,212,92,174,85,89,255
2021,Cheshire West and Chester 030,E02003800,6811,6176,364,289,75,84,37,47,187
2021,Cheshire West and Chester 032,E02003801,6750,6064,338,244,94,120,64,56,228
2021,Cheshire West and Chester 033,E02003802,8313,7775,305,231,74,123,51,72,110
2021,Cheshire West and Chester 034,E02003803,9995,9442,341,256,85,99,46,53,113
2021,Cheshire West and Chester 036,E02003804,6538,5973,317,240,77,102,49,53,146
2021,Cheshire West and Chester 039,E02003805,6081,5494,357,283,74,87,36,51,143
2021,Cheshire West and Chester 041,E02003806,7819,7185,374,286,88,107,45,62,153
2021,Cheshire West and Chester 043,E02003807,8494,7678,431,320,111,141,68,73,244
2021,Cheshire West and Chester 044,E02003808,6117,5564,238,161,77,148,67,81,167
2021,Cheshire West and Chester 046,E02003809,7856,7135,408,312,96,108,62,46,205
2021,Cheshire West and Chester 047,E02003810,9334,8509,462,363,99,133,61,72,230
2021,Cheshire East 022,E02003811,7235,6534,411,300,111,105,59,46,185
2021,Cheshire East 023,E02003812,6339,5790,308,246,62,85,50,35,156
2021,Cheshire East 024,E02003813,5818,5277,295,219,76,97,53,44,149
2021,Cheshire East 025,E02003814,7886,7213,358,256,102,142,63,79,173
2021,Cheshire East 026,E02003815,7078,6390,285,193,92,166,72,94,237
2021,Cheshire East 027,E02003816,7162,6503,365,286,79,121,58,63,173
2021,Cheshire East 028,E02003817,7338,6676,373,291,82,111,59,52,178
2021,Cheshire East 029,E02003818,5452,4925,346,272,74,77,48,29,104
2021,Cheshire East 030,E02003819,6263,5654,336,265,71,82,28,54,191
2021,Cheshire East 031,E02003820,9082,8352,426,315,111,124,63,61,180
2021,Cheshire East 032,E02003821,5330,4807,265,183,82,82,41,41,176
2021,Cheshire East 033,E02003822,11019,9871,608,448,160,189,95,94,351
2021,Cheshire East 040,E02003823,6571,5846,373,264,109,137,77,60,215
2021,Cheshire East 042,E02003824,6143,5591,317,244,73,88,50,38,147
2021,Cheshire East 034,E02003825,6032,5506,282,213,69,124,60,64,120
2021,Cheshire East 035,E02003826,8254,7350,320,228,92,237,99,138,347
2021,Cheshire East 036,E02003827,8903,8186,276,182,94,168,61,107,273
2021,Cheshire East 037,E02003828,6087,5537,208,143,65,141,63,78,201
2021,Cheshire East 038,E02003829,5352,4847,237,166,71,100,42,58,168
2021,Cheshire East 039,E02003830,7505,6910,220,145,75,167,61,106,208
2021,Cheshire East 041,E02003831,9662,8696,559,426,133,132,82,50,275
2021,Cheshire East 043,E02003832,6224,5780,192,138,54,108,35,73,144
2021,Cheshire East 044,E02003833,5995,5431,285,214,71,111,47,64,168
2021,Cheshire East 045,E02003834,6653,6164,236,186,50,116,45,71,137
2021,Cheshire East 046,E02003835,7982,7140,466,363,103,143,77,66,233
2021,Cheshire East 047,E02003836,6705,6068,347,256,91,105,58,47,185
2021,Cheshire East 048,E02003838,7696,6989,406,296,110,117,55,62,184
2021,Cheshire East 050,E02003839,6782,6149,313,240,73,120,60,60,200
2021,Cheshire East 051,E02003840,10427,9350,614,478,136,181,101,80,282
2021,Cheshire West and Chester 001,E02003841,7608,6823,416,315,101,140,69,71,229
2021,Cheshire West and Chester 004,E02003842,5427,4866,307,257,50,83,50,33,171
2021,Cheshire West and Chester 005,E02003843,6156,5437,301,196,105,146,70,76,272
2021,Cheshire West and Chester 006,E02003844,6392,5652,385,285,100,120,64,56,235
2021,Cheshire West and Chester 007,E02003845,10132,9254,335,221,114,232,91,141,311
2021,Cheshire West and Chester 008,E02003846,6422,5808,204,134,70,169,75,94,241
2021,Cheshire West and Chester 009,E02003847,9344,8355,599,426,173,149,70,79,241
2021,Cheshire West and Chester 010,E02003848,5030,4497,210,145,65,130,62,68,193
2021,Cheshire West and Chester 011,E02003849,7844,7060,268,178,90,209,89,120,307
2021,Cheshire West and Chester 013,E02003850,4850,4349,224,168,56,94,46,48,183
2021,Cheshire West and Chester 014,E02003851,5537,4976,303,220,83,107,52,55,151
2021,Cheshire West and Chester 016,E02003852,6228,5561,335,233,102,110,58,52,222
2021,Cheshire East 001,E02003853,5840,5304,315,257,58,79,40,39,142
2021,Cheshire East 002,E02003854,6114,5534,326,235,91,87,53,34,167
2021,Cheshire East 003,E02003855,6176,5623,336,260,76,72,41,31,145
2021,Cheshire East 004,E02003856,10783,9805,479,342,137,209,105,104,290
2021,Cheshire East 005,E02003857,6428,5910,301,219,82,89,34,55,128
2021,Cheshire East 006,E02003858,6564,6048,305,243,62,75,38,37,136
2021,Cheshire East 007,E02003859,11945,10792,667,499,168,217,128,89,269
2021,Cheshire East 008,E02003860,6905,6385,339,278,61,65,32,33,116
2021,Cheshire East 009,E02003861,6096,5519,310,225,85,100,53,47,167
2021,Cheshire East 011,E02003862,5106,4667,269,201,68,60,33,27,110
2021,Cheshire East 010,E02003863,6527,6003,342,267,75,64,31,33,118
2021,Cheshire East 012,E02003864,8234,7596,393,304,89,89,41,48,156
2021,Cheshire East 013,E02003865,7580,6880,441,318,123,108,55,53,151
2021,Cheshire East 014,E02003866,5989,5473,340,258,82,55,33,22,121
2021,Cheshire East 015,E02003867,7272,6576,366,269,97,138,62,76,192
2021,Cheshire East 016,E02003868,7996,7328,318,238,80,140,56,84,210
2021,Cheshire East 017,E02003869,6993,6326,394,308,86,107,58,49,166
2021,Cheshire East 018,E02003870,9930,9199,443,339,104,129,65,64,159
2021,Cheshire East 019,E02003871,6492,5839,300,222,78,121,58,63,232
2021,Cheshire East 020,E02003872,9842,8835,687,530,157,123,68,55,197
2021,Cheshire East 021,E02003873,5847,5280,248,179,69,129,57,72,190
2021,Cheshire West and Chester 002,E02003874,8801,7884,464,339,125,140,69,71,313
2021,Cheshire West and Chester 003,E02003875,6210,5513,421,310,111,98,58,40,178
2021,Cheshire West and Chester 012,E02003876,5380,4884,252,165,87,103,46,57,141
2021,Cheshire West and Chester 015,E02003877,9217,8358,535,408,127,132,70,62,192
2021,Cheshire West and Chester 017,E02003878,8835,7987,466,344,122,145,69,76,237
2021,Cheshire West and Chester 018,E02003879,8488,7852,296,212,84,151,71,80,189
2021,Cheshire West and Chester 019,E02003880,6247,5567,306,218,88,145,71,74,229
2021,Cheshire West and Chester 020,E02003881,5573,5053,233,157,76,138,65,73,149
2021,Cheshire West and Chester 021,E02003882,9006,8045,397,279,118,257,121,136,307
2021,Cheshire West and Chester 023,E02003883,10762,9794,605,450,155,130,71,59,233
2021,Cheshire West and Chester 024,E02003884,8505,7656,492,362,130,115,67,48,242
2021,Cheshire West and Chester 026,E02003885,6147,5546,340,252,88,98,46,52,163
2021,Cheshire West and Chester 035,E02003886,6190,5562,262,171,91,140,59,81,226
2021,Cheshire West and Chester 037,E02003887,6564,5866,320,235,85,134,50,84,244
2021,Cheshire West and Chester 038,E02003888,6125,5525,244,159,85,130,55,75,226
2021,Cheshire West and Chester 040,E02003889,6044,5347,210,138,72,200,75,125,287
2021,Cheshire West and Chester 042,E02003890,6620,5958,263,187,76,158,77,81,241
2021,Cheshire West and Chester 045,E02003891,6199,5627,332,259,73,92,49,43,148
2021,Cornwall 010,E02003892,6416,5683,383,282,101,126,64,62,224
2021,Cornwall 012,E02003893,6345,5621,394,299,95,145,73,72,185
2021,Cornwall 013,E02003894,7940,7130,387,275,112,160,86,74,263
2021,Cornwall 016,E02003895,8941,8030,451,316,135,174,83,91,286
2021,Cornwall 017,E02003896,5676,5121,233,172,61,122,48,74,200
2021,Cornwall 022,E02003897,5209,4717,284,219,65,74,33,41,134
2021,Cornwall 023,E02003898,6506,5806,348,275,73,118,57,61,234
2021,Cornwall 025,E02003899,5056,4515,243,159,84,113,55,58,185
2021,Cornwall 026,E02003900,6796,6150,323,234,89,134,68,66,189
2021,Cornwall 028,E02003901,8007,7158,357,257,100,178,89,89,314
2021,Cornwall 029,E02003902,5061,4526,246,165,81,109,47,62,180
2021,Cornwall 034,E02003903,6000,5340,356,271,85,130,68,62,174
2021,Cornwall 037,E02003904,4888,4380,249,184,65,109,56,53,150
2021,Cornwall 032,E02003905,6811,6195,292,208,84,128,62,66,196
2021,Cornwall 033,E02003906,6128,5544,295,214,81,124,66,58,165
2021,Cornwall 040,E02003907,8084,7345,426,332,94,118,65,53,195
2021,Cornwall 042,E02003908,8070,7288,404,308,96,149,73,76,229
2021,Cornwall 043,E02003909,10202,9170,528,389,139,212,106,106,292
2021,Cornwall 044,E02003910,6648,6104,315,233,82,89,43,46,140
2021,Cornwall 047,E02003911,8741,7808,535,394,141,145,85,60,253
2021,Cornwall 048,E02003912,7906,7162,417,306,111,128,74,54,199
2021,Cornwall 056,E02003913,5718,5107,312,239,73,103,58,45,196
2021,Cornwall 060,E02003914,8083,7406,337,247,90,140,71,69,200
2021,Cornwall 062,E02003915,7981,7264,325,229,96,170,71,99,222
2021,Cornwall 063,E02003916,6894,6443,275,217,58,70,38,32,106
2021,Cornwall 064,E02003917,7907,7225,373,281,92,117,52,65,192
2021,Cornwall 045,E02003918,6850,6122,343,226,117,131,59,72,254
2021,Cornwall 046,E02003919,6941,6250,294,214,80,155,66,89,242
2021,Cornwall 049,E02003920,7786,7005,386,284,102,135,58,77,260
2021,Cornwall 050,E02003921,6014,5414,296,219,77,116,57,59,188
2021,Cornwall 051,E02003922,8531,7653,412,299,113,188,98,90,278
2021,Cornwall 052,E02003923,8843,7948,390,263,127,189,85,104,316
2021,Cornwall 053,E02003924,7031,6259,311,207,104,185,73,112,276
2021,Cornwall 055,E02003925,6895,6085,341,233,108,175,85,90,294
2021,Cornwall 059,E02003926,7956,7115,448,325,123,152,76,76,241
2021,Cornwall 066,E02003927,10261,9320,506,381,125,159,71,88,276
2021,Cornwall 071,E02003928,11449,10441,484,347,137,184,95,89,340
2021,Cornwall 072,E02003929,6605,5902,389,271,118,106,60,46,208
2021,Cornwall 073,E02003930,8590,7637,490,340,150,160,83,77,303
2021,Cornwall 001,E02003931,10144,9136,464,352,112,177,87,90,367
2021,Cornwall 002,E02003932,7179,6429,390,288,102,120,57,63,240
2021,Cornwall 003,E02003933,6796,6120,312,232,80,136,73,63,228
2021,Cornwall 004,E02003934,6861,6143,356,258,98,143,88,55,219
2021,Cornwall 005,E02003935,9684,8789,379,283,96,192,71,121,324
2021,Cornwall 006,E02003936,8072,7285,392,290,102,145,81,64,250
2021,Cornwall 007,E02003937,5100,4603,271,198,73,82,41,41,144
2021,Cornwall 008,E02003938,6448,5790,319,225,94,137,75,62,202
2021,Cornwall 009,E02003939,6547,5909,335,247,88,102,51,51,201
2021,Cornwall 011,E02003940,6173,5511,331,235,96,131,69,62,200
2021,Cornwall 014,E02003941,8454,7632,367,272,95,181,84,97,274
2021,Cornwall 015,E02003942,7469,6698,300,195,105,198,89,109,273
2021,Cornwall 054,E02003943,6662,5945,322,236,86,151,83,68,244
2021,Cornwall 057,E02003944,9821,8789,463,336,127,223,94,129,346
2021,Cornwall 058,E02003945,5708,5071,324,236,88,134,65,69,179
2021,Cornwall 061,E02003946,9057,8066,497,352,145,183,88,95,311
2021,Cornwall 065,E02003947,6291,5627,350,263,87,111,56,55,203
2021,Cornwall 067,E02003948,7954,7059,361,237,124,198,112,86,336
2021,Cornwall 068,E02003949,6261,5647,295,212,83,131,71,60,188
2021,Cornwall 069,E02003950,5195,4635,278,201,77,103,52,51,179
2021,Cornwall 070,E02003951,5622,5013,304,229,75,120,61,59,185
2021,Cornwall 018,E02003952,9186,8418,331,240,91,164,76,88,273
2021,Cornwall 019,E02003953,10266,9292,425,297,128,194,88,106,355
2021,Cornwall 020,E02003954,7305,6704,319,217,102,131,57,74,151
2021,Cornwall 021,E02003955,9645,8786,375,276,99,214,104,110,270
2021,Cornwall 024,E02003956,7360,6597,289,203,86,163,84,79,311
2021,Cornwall 027,E02003957,10538,9442,490,345,145,229,112,117,377
2021,Cornwall 030,E02003958,7801,6923,364,265,99,177,97,80,337
2021,Cornwall 031,E02003959,6582,5904,313,207,106,152,83,69,213
2021,Cornwall 035,E02003960,5516,4921,305,225,80,91,45,46,199
2021,Cornwall 036,E02003961,9211,8237,498,346,152,182,99,83,294
2021,Cornwall 038,E02003962,6851,6198,315,221,94,128,65,63,210
2021,Cornwall 039,E02003963,9508,8477,456,311,145,214,110,104,361
2021,Cornwall 041,E02003964,7759,7036,364,270,94,122,57,65,237
2021,Allerdale 001,E02003965,10521,9540,492,322,170,206,105,101,283
2021,Allerdale 002,E02003966,6773,6091,402,301,101,108,52,56,172
2021,Allerdale 003,E02003967,7733,6915,385,291,94,178,95,83,255
2021,Allerdale 004,E02003968,8449,7615,365,255,110,173,94,79,296
2021,Allerdale 005,E02003969,6163,5541,222,142,80,166,68,98,234
2021,Allerdale 006,E02003970,7882,7152,406,296,110,132,68,64,192
2021,Allerdale 007,E02003971,7440,6773,373,296,77,116,48,68,178
2021,Allerdale 008,E02003972,8525,7647,429,295,134,180,87,93,269
2021,Allerdale 009,E02003973,8089,7232,312,192,120,232,89,143,313
2021,Allerdale 010,E02003974,7242,6470,350,245,105,154,68,86,268
2021,Allerdale 011,E02003975,6888,6267,324,233,91,110,53,57,187
2021,Allerdale 012,E02003976,6108,5561,315,237,78,83,38,45,149
2021,Barrow-in-Furness 001,E02003977,5909,5288,337,225,112,124,54,70,160
2021,Barrow-in-Furness 002,E02003978,5485,4974,247,166,81,91,43,48,173
2021,Barrow-in-Furness 003,E02003979,7457,6693,381,266,115,148,64,84,235
2021,Barrow-in-Furness 004,E02003980,6316,5690,227,140,87,177,87,90,222
2021,Barrow-in-Furness 005,E02003981,6107,5534,296,211,85,118,56,62,159
2021,Barrow-in-Furness 006,E02003982,7700,7001,364,247,117,126,60,66,209
2021,Barrow-in-Furness 007,E02003983,6836,6087,296,191,105,195,84,111,258
2021,Barrow-in-Furness 008,E02003984,6001,5464,219,152,67,139,47,92,179
2021,Barrow-in-Furness 009,E02003985,6367,5695,278,188,90,141,69,72,253
2021,Barrow-in-Furness 010,E02003986,5746,5163,269,184,85,134,60,74,180
2021,Carlisle 001,E02003987,5762,5171,276,198,78,122,60,62,193
2021,Carlisle 002,E02003988,6258,5688,317,233,84,107,57,50,146
2021,Carlisle 003,E02003989,7179,6509,358,276,82,109,49,60,203
2021,Carlisle 004,E02003990,10432,9519,527,409,118,148,82,66,238
2021,Carlisle 005,E02003991,7230,6482,425,300,125,135,70,65,188
2021,Carlisle 006,E02003992,7748,7200,282,223,59,120,57,63,146
2021,Carlisle 007,E02003993,8477,7696,486,357,129,131,73,58,164
2021,Carlisle 008,E02003994,6851,6294,249,168,81,133,61,72,175
2021,Carlisle 009,E02003995,9540,8667,371,253,118,203,84,119,299
2021,Carlisle 010,E02003996,8896,8211,347,240,107,148,75,73,190
2021,Carlisle 011,E02003997,8884,8144,254,156,98,198,97,101,288
2021,Carlisle 012,E02003998,6121,5562,237,152,85,131,57,74,191
2021,Carlisle 013,E02003999,11267,10283,524,373,151,187,97,90,273
2021,Copeland 001,E02004000,4935,4388,247,165,82,125,68,57,175
2021,Copeland 002,E02004001,4996,4532,203,135,68,102,43,59,159
2021,Copeland 003,E02004002,9128,8242,435,313,122,171,86,85,280
2021,Copeland 004,E02004003,11028,9925,458,309,149,268,109,159,377
2021,Copeland 005,E02004004,9184,8218,345,211,134,240,101,139,381
2021,Copeland 006,E02004005,7320,6536,346,221,125,160,59,101,278
2021,Copeland 007,E02004006,8060,7223,429,317,112,152,66,86,256
2021,Copeland 008,E02004007,9293,8406,422,290,132,174,89,85,291
2021,Eden 001,E02004008,6199,5614,293,221,72,102,54,48,190
2021,Eden 002,E02004009,5986,5378,380,286,94,97,52,45,131
2021,Eden 003,E02004010,7368,6768,308,236,72,119,58,61,173
2021,Eden 004,E02004011,10438,9545,469,360,109,166,92,74,258
2021,Eden 005,E02004012,5326,4842,304,229,75,69,35,34,111
2021,Eden 006,E02004013,9825,8908,525,399,126,165,87,78,227
2021,Eden 007,E02004014,7441,6747,390,269,121,118,57,61,186
2021,South Lakeland 001,E02004015,5976,5527,260,198,62,65,33,32,124
2021,South Lakeland 002,E02004016,7735,7115,339,241,98,103,66,37,178
2021,South Lakeland 003,E02004017,8468,7691,423,322,101,150,73,77,204
2021,South Lakeland 004,E02004018,7946,7307,368,276,92,116,61,55,155
2021,South Lakeland 005,E02004019,7393,6733,407,288,119,85,46,39,168
2021,South Lakeland 006,E02004020,8574,7865,389,306,83,118,54,64,202
2021,South Lakeland 007,E02004021,5109,4668,260,200,60,70,36,34,111
2021,South Lakeland 008,E02004022,5346,4863,287,219,68,70,37,33,126
2021,South Lakeland 009,E02004023,6114,5620,279,215,64,85,36,49,130
2021,South Lakeland 010,E02004024,7138,6410,420,312,108,111,59,52,197
2021,South Lakeland 011,E02004025,7719,6959,435,335,100,112,64,48,213
2021,South Lakeland 012,E02004026,7716,6982,386,286,100,138,64,74,210
2021,South Lakeland 013,E02004027,7709,6940,444,321,123,104,56,48,221
2021,South Lakeland 014,E02004028,7590,6866,425,310,115,109,63,46,190
2021,Amber Valley 001,E02004029,6957,6264,279,190,89,165,82,83,249
2021,Amber Valley 002,E02004030,5797,5134,364,278,86,113,56,57,186
2021,Amber Valley 003,E02004031,6967,6193,273,166,107,190,68,122,311
2021,Amber Valley 004,E02004032,8062,7128,510,387,123,177,86,91,247
2021,Amber Valley 005,E02004033,8476,7606,447,317,130,196,99,97,227
2021,Amber Valley 006,E02004034,6564,5883,383,284,99,113,57,56,185
2021,Amber Valley 007,E02004035,6172,5514,356,259,97,97,49,48,205
2021,Amber Valley 008,E02004036,9778,8668,514,385,129,223,109,114,373
2021,Amber Valley 009,E02004037,7514,6776,470,354,116,120,66,54,148
2021,Amber Valley 010,E02004038,7215,6496,398,305,93,118,56,62,203
2021,Amber Valley 011,E02004039,7416,6664,467,347,120,115,58,57,170
2021,Amber Valley 012,E02004040,8946,8032,449,321,128,178,75,103,287
2021,Amber Valley 013,E02004041,7024,6306,333,257,76,134,56,78,251
2021,Amber Valley 015,E02004043,6988,6272,384,276,108,130,73,57,202
2021,Amber Valley 016,E02004044,8716,7956,462,353,109,96,46,50,202
2021,Bolsover 001,E02004045,9331,8419,456,326,130,185,96,89,271
2021,Bolsover 002,E02004046,5916,5187,305,223,82,168,81,87,256
2021,Bolsover 003,E02004047,5745,5116,232,152,80,153,57,96,244
2021,Bolsover 004,E02004048,6603,5864,273,173,100,202,86,116,264
2021,Bolsover 005,E02004049,7596,6701,448,313,135,162,84,78,285
2021,Bolsover 006,E02004050,7338,6505,332,208,124,218,107,111,283
2021,Bolsover 007,E02004051,9195,8075,452,312,140,274,109,165,394
2021,Bolsover 008,E02004052,8241,7323,445,328,117,183,83,100,290
2021,Bolsover 009,E02004053,7452,6655,335,216,119,168,79,89,294
2021,Bolsover 010,E02004054,8751,7817,455,311,144,203,111,92,276
2021,Chesterfield 001,E02004055,6599,5820,367,272,95,158,79,79,254
2021,Chesterfield 002,E02004056,7547,6706,312,223,89,205,74,131,324
2021,Chesterfield 003,E02004057,7317,6608,318,233,85,169,78,91,222
2021,Chesterfield 004,E02004058,7564,6724,317,207,110,206,87,119,317
2021,Chesterfield 005,E02004059,6902,6132,395,283,112,139,61,78,236
2021,Chesterfield 006,E02004060,7183,6321,354,240,114,156,73,83,352
2021,Chesterfield 007,E02004061,7035,6304,365,270,95,152,60,92,214
2021,Chesterfield 008,E02004062,7279,6437,438,317,121,166,69,97,238
2021,Chesterfield 009,E02004063,7418,6577,484,372,112,141,76,65,216
2021,Chesterfield 010,E02004064,9086,8254,378,268,110,190,90,100,264
2021,Chesterfield 011,E02004065,7781,6950,482,353,129,126,69,57,223
2021,Chesterfield 012,E02004066,10861,9720,588,414,174,224,110,114,329
2021,Chesterfield 013,E02004067,5920,5224,263,172,91,163,62,101,270
2021,Derbyshire Dales 001,E02004068,7002,6296,433,332,101,99,53,46,174
2021,Derbyshire Dales 002,E02004069,6133,5500,381,284,97,92,51,41,160
2021,Derbyshire Dales 005,E02004072,9036,8082,548,417,131,165,85,80,241
2021,Derbyshire Dales 006,E02004073,8478,7585,501,375,126,146,65,81,246
2021,Derbyshire Dales 007,E02004074,5616,4998,351,269,82,99,47,52,168
2021,Derbyshire Dales 008,E02004075,6883,6202,432,312,120,95,53,42,154
2021,Derbyshire Dales 009,E02004076,7111,6482,339,259,80,87,44,43,203
2021,Derbyshire Dales 010,E02004077,7984,7298,445,347,98,100,44,56,141
2021,Erewash 001,E02004078,6612,5840,264,172,92,194,66,128,314
2021,Erewash 003,E02004080,9178,8369,340,246,94,183,89,94,286
2021,Erewash 004,E02004081,5603,4937,362,269,93,98,41,57,206
2021,Erewash 005,E02004082,5872,5295,355,290,65,80,44,36,142
2021,Erewash 006,E02004083,7805,7051,353,263,90,155,73,82,246
2021,Erewash 007,E02004084,5656,5031,266,172,94,130,59,71,229
2021,Erewash 008,E02004085,8464,7595,445,343,102,173,82,91,251
2021,Erewash 009,E02004086,6868,6119,399,304,95,132,70,62,218
2021,Erewash 010,E02004087,7326,6651,336,221,115,139,59,80,200
2021,Erewash 011,E02004088,7316,6603,436,326,110,108,55,53,169
2021,Erewash 012,E02004089,6440,5879,272,208,64,124,61,63,165
2021,Erewash 013,E02004090,5729,5150,303,215,88,106,40,66,170
2021,Erewash 014,E02004091,8846,8004,460,350,110,154,77,77,228
2021,Erewash 015,E02004092,8932,8066,415,305,110,171,81,90,280
2021,High Peak 001,E02004093,6032,5458,319,240,79,90,50,40,165
2021,High Peak 002,E02004094,6641,6001,276,197,79,161,80,81,203
2021,High Peak 003,E02004095,9654,8746,501,369,132,169,75,94,238
2021,High Peak 004,E02004096,9329,8452,525,390,135,128,58,70,224
2021,High Peak 005,E02004097,7141,6421,467,365,102,91,47,44,162
2021,High Peak 006,E02004098,7001,6363,317,234,83,121,64,57,200
2021,High Peak 008,E02004100,7793,7103,433,329,104,86,51,35,171
2021,High Peak 010,E02004102,7367,6708,366,278,88,121,58,63,172
2021,High Peak 011,E02004103,6453,5869,267,183,84,130,56,74,187
2021,High Peak 012,E02004104,6920,6319,327,255,72,116,53,63,158
2021,North East Derbyshire 001,E02004105,8746,7841,401,293,108,196,91,105,308
2021,North East Derbyshire 002,E02004106,6552,5817,413,296,117,109,49,60,213
2021,North East Derbyshire 004,E02004108,7253,6458,417,296,121,133,70,63,245
2021,North East Derbyshire 005,E02004109,6474,5803,416,303,113,89,43,46,166
2021,North East Derbyshire 006,E02004110,7030,6344,413,319,94,96,44,52,177
2021,North East Derbyshire 007,E02004111,5313,4656,312,232,80,132,60,72,213
2021,North East Derbyshire 008,E02004112,6102,5383,402,292,110,123,67,56,194
2021,North East Derbyshire 009,E02004113,9578,8453,408,279,129,280,115,165,437
2021,North East Derbyshire 010,E02004114,8101,7221,475,346,129,130,71,59,275
2021,North East Derbyshire 011,E02004115,8459,7500,515,346,169,171,79,92,273
2021,North East Derbyshire 012,E02004116,8069,7207,354,246,108,182,88,94,326
2021,North East Derbyshire 013,E02004117,7649,6813,392,267,125,166,78,88,278
2021,South Derbyshire 001,E02004118,7314,6733,317,236,81,102,56,46,162
2021,South Derbyshire 002,E02004119,11251,10317,541,422,119,166,90,76,227
2021,South Derbyshire 003,E02004120,10197,9381,431,323,108,180,84,96,205
2021,South Derbyshire 004,E02004121,8725,7930,472,368,104,134,74,60,189
2021,South Derbyshire 005,E02004122,6664,6100,359,266,93,101,60,41,104
2021,South Derbyshire 006,E02004123,6510,5907,367,289,78,87,44,43,149
2021,South Derbyshire 007,E02004124,7172,6443,331,226,105,141,68,73,257
2021,South Derbyshire 008,E02004125,8278,7434,360,249,111,194,90,104,290
2021,South Derbyshire 009,E02004126,7067,6342,327,235,92,144,69,75,254
2021,South Derbyshire 011,E02004128,10906,9756,554,399,155,210,104,106,386
2021,East Devon 001,E02004129,5827,5262,309,240,69,110,56,54,146
2021,East Devon 002,E02004130,5908,5292,270,199,71,125,57,68,221
2021,East Devon 003,E02004131,5235,4725,271,200,71,91,44,47,148
2021,East Devon 004,E02004132,8518,7709,457,366,91,127,62,65,225
2021,East Devon 005,E02004133,9333,8497,414,317,97,157,76,81,265
2021,East Devon 007,E02004135,8124,7320,462,325,137,121,58,63,221
2021,East Devon 008,E02004136,9080,8228,463,339,124,123,57,66,266
2021,East Devon 009,E02004137,5166,4651,303,226,77,84,40,44,128
2021,East Devon 010,E02004138,7477,6645,399,297,102,137,75,62,296
2021,East Devon 011,E02004139,6733,6013,356,259,97,135,70,65,229
2021,East Devon 012,E02004140,5158,4589,317,243,74,89,45,44,163
2021,East Devon 013,E02004141,6004,5398,364,268,96,78,40,38,164
2021,East Devon 014,E02004142,6126,5595,327,258,69,72,38,34,132
2021,East Devon 015,E02004143,6083,5440,322,238,84,107,48,59,214
2021,East Devon 016,E02004144,6627,5934,357,274,83,128,63,65,208
2021,East Devon 017,E02004145,5956,5348,332,255,77,102,50,52,174
2021,East Devon 018,E02004146,7178,6436,316,219,97,169,95,74,257
2021,East Devon 019,E02004147,6694,6075,344,248,96,119,58,61,156
2021,East Devon 020,E02004148,7546,6747,380,286,94,156,79,77,263
2021,Exeter 001,E02004149,10833,10158,432,351,81,86,52,34,157
2021,Exeter 002,E02004150,6717,6182,257,185,72,108,44,64,170
2021,Exeter 003,E02004151,9446,8471,495,360,135,199,88,111,281
2021,Exeter 004,E02004152,9551,9150,245,217,28,87,47,40,69
2021,Exeter 005,E02004153,7077,6433,334,248,86,128,54,74,182
2021,Exeter 006,E02004154,7886,7367,312,251,61,90,47,43,117
2021,Exeter 007,E02004155,7022,6327,331,234,97,136,72,64,228
2021,Exeter 008,E02004156,11312,10741,337,250,87,105,48,57,129
2021,Exeter 009,E02004157,6079,5608,325,263,62,54,25,29,92
2021,Exeter 010,E02004158,7650,6970,353,253,100,140,63,77,187
2021,Exeter 011,E02004159,11981,10986,572,441,131,186,87,99,237
2021,Exeter 012,E02004160,6846,6186,308,228,80,148,79,69,204
2021,Exeter 013,E02004161,7924,7125,359,257,102,184,85,99,256
2021,Exeter 014,E02004162,6638,6076,317,232,85,94,48,46,151
2021,Exeter 015,E02004163,7865,7067,399,302,97,140,68,72,259
2021,Mid Devon 001,E02004164,6525,5919,333,250,83,112,56,56,161
2021,Mid Devon 002,E02004165,8490,7653,443,337,106,131,65,66,263
2021,Mid Devon 003,E02004166,6493,5885,342,247,95,94,45,49,172
2021,Mid Devon 004,E02004167,6807,6161,299,212,87,136,68,68,211
2021,Mid Devon 005,E02004168,5900,5373,231,168,63,122,60,62,174
2021,Mid Devon 006,E02004169,7213,6518,368,276,92,126,57,69,201
2021,Mid Devon 007,E02004170,8267,7504,363,264,99,167,82,85,233
2021,Mid Devon 008,E02004171,8095,7309,456,366,90,148,73,75,182
2021,Mid Devon 009,E02004172,6242,5569,374,276,98,127,56,71,172
2021,Mid Devon 010,E02004173,7170,6472,408,310,98,97,54,43,193
2021,Mid Devon 011,E02004174,7629,6965,372,285,87,121,56,65,171
2021,North Devon 001,E02004175,4943,4493,213,144,69,86,42,44,151
2021,North Devon 002,E02004176,5400,4903,230,164,66,93,48,45,174
2021,North Devon 003,E02004177,5651,5130,228,162,66,107,51,56,186
2021,North Devon 004,E02004178,5078,4598,273,190,83,64,35,29,143
2021,North Devon 005,E02004179,8788,8010,415,325,90,140,69,71,223
2021,North Devon 006,E02004180,6239,5625,337,254,83,100,50,50,177
2021,North Devon 007,E02004181,5467,4970,231,169,62,96,36,60,170
2021,North Devon 008,E02004182,5931,5407,243,162,81,121,52,69,160
2021,North Devon 009,E02004183,5621,5053,264,190,74,103,48,55,201
2021,North Devon 010,E02004184,8070,7331,339,240,99,145,58,87,255
2021,North Devon 011,E02004185,6375,5702,324,245,79,130,67,63,219
2021,North Devon 012,E02004186,9534,8638,496,360,136,158,71,87,242
2021,North Devon 013,E02004187,10215,9172,518,371,147,196,96,100,329
2021,North Devon 014,E02004188,6782,6099,347,273,74,122,63,59,214
2021,South Hams 001,E02004189,5855,5312,296,229,67,109,53,56,138
2021,South Hams 002,E02004190,8342,7424,531,400,131,152,75,77,235
2021,South Hams 003,E02004191,8658,7704,554,414,140,150,80,70,250
2021,South Hams 004,E02004192,7453,6643,491,372,119,130,73,57,189
2021,South Hams 005,E02004193,11382,10297,598,455,143,196,92,104,291
2021,South Hams 006,E02004194,7020,6376,391,302,89,97,56,41,156
2021,South Hams 007,E02004195,5081,4614,216,152,64,92,49,43,159
2021,South Hams 008,E02004196,7777,7014,408,310,98,151,74,77,204
2021,South Hams 009,E02004197,6950,6193,407,309,98,138,79,59,212
2021,South Hams 010,E02004198,6066,5485,335,251,84,100,44,56,146
2021,South Hams 011,E02004199,5579,4998,313,238,75,95,42,53,173
2021,South Hams 012,E02004200,4933,4459,265,193,72,69,30,39,140
2021,Teignbridge 001,E02004201,5288,4727,314,236,78,90,48,42,157
2021,Teignbridge 002,E02004202,8267,7446,466,369,97,122,60,62,233
2021,Teignbridge 003,E02004203,5558,4990,355,281,74,71,31,40,142
2021,Teignbridge 004,E02004204,9377,8394,543,421,122,139,73,66,301
2021,Teignbridge 005,E02004205,8201,7350,416,316,100,168,79,89,267
2021,Teignbridge 006,E02004206,6480,5746,363,275,88,138,75,63,233
2021,Teignbridge 007,E02004207,6403,5719,353,272,81,121,57,64,210
2021,Teignbridge 008,E02004208,8044,7247,446,332,114,124,65,59,227
2021,Teignbridge 009,E02004209,8745,7806,486,369,117,160,77,83,293
2021,Teignbridge 010,E02004210,6308,5715,264,183,81,140,65,75,189
2021,Teignbridge 011,E02004211,6402,5721,381,280,101,110,59,51,190
2021,Teignbridge 012,E02004212,5880,5322,272,196,76,115,59,56,171
2021,Teignbridge 013,E02004213,8589,7868,377,283,94,168,78,90,176
2021,Teignbridge 014,E02004214,5726,5223,229,144,85,103,44,59,171
2021,Teignbridge 015,E02004215,5559,5019,265,210,55,111,46,65,164
2021,Teignbridge 016,E02004216,5336,4710,291,206,85,127,64,63,208
2021,Teignbridge 017,E02004217,7446,6670,397,273,124,149,79,70,230
2021,Teignbridge 018,E02004218,5883,5215,324,232,92,136,69,67,208
2021,Teignbridge 019,E02004219,5409,4788,364,274,90,90,42,48,167
2021,Torridge 001,E02004220,5799,5202,268,195,73,108,53,55,221
2021,Torridge 002,E02004221,6185,5487,359,280,79,112,61,51,227
2021,Torridge 003,E02004222,5519,4977,254,177,77,120,55,65,168
2021,Torridge 004,E02004223,12267,11084,543,393,150,242,105,137,398
2021,Torridge 005,E02004224,6220,5589,345,263,82,109,58,51,177
2021,Torridge 006,E02004225,5522,4987,291,222,69,101,46,55,143
2021,Torridge 007,E02004226,7060,6330,364,268,96,126,62,64,240
2021,Torridge 008,E02004227,9710,8766,422,309,113,192,90,102,330
2021,Torridge 009,E02004228,7027,6261,376,271,105,136,72,64,254
2021,West Devon 001,E02004229,9480,8441,529,387,142,192,105,87,318
2021,West Devon 002,E02004230,7383,6656,368,272,96,118,53,65,241
2021,West Devon 003,E02004231,6844,6133,408,314,94,114,62,52,189
2021,West Devon 004,E02004232,6649,5961,417,307,110,102,48,54,169
2021,West Devon 005,E02004233,12190,10996,614,464,150,204,111,93,376
2021,West Devon 006,E02004234,6037,5391,369,273,96,99,55,44,178
2021,West Devon 007,E02004235,6322,5645,339,255,84,129,61,68,209
2021,"Bournemouth, Christchurch and Poole 002",E02004236,5973,5363,325,260,65,97,52,45,188
2021,"Bournemouth, Christchurch and Poole 014",E02004237,7825,7089,400,307,93,120,62,58,216
2021,"Bournemouth, Christchurch and Poole 019",E02004238,7301,6516,427,301,126,102,50,52,256
2021,"Bournemouth, Christchurch and Poole 018",E02004239,6018,5448,296,225,71,83,45,38,191
2021,"Bournemouth, Christchurch and Poole 024",E02004240,5764,5132,277,206,71,130,56,74,225
2021,"Bournemouth, Christchurch and Poole 031",E02004241,9070,8279,432,330,102,129,72,57,230
2021,"Bournemouth, Christchurch and Poole 033",E02004242,6276,5641,341,249,92,115,68,47,179
2021,Dorset 007,E02004243,6191,5584,349,261,88,100,53,47,158
2021,Dorset 010,E02004244,7331,6663,371,300,71,102,58,44,195
2021,Dorset 012,E02004245,7152,6461,350,249,101,120,51,69,221
2021,Dorset 015,E02004246,7631,6896,418,317,101,100,51,49,217
2021,Dorset 013,E02004247,5888,5278,379,310,69,91,41,50,140
2021,Dorset 016,E02004248,7161,6382,379,266,113,125,72,53,275
2021,Dorset 017,E02004249,5723,5220,289,223,66,79,47,32,135
2021,Dorset 018,E02004250,7518,6684,407,287,120,150,79,71,277
2021,Dorset 020,E02004251,6040,5377,386,292,94,87,46,41,190
2021,Dorset 021,E02004252,7583,6886,385,291,94,114,53,61,198
2021,Dorset 024,E02004253,9492,8477,582,435,147,152,81,71,281
2021,Dorset 025,E02004254,9901,8936,539,418,121,168,64,104,258
2021,Dorset 001,E02004255,7047,6399,332,246,86,104,59,45,212
2021,Dorset 002,E02004256,8828,8044,449,335,114,124,61,63,211
2021,Dorset 003,E02004257,8669,7945,387,291,96,131,54,77,206
2021,Dorset 005,E02004258,10058,9112,496,378,118,154,67,87,296
2021,Dorset 006,E02004259,6958,6298,353,276,77,91,45,46,216
2021,Dorset 009,E02004260,8631,7939,380,295,85,119,59,60,193
2021,Dorset 011,E02004261,9844,8992,442,340,102,170,93,77,240
2021,Dorset 014,E02004262,7622,6881,412,324,88,123,67,56,206
2021,Dorset 027,E02004263,5573,5049,302,221,81,81,40,41,141
2021,Dorset 028,E02004264,8258,7451,418,312,106,149,69,80,240
2021,Dorset 033,E02004265,8139,7333,427,309,118,145,69,76,234
2021,Dorset 035,E02004266,7923,7153,384,284,100,151,80,71,235
2021,Dorset 039,E02004267,4919,4352,351,264,87,78,36,42,138
2021,Dorset 042,E02004268,9113,8178,461,355,106,180,88,92,294
2021,Dorset 004,E02004269,9975,9169,428,313,115,139,65,74,239
2021,Dorset 008,E02004270,7535,6822,401,310,91,100,53,47,212
2021,Dorset 019,E02004271,9707,8738,496,369,127,159,82,77,314
2021,Dorset 022,E02004272,11717,10588,632,495,137,195,109,86,302
2021,Dorset 023,E02004273,7002,6329,367,271,96,103,63,40,203
2021,Dorset 026,E02004274,6179,5593,292,203,89,104,49,55,190
2021,Dorset 029,E02004275,7407,6656,407,310,97,125,66,59,219
2021,Dorset 030,E02004276,5354,4818,292,214,78,86,49,37,158
2021,Dorset 034,E02004278,8440,7599,502,374,128,117,61,56,222
2021,Dorset 036,E02004279,7721,6990,409,282,127,111,57,54,211
2021,Dorset 037,E02004280,8036,7216,424,301,123,160,73,87,236
2021,Dorset 038,E02004281,7248,6450,378,271,107,156,67,89,264
2021,Dorset 040,E02004282,8606,7699,484,367,117,167,89,78,256
2021,Dorset 041,E02004283,8705,7761,468,332,136,180,87,93,296
2021,Dorset 044,E02004284,9174,8349,379,263,116,180,78,102,266
2021,Dorset 043,E02004285,7366,6672,320,231,89,138,72,66,236
2021,Dorset 045,E02004286,4850,4373,249,186,63,88,41,47,140
2021,Dorset 046,E02004287,5384,4831,283,205,78,117,45,72,153
2021,Dorset 047,E02004288,5941,5355,259,170,89,120,60,60,207
2021,Dorset 048,E02004289,6988,6210,330,226,104,160,73,87,288
2021,County Durham 002,E02004290,5499,4934,293,213,80,98,42,56,174
2021,County Durham 005,E02004291,6738,6019,312,207,105,164,61,103,243
2021,County Durham 007,E02004292,7628,6850,378,279,99,147,69,78,253
2021,County Durham 011,E02004293,9087,8131,384,255,129,238,89,149,334
2021,County Durham 013,E02004294,7646,6763,505,373,132,160,91,69,218
2021,County Durham 015,E02004295,6985,6201,379,256,123,159,74,85,246
2021,County Durham 019,E02004296,7976,7130,374,274,100,206,99,107,266
2021,County Durham 001,E02004297,7584,6816,412,307,105,138,62,76,218
2021,County Durham 003,E02004298,9507,8478,499,374,125,193,89,104,337
2021,County Durham 004,E02004299,7852,7030,338,221,117,182,71,111,302
2021,County Durham 006,E02004300,7297,6455,302,207,95,185,86,99,355
2021,County Durham 008,E02004301,9090,8080,341,232,109,254,106,148,415
2021,County Durham 009,E02004302,7408,6564,302,176,126,240,101,139,302
2021,County Durham 010,E02004303,10565,9432,524,385,139,280,102,178,329
2021,County Durham 012,E02004304,8547,7682,364,241,123,183,66,117,318
2021,County Durham 014,E02004305,9572,8624,389,240,149,221,95,126,338
2021,County Durham 020,E02004306,5718,5050,318,240,78,115,47,68,235
2021,County Durham 024,E02004307,6133,5489,320,229,91,115,43,72,209
2021,County Durham 022,E02004308,7483,6777,402,309,93,107,59,48,197
2021,County Durham 023,E02004309,5907,5289,284,201,83,154,66,88,180
2021,County Durham 026,E02004310,7399,6526,370,254,116,195,85,110,308
2021,County Durham 027,E02004311,8693,7709,448,317,131,217,94,123,319
2021,County Durham 028,E02004312,7126,6372,394,298,96,113,68,45,247
2021,County Durham 029,E02004313,6441,5915,194,131,63,128,45,83,204
2021,County Durham 030,E02004314,12608,12171,294,249,45,60,22,38,83
2021,County Durham 033,E02004315,12742,11807,583,432,151,149,74,75,203
2021,County Durham 031,E02004316,6150,5453,256,175,81,185,99,86,256
2021,County Durham 038,E02004317,7008,6255,325,223,102,157,71,86,271
2021,County Durham 041,E02004318,6242,5640,286,216,70,112,45,67,204
2021,County Durham 044,E02004319,7560,6783,347,242,105,174,79,95,256
2021,County Durham 016,E02004320,8188,7288,419,279,140,209,89,120,272
2021,County Durham 017,E02004321,7749,6939,283,199,84,236,117,119,291
2021,County Durham 018,E02004322,8137,7166,266,157,109,238,108,130,467
2021,County Durham 021,E02004323,7009,6248,304,216,88,190,79,111,267
2021,County Durham 025,E02004324,5476,4877,233,154,79,159,67,92,207
2021,County Durham 032,E02004325,8424,7464,284,166,118,301,116,185,375
2021,County Durham 034,E02004326,6370,5651,237,156,81,206,86,120,276
2021,County Durham 036,E02004327,5279,4649,193,126,67,170,65,105,267
2021,County Durham 035,E02004328,6793,6007,271,186,85,222,84,138,293
2021,County Durham 037,E02004329,6210,5451,304,201,103,172,80,92,283
2021,County Durham 039,E02004330,5677,4998,248,146,102,167,57,110,264
2021,County Durham 040,E02004331,6785,6018,257,162,95,208,91,117,302
2021,County Durham 043,E02004332,6987,6171,321,200,121,195,76,119,300
2021,County Durham 047,E02004333,6435,5696,352,252,100,132,59,73,255
2021,County Durham 048,E02004334,6675,5968,292,196,96,175,70,105,240
2021,County Durham 049,E02004335,7263,6523,283,180,103,191,72,119,266
2021,County Durham 050,E02004336,6379,5603,280,194,86,176,81,95,320
2021,County Durham 052,E02004337,9986,8917,432,301,131,236,104,132,401
2021,County Durham 053,E02004338,6956,6242,267,174,93,173,67,106,274
2021,County Durham 054,E02004339,6769,6087,377,273,104,119,51,68,186
2021,County Durham 059,E02004340,9838,8715,408,265,143,290,113,177,425
2021,County Durham 060,E02004341,8341,7412,467,335,132,178,76,102,284
2021,County Durham 061,E02004342,5203,4670,155,101,54,140,46,94,238
2021,County Durham 062,E02004343,5268,4695,245,160,85,126,49,77,202
2021,County Durham 063,E02004344,6645,5812,344,244,100,166,68,98,323
2021,County Durham 064,E02004345,12085,10751,626,450,176,291,140,151,417
2021,County Durham 042,E02004348,7599,6789,390,285,105,159,75,84,261
2021,County Durham 045,E02004349,8772,7790,340,236,104,237,87,150,405
2021,County Durham 046,E02004350,9335,8371,433,299,134,214,80,134,317
2021,County Durham 051,E02004351,6871,6043,300,189,111,212,87,125,316
2021,County Durham 055,E02004352,7706,6918,341,227,114,173,69,104,274
2021,County Durham 056,E02004353,6915,6164,378,250,128,157,65,92,216
2021,County Durham 057,E02004354,8616,7674,355,229,126,220,98,122,367
2021,County Durham 058,E02004355,6646,5879,233,145,88,221,81,140,313
2021,Eastbourne 001,E02004356,6998,6154,323,239,84,194,82,112,327
2021,Eastbourne 002,E02004357,7227,6414,315,220,95,189,85,104,309
2021,Eastbourne 003,E02004358,7599,6805,318,230,88,180,85,95,296
2021,Eastbourne 004,E02004359,7435,6577,386,279,107,181,76,105,291
2021,Eastbourne 006,E02004361,7806,7033,393,303,90,132,66,66,248
2021,Eastbourne 007,E02004362,8343,7552,429,312,117,153,68,85,209
2021,Eastbourne 008,E02004363,6654,6082,272,199,73,126,53,73,174
2021,Eastbourne 009,E02004364,7880,7160,413,316,97,122,70,52,185
2021,Eastbourne 010,E02004365,7907,7281,258,177,81,158,57,101,210
2021,Eastbourne 011,E02004366,7364,6831,246,183,63,111,47,64,176
2021,Eastbourne 012,E02004367,6586,5972,317,235,82,96,56,40,201
2021,Hastings 001,E02004368,7854,7083,382,269,113,163,74,89,226
2021,Hastings 002,E02004369,9679,8683,482,356,126,191,101,90,323
2021,Hastings 003,E02004370,7557,6648,308,215,93,222,100,122,379
2021,Hastings 004,E02004371,6641,5947,305,236,69,158,60,98,231
2021,Hastings 005,E02004372,6617,5901,244,169,75,182,62,120,290
2021,Hastings 006,E02004373,8310,7477,359,255,104,182,70,112,292
2021,Hastings 007,E02004374,6979,6266,352,264,88,147,65,82,214
2021,Hastings 008,E02004375,7986,7214,415,317,98,159,80,79,198
2021,Hastings 009,E02004376,6551,5974,281,207,74,150,50,100,146
2021,Hastings 010,E02004377,10219,9197,446,326,120,210,104,106,366
2021,Hastings 011,E02004378,7786,7119,312,222,90,179,73,106,176
2021,Lewes 001,E02004379,7306,6640,403,319,84,98,55,43,165
2021,Lewes 002,E02004380,9239,8387,514,409,105,109,63,46,229
2021,Lewes 003,E02004381,8971,8078,564,442,122,135,73,62,194
2021,Lewes 004,E02004382,6239,5544,398,274,124,102,39,63,195
2021,Lewes 005,E02004383,7051,6448,406,321,85,83,38,45,114
2021,Lewes 006,E02004384,7073,6302,422,323,99,124,57,67,225
2021,Lewes 007,E02004385,7273,6510,348,245,103,143,74,69,272
2021,Lewes 008,E02004386,6239,5601,315,229,86,111,52,59,212
2021,Lewes 009,E02004387,5653,5114,231,181,50,127,60,67,181
2021,Lewes 010,E02004388,7365,6555,342,226,116,164,91,73,304
2021,Lewes 011,E02004389,8986,7932,578,420,158,175,99,76,301
2021,Lewes 012,E02004390,7730,6844,446,335,111,142,71,71,298
2021,Lewes 013,E02004391,6236,5603,351,263,88,120,67,53,162
2021,Rother 001,E02004392,8803,7929,483,383,100,165,87,78,226
2021,Rother 002,E02004393,6140,5517,277,201,76,112,59,53,234
2021,Rother 003,E02004394,7598,6851,460,361,99,98,50,48,189
2021,Rother 004,E02004395,7338,6550,378,293,85,137,61,76,273
2021,Rother 005,E02004396,8925,7971,501,382,119,154,67,87,299
2021,Rother 006,E02004397,7796,7050,407,310,97,134,64,70,205
2021,Rother 007,E02004398,8759,7811,391,265,126,211,98,113,346
2021,Rother 008,E02004399,7710,6812,379,270,109,177,91,86,342
2021,Rother 009,E02004400,10242,9111,581,421,160,204,102,102,346
2021,Rother 010,E02004401,7509,6709,398,292,106,145,77,68,257
2021,Rother 011,E02004402,8570,7738,389,274,115,182,89,93,261
2021,Wealden 001,E02004403,6159,5637,323,253,70,90,42,48,109
2021,Wealden 002,E02004404,6150,5620,345,258,87,74,39,35,111
2021,Wealden 003,E02004405,5749,5266,262,195,67,82,34,48,139
2021,Wealden 004,E02004406,7028,6440,346,277,69,83,49,34,159
2021,Wealden 005,E02004407,7803,7165,428,331,97,86,47,39,124
2021,Wealden 006,E02004408,7923,7269,369,278,91,115,59,56,170
2021,Wealden 007,E02004409,5160,4651,331,252,79,61,28,33,117
2021,Wealden 008,E02004410,7721,7009,447,359,88,93,39,54,172
2021,Wealden 009,E02004411,8107,7419,381,291,90,132,67,65,175
2021,Wealden 010,E02004412,7688,7091,355,271,84,109,61,48,133
2021,Wealden 011,E02004413,7019,6301,424,333,91,118,66,52,176
2021,Wealden 012,E02004414,6183,5683,287,217,70,88,46,42,125
2021,Wealden 013,E02004415,6447,5857,338,273,65,102,55,47,150
2021,Wealden 014,E02004416,6232,5648,344,275,69,88,49,39,152
2021,Wealden 015,E02004417,6205,5623,309,236,73,96,48,48,177
2021,Wealden 016,E02004418,5484,4950,246,189,57,113,54,59,175
2021,Wealden 017,E02004419,5960,5264,301,222,79,151,63,88,244
2021,Wealden 018,E02004420,13259,12036,669,501,168,224,108,116,330
2021,Wealden 019,E02004421,8852,7959,455,318,137,155,86,69,283
2021,Wealden 020,E02004422,10562,9424,549,408,141,220,114,106,369
2021,Wealden 021,E02004423,7280,6471,425,321,104,129,79,50,255
2021,Basildon 001,E02004424,6731,6201,325,248,77,75,29,46,130
2021,Basildon 002,E02004425,6908,6372,313,238,75,83,49,34,140
2021,Basildon 003,E02004426,7638,6972,418,341,77,95,51,44,153
2021,Basildon 004,E02004427,7633,7000,374,281,93,92,47,45,167
2021,Basildon 005,E02004428,6609,6001,295,224,71,124,53,71,189
2021,Basildon 006,E02004429,7252,6513,381,270,111,122,74,48,236
2021,Basildon 007,E02004430,7981,7252,366,263,103,144,78,66,219
2021,Basildon 008,E02004431,9043,8302,421,320,101,122,63,59,198
2021,Basildon 009,E02004432,6141,5577,296,232,64,109,53,56,159
2021,Basildon 010,E02004433,8200,7428,341,251,90,168,73,95,263
2021,Basildon 011,E02004434,8030,7309,301,220,81,173,83,90,247
2021,Basildon 012,E02004435,9036,8204,356,257,99,204,87,117,272
2021,Basildon 013,E02004436,7345,6581,260,168,92,201,83,118,303
2021,Basildon 014,E02004437,9357,8522,384,262,122,173,77,96,278
2021,Basildon 015,E02004438,8799,8126,290,203,87,156,59,97,227
2021,Basildon 016,E02004439,9002,8231,276,185,91,185,76,109,310
2021,Basildon 017,E02004440,8511,7848,286,206,80,155,60,95,222
2021,Basildon 018,E02004441,7334,6661,255,149,106,162,75,87,256
2021,Basildon 019,E02004442,8003,7220,290,188,102,171,75,96,322
2021,Basildon 020,E02004443,9584,8867,344,253,91,160,69,91,213
2021,Basildon 021,E02004444,8482,7737,428,302,126,115,58,57,202
2021,Basildon 022,E02004445,7755,7007,334,224,110,151,75,76,263
2021,Braintree 001,E02004446,6746,6128,350,284,66,90,50,40,178
2021,Braintree 002,E02004447,5741,5203,310,251,59,78,51,27,150
2021,Braintree 003,E02004448,7373,6706,345,256,89,128,61,67,194
2021,Braintree 004,E02004449,8379,7688,300,243,57,156,68,88,235
2021,Braintree 005,E02004450,6024,5439,332,237,95,105,57,48,148
2021,Braintree 006,E02004451,9033,8264,403,311,92,145,68,77,221
2021,Braintree 007,E02004452,8885,8162,367,290,77,153,65,88,203
2021,Braintree 008,E02004453,6949,6293,270,188,82,144,80,64,242
2021,Braintree 009,E02004454,8855,8232,335,248,87,124,48,76,164
2021,Braintree 010,E02004455,7531,6899,341,253,88,98,53,45,193
2021,Braintree 011,E02004456,9209,8371,388,271,117,193,83,110,257
2021,Braintree 012,E02004457,9958,9089,416,302,114,170,83,87,283
2021,Braintree 013,E02004458,9082,8373,429,335,94,105,45,60,175
2021,Braintree 014,E02004459,9922,8986,527,396,131,150,70,80,259
2021,Braintree 015,E02004460,9149,8310,398,297,101,148,69,79,293
2021,Braintree 016,E02004461,5380,4899,215,146,69,89,41,48,177
2021,Braintree 017,E02004462,10868,10096,391,291,100,155,67,88,226
2021,Braintree 018,E02004463,7731,7024,373,274,99,136,69,67,198
2021,Brentwood 001,E02004464,9442,8577,461,322,139,136,60,76,268
2021,Brentwood 002,E02004465,6045,5528,289,224,65,96,45,51,132
2021,Brentwood 003,E02004466,7758,7093,371,296,75,116,53,63,178
2021,Brentwood 004,E02004467,7690,7079,323,246,77,118,58,60,170
2021,Brentwood 005,E02004468,10099,9215,580,456,124,107,55,52,197
2021,Brentwood 006,E02004469,6844,6266,324,236,88,99,54,45,155
2021,Brentwood 007,E02004470,11007,10347,393,306,87,115,57,58,152
2021,Brentwood 008,E02004471,8011,7312,393,284,109,121,50,71,185
2021,Brentwood 009,E02004472,5878,5353,331,249,82,69,31,38,125
2021,Castle Point 001,E02004473,7401,6726,335,237,98,141,80,61,199
2021,Castle Point 002,E02004474,7575,6871,364,275,89,136,60,76,204
2021,Castle Point 003,E02004475,6318,5741,296,223,73,104,53,51,177
2021,Castle Point 004,E02004476,7707,7010,394,274,120,130,64,66,173
2021,Castle Point 005,E02004477,5772,5226,301,230,71,97,60,37,148
2021,Castle Point 006,E02004478,6369,5797,289,211,78,103,51,52,180
2021,Castle Point 007,E02004479,7666,6924,399,291,108,149,77,72,194
2021,Castle Point 008,E02004480,6564,5985,306,223,83,119,41,78,154
2021,Castle Point 009,E02004481,6400,5730,266,172,94,128,57,71,276
2021,Castle Point 010,E02004482,7876,7071,272,192,80,220,94,126,313
2021,Castle Point 011,E02004483,7635,6887,304,189,115,142,80,62,302
2021,Castle Point 012,E02004484,7989,7177,342,231,111,176,90,86,294
2021,Chelmsford 001,E02004485,9155,8398,403,305,98,137,68,69,217
2021,Chelmsford 002,E02004486,8189,7476,391,309,82,125,71,54,197
2021,Chelmsford 003,E02004487,7166,6588,302,227,75,105,45,60,171
2021,Chelmsford 004,E02004488,9327,8662,370,283,87,121,49,72,174
2021,Chelmsford 005,E02004489,9026,8332,421,331,90,109,53,56,164
2021,Chelmsford 006,E02004490,7451,6850,267,185,82,132,63,69,202
2021,Chelmsford 007,E02004491,7096,6529,334,263,71,106,53,53,127
2021,Chelmsford 008,E02004492,8850,8193,378,298,80,109,47,62,170
2021,Chelmsford 009,E02004493,9766,8950,426,319,107,164,66,98,226
2021,Chelmsford 011,E02004495,7919,7192,406,299,107,105,50,55,216
2021,Chelmsford 012,E02004496,7782,7230,330,267,63,65,30,35,157
2021,Chelmsford 013,E02004497,7486,6799,381,291,90,123,62,61,183
2021,Chelmsford 014,E02004498,9337,8558,404,306,98,125,46,79,250
2021,Chelmsford 015,E02004499,6489,5993,299,233,66,77,43,34,120
2021,Chelmsford 016,E02004500,8847,8081,437,338,99,138,84,54,191
2021,Chelmsford 017,E02004501,6663,6082,342,261,81,85,46,39,154
2021,Chelmsford 018,E02004502,6968,6359,370,283,87,91,48,43,148
2021,Chelmsford 019,E02004503,7593,7029,321,244,77,101,45,56,142
2021,Chelmsford 020,E02004504,7555,6977,324,252,72,112,57,55,142
2021,Chelmsford 021,E02004505,6128,5537,297,223,74,111,61,50,183
2021,Colchester 001,E02004506,6815,6233,347,274,73,91,50,41,144
2021,Colchester 002,E02004507,9150,8467,353,275,78,125,51,74,205
2021,Colchester 003,E02004508,6294,5662,366,284,82,81,42,39,185
2021,Colchester 007,E02004512,10665,9986,349,270,79,144,58,86,186
2021,Colchester 008,E02004513,10811,10021,273,179,94,230,96,134,287
2021,Colchester 009,E02004514,5568,5049,301,228,73,70,32,38,148
2021,Colchester 010,E02004515,9091,8367,401,320,81,118,67,51,205
2021,Colchester 011,E02004516,12446,11599,421,323,98,214,89,125,212
2021,Colchester 012,E02004517,9070,8337,381,291,90,138,60,78,214
2021,Colchester 013,E02004518,7580,7065,316,249,67,70,33,37,129
2021,Colchester 014,E02004519,7199,6499,357,278,79,125,65,60,218
2021,Colchester 015,E02004520,8887,8183,292,224,68,171,76,95,241
2021,Colchester 016,E02004521,8883,8129,379,276,103,143,70,73,232
2021,Colchester 017,E02004522,8621,7955,404,316,88,103,54,49,159
2021,Colchester 018,E02004523,9775,8845,383,261,122,198,86,112,349
2021,Colchester 019,E02004524,7971,7170,464,349,115,137,76,61,200
2021,Colchester 020,E02004525,7710,7019,369,277,92,117,57,60,205
2021,Colchester 021,E02004526,6999,6228,395,272,123,126,55,71,250
2021,Epping Forest 001,E02004527,8812,8082,402,323,79,125,54,71,203
2021,Epping Forest 002,E02004528,8411,7621,422,313,109,159,81,78,209
2021,Epping Forest 003,E02004529,7027,6384,349,252,97,106,61,45,188
2021,Epping Forest 004,E02004530,6690,6122,296,229,67,115,55,60,157
2021,Epping Forest 005,E02004531,6702,6215,273,205,68,78,43,35,136
2021,Epping Forest 006,E02004532,6049,5543,297,239,58,86,47,39,123
2021,Epping Forest 007,E02004533,7262,6625,323,223,100,117,59,58,197
2021,Epping Forest 008,E02004534,8446,7802,318,239,79,129,64,65,197
2021,Epping Forest 009,E02004535,5733,5215,265,184,81,107,58,49,146
2021,Epping Forest 010,E02004536,5938,5468,266,194,72,83,36,47,121
2021,Epping Forest 011,E02004537,8871,8197,325,243,82,154,70,84,195
2021,Epping Forest 012,E02004538,9337,8597,441,340,101,91,49,42,208
2021,Epping Forest 013,E02004539,7416,6845,315,240,75,99,46,53,157
2021,Epping Forest 014,E02004540,5682,5184,297,215,82,68,31,37,133
2021,Epping Forest 015,E02004541,11019,10185,530,414,116,130,74,56,174
2021,Epping Forest 016,E02004542,6604,6018,337,249,88,97,47,50,152
2021,Epping Forest 017,E02004543,7059,6487,304,197,107,109,44,65,159
2021,Harlow 001,E02004544,10327,9508,427,324,103,178,80,98,214
2021,Harlow 002,E02004545,7456,6804,319,228,91,139,63,76,194
2021,Harlow 003,E02004546,7939,7264,308,215,93,174,73,101,193
2021,Harlow 004,E02004547,9314,8624,327,238,89,148,63,85,215
2021,Harlow 005,E02004548,8380,7753,362,271,91,113,57,56,152
2021,Harlow 006,E02004549,7630,6941,293,216,77,161,67,94,235
2021,Harlow 007,E02004550,8184,7539,256,165,91,165,87,78,224
2021,Harlow 008,E02004551,7131,6454,315,237,78,140,65,75,222
2021,Harlow 009,E02004552,6209,5673,269,211,58,99,53,46,168
2021,Harlow 010,E02004553,7270,6605,286,201,85,169,75,94,210
2021,Harlow 011,E02004554,7240,6667,265,200,65,128,55,73,180
2021,Maldon 001,E02004555,6253,5592,403,316,87,101,52,49,157
2021,Maldon 002,E02004556,7244,6572,388,299,89,96,44,52,188
2021,Maldon 003,E02004557,8406,7610,409,296,113,168,79,89,219
2021,Maldon 004,E02004558,6557,5919,325,230,95,113,52,61,200
2021,Maldon 005,E02004559,7686,6942,389,288,101,132,73,59,223
2021,Maldon 006,E02004560,8623,7734,433,311,122,165,77,88,291
2021,Maldon 007,E02004561,9993,8949,572,422,150,177,93,84,295
2021,Maldon 008,E02004562,8405,7618,400,280,120,144,72,72,243
2021,Rochford 001,E02004563,6360,5780,295,208,87,109,66,43,176
2021,Rochford 002,E02004564,7579,6873,386,284,102,104,54,50,216
2021,Rochford 004,E02004566,5307,4841,206,161,45,104,54,50,156
2021,Rochford 005,E02004567,7775,7109,398,282,116,106,62,44,162
2021,Rochford 006,E02004568,8321,7652,369,287,82,90,43,47,210
2021,Rochford 007,E02004569,8120,7394,398,286,112,126,66,60,202
2021,Rochford 008,E02004570,8260,7506,411,302,109,116,56,60,227
2021,Rochford 009,E02004571,7460,6825,370,277,93,97,49,48,168
2021,Rochford 010,E02004572,7521,6826,349,247,102,144,82,62,202
2021,Tendring 001,E02004573,6064,5452,257,190,67,146,49,97,209
2021,Tendring 002,E02004574,7357,6615,315,215,100,152,60,92,275
2021,Tendring 003,E02004575,11518,10400,595,458,137,197,85,112,326
2021,Tendring 004,E02004576,8759,7885,393,280,113,180,98,82,301
2021,Tendring 005,E02004577,5832,5252,312,231,81,100,53,47,168
2021,Tendring 006,E02004578,7291,6447,355,233,122,180,88,92,309
2021,Tendring 007,E02004579,7602,6773,383,257,126,162,81,81,284
2021,Tendring 008,E02004580,11893,10514,584,414,170,256,125,131,539
2021,Tendring 009,E02004581,8118,7291,408,302,106,151,78,73,268
2021,Tendring 010,E02004582,6727,5881,306,202,104,164,77,87,376
2021,Tendring 011,E02004583,8533,7594,434,323,111,203,89,114,302
2021,Tendring 012,E02004584,6431,5643,303,198,105,168,73,95,317
2021,Tendring 013,E02004585,8579,7589,372,254,118,217,95,122,401
2021,Tendring 014,E02004586,7864,7020,327,233,94,188,86,102,329
2021,Tendring 015,E02004587,7277,6356,325,209,116,216,88,128,380
2021,Tendring 016,E02004588,6750,6047,255,156,99,178,64,114,270
2021,Tendring 017,E02004589,7056,6227,326,226,100,172,92,80,331
2021,Tendring 018,E02004590,7945,6904,336,208,128,244,104,140,461
2021,Uttlesford 001,E02004591,7235,6695,366,286,80,76,34,42,98
2021,Uttlesford 002,E02004592,12423,11476,579,453,126,149,73,76,219
2021,Uttlesford 003,E02004593,8552,7845,428,348,80,120,68,52,159
2021,Uttlesford 004,E02004594,7899,7215,413,326,87,97,50,47,174
2021,Uttlesford 005,E02004595,13930,12819,673,532,141,168,87,81,270
2021,Uttlesford 006,E02004596,9926,9149,428,331,97,118,59,59,231
2021,Uttlesford 007,E02004597,8446,7866,322,255,67,94,38,56,164
2021,Uttlesford 008,E02004598,10468,9699,471,370,101,123,55,68,175
2021,Uttlesford 009,E02004599,7437,6781,422,315,107,88,39,49,146
2021,Cheltenham 001,E02004600,5236,4804,210,171,39,86,41,45,136
2021,Cheltenham 002,E02004601,5830,5394,268,205,63,56,33,23,112
2021,Cheltenham 003,E02004602,6313,5839,204,143,61,110,41,69,160
2021,Cheltenham 004,E02004603,7779,7277,259,187,72,114,48,66,129
2021,Cheltenham 005,E02004604,7645,7032,238,152,86,168,62,106,207
2021,Cheltenham 006,E02004605,5497,4996,231,177,54,109,46,63,161
2021,Cheltenham 007,E02004606,9901,9203,366,282,84,155,74,81,177
2021,Cheltenham 008,E02004607,9151,8578,368,303,65,78,35,43,127
2021,Cheltenham 009,E02004608,9647,9112,345,289,56,81,29,52,109
2021,Cheltenham 010,E02004609,6792,6235,331,251,80,87,39,48,139
2021,Cheltenham 011,E02004610,7342,6780,352,279,73,73,43,30,137
2021,Cheltenham 012,E02004611,11553,10729,545,437,108,100,51,49,179
2021,Cheltenham 013,E02004612,8905,8107,463,358,105,140,63,77,195
2021,Cheltenham 014,E02004613,6131,5653,320,259,61,57,33,24,101
2021,Cheltenham 015,E02004614,5258,4826,294,236,58,36,23,13,102
2021,Cotswold 001,E02004615,8378,7651,420,328,92,106,55,51,201
2021,Cotswold 002,E02004616,9575,8772,421,315,106,135,81,54,247
2021,Cotswold 003,E02004617,9069,8384,382,292,90,118,72,46,185
2021,Cotswold 004,E02004618,6999,6422,389,318,71,65,32,33,123
2021,Cotswold 005,E02004619,6921,6354,344,290,54,93,46,47,130
2021,Cotswold 006,E02004620,7996,7348,367,287,80,113,65,48,168
2021,Cotswold 007,E02004621,5897,5456,242,200,42,61,27,34,138
2021,Cotswold 008,E02004622,7123,6598,275,194,81,89,49,40,161
2021,Cotswold 009,E02004623,8824,8156,381,288,93,87,46,41,200
2021,Cotswold 010,E02004624,6293,5739,333,258,75,75,47,28,146
2021,Cotswold 011,E02004625,9740,8941,486,379,107,141,64,77,172
2021,Forest of Dean 001,E02004626,9628,8815,502,384,118,111,57,54,200
2021,Forest of Dean 002,E02004627,6030,5461,313,248,65,95,51,44,161
2021,Forest of Dean 003,E02004628,7519,6753,398,300,98,142,67,75,226
2021,Forest of Dean 004,E02004629,12315,11124,537,390,147,225,103,122,429
2021,Forest of Dean 005,E02004630,6334,5701,355,266,89,110,63,47,168
2021,Forest of Dean 006,E02004631,4928,4429,298,219,79,74,38,36,127
2021,Forest of Dean 007,E02004632,10341,9269,533,368,165,209,109,100,330
2021,Forest of Dean 008,E02004633,7972,7126,417,314,103,158,75,83,271
2021,Forest of Dean 009,E02004634,10700,9693,497,334,163,183,92,91,327
2021,Forest of Dean 010,E02004635,7256,6606,348,262,86,126,57,69,176
2021,Gloucester 001,E02004636,7504,6825,381,299,82,116,67,49,182
2021,Gloucester 002,E02004637,8916,8271,349,260,89,128,59,69,168
2021,Gloucester 003,E02004638,5583,5118,263,198,65,86,43,43,116
2021,Gloucester 004,E02004639,10982,10244,372,269,103,183,70,113,183
2021,Gloucester 005,E02004640,8000,7352,260,165,95,195,79,116,193
2021,Gloucester 006,E02004641,7087,6389,391,287,104,111,54,57,196
2021,Gloucester 007,E02004642,11481,10445,522,376,146,203,107,96,311
2021,Gloucester 008,E02004643,7729,7023,286,199,87,194,73,121,226
2021,Gloucester 009,E02004644,8614,7834,352,249,103,171,87,84,257
2021,Gloucester 010,E02004645,8614,7866,452,355,97,122,56,66,174
2021,Gloucester 011,E02004646,8617,7876,328,233,95,179,83,96,234
2021,Gloucester 012,E02004647,5875,5280,274,201,73,128,64,64,193
2021,Gloucester 013,E02004648,5423,4894,238,170,68,110,58,52,181
2021,Gloucester 014,E02004649,6867,6308,328,261,67,105,50,55,126
2021,Gloucester 015,E02004650,13663,12690,494,347,147,217,102,115,262
2021,Stroud 001,E02004651,10414,9625,448,348,100,156,75,81,185
2021,Stroud 002,E02004652,6461,5864,379,286,93,76,38,38,142
2021,Stroud 003,E02004653,7410,6808,357,277,80,100,48,52,145
2021,Stroud 004,E02004654,10978,9978,567,420,147,186,92,94,247
2021,Stroud 005,E02004655,7697,7000,358,264,94,134,62,72,205
2021,Stroud 006,E02004656,10813,9872,591,452,139,168,83,85,182
2021,Stroud 007,E02004657,6471,5860,407,321,86,82,46,36,122
2021,Stroud 008,E02004658,6028,5507,345,280,65,66,30,36,110
2021,Stroud 009,E02004659,6800,6183,368,276,92,98,52,46,151
2021,Stroud 010,E02004660,6453,5834,360,281,79,86,48,38,173
2021,Stroud 011,E02004661,8112,7294,474,371,103,124,67,57,220
2021,Stroud 012,E02004662,6246,5681,319,235,84,93,46,47,153
2021,Stroud 013,E02004663,6230,5698,336,252,84,80,41,39,116
2021,Stroud 014,E02004664,7022,6363,374,282,92,118,56,62,167
2021,Stroud 015,E02004665,8329,7640,419,339,80,104,49,55,166
2021,Tewkesbury 001,E02004666,11420,10519,493,379,114,154,75,79,254
2021,Tewkesbury 002,E02004667,10143,9188,527,400,127,164,82,82,264
2021,Tewkesbury 003,E02004668,8692,7938,474,366,108,94,56,38,186
2021,Tewkesbury 004,E02004669,7153,6507,385,291,94,96,53,43,165
2021,Tewkesbury 006,E02004671,6763,6142,380,287,93,86,45,41,155
2021,Tewkesbury 007,E02004672,11689,10686,550,440,110,178,87,91,275
2021,Tewkesbury 008,E02004673,7250,6622,322,239,83,88,36,52,218
2021,Tewkesbury 009,E02004674,11453,10511,468,348,120,188,83,105,286
2021,Basingstoke and Deane 001,E02004675,7304,6637,379,301,78,112,50,62,176
2021,Basingstoke and Deane 002,E02004676,7639,6978,393,300,93,101,51,50,167
2021,Basingstoke and Deane 003,E02004677,7253,6713,334,249,85,76,46,30,130
2021,Basingstoke and Deane 004,E02004678,7231,6612,356,284,72,103,46,57,160
2021,Basingstoke and Deane 005,E02004679,10354,9577,473,362,111,133,62,71,171
2021,Basingstoke and Deane 006,E02004680,7348,6839,314,256,58,83,42,41,112
2021,Basingstoke and Deane 007,E02004681,13813,12888,389,286,103,222,100,122,314
2021,Basingstoke and Deane 008,E02004682,7865,7251,348,256,92,110,66,44,156
2021,Basingstoke and Deane 009,E02004683,7618,7053,303,231,72,115,53,62,147
2021,Basingstoke and Deane 010,E02004684,10577,9807,375,264,111,163,68,95,232
2021,Basingstoke and Deane 011,E02004685,7500,6995,273,211,62,82,35,47,150
2021,Basingstoke and Deane 012,E02004686,8298,7794,252,173,79,108,48,60,144
2021,Basingstoke and Deane 013,E02004687,7170,6528,268,189,79,135,59,76,239
2021,Basingstoke and Deane 014,E02004688,7376,6716,269,197,72,153,72,81,238
2021,Basingstoke and Deane 015,E02004689,5451,4969,290,212,78,78,45,33,114
2021,Basingstoke and Deane 016,E02004690,7715,7139,320,244,76,88,41,47,168
2021,Basingstoke and Deane 017,E02004691,7630,6964,380,306,74,100,42,58,186
2021,Basingstoke and Deane 018,E02004692,6977,6329,363,269,94,92,54,38,193
2021,Basingstoke and Deane 019,E02004693,6992,6419,279,206,73,118,54,64,176
2021,Basingstoke and Deane 020,E02004694,7105,6530,363,284,79,77,40,37,135
2021,Basingstoke and Deane 021,E02004695,8281,7751,345,282,63,82,47,35,103
2021,Basingstoke and Deane 022,E02004696,7098,6568,321,255,66,83,37,46,126
2021,East Hampshire 001,E02004697,6532,6024,304,237,67,82,39,43,122
2021,East Hampshire 002,E02004698,6177,5680,227,174,53,109,48,61,161
2021,East Hampshire 003,E02004699,10254,9411,535,419,116,123,57,66,185
2021,East Hampshire 004,E02004700,6317,5868,227,156,71,93,40,53,129
2021,East Hampshire 006,E02004702,7562,6939,334,263,71,141,57,84,148
2021,East Hampshire 007,E02004703,12101,11003,666,511,155,148,83,65,284
2021,East Hampshire 008,E02004704,5926,5452,261,209,52,72,43,29,141
2021,East Hampshire 009,E02004705,9325,8560,433,351,82,129,60,69,203
2021,East Hampshire 010,E02004706,7313,6716,347,266,81,94,50,44,156
2021,East Hampshire 011,E02004707,10798,9918,576,456,120,115,61,54,189
2021,East Hampshire 012,E02004708,9099,8380,397,296,101,125,64,61,197
2021,East Hampshire 013,E02004709,8295,7538,445,336,109,100,45,55,212
2021,East Hampshire 014,E02004710,6262,5674,360,277,83,98,47,51,130
2021,Eastleigh 001,E02004712,8453,7755,451,344,107,75,41,34,172
2021,Eastleigh 002,E02004713,7625,6970,414,325,89,78,41,37,163
2021,Eastleigh 003,E02004714,7199,6647,346,270,76,68,33,35,138
2021,Eastleigh 004,E02004715,8470,7762,363,271,92,125,64,61,220
2021,Eastleigh 005,E02004716,8247,7545,371,278,93,127,68,59,204
2021,Eastleigh 006,E02004717,12070,11056,450,329,121,232,103,129,332
2021,Eastleigh 007,E02004718,8179,7534,316,240,76,172,83,89,157
2021,Eastleigh 008,E02004719,10855,9956,557,440,117,120,52,68,222
2021,Eastleigh 009,E02004720,10831,9875,522,382,140,168,94,74,266
2021,Eastleigh 010,E02004721,10928,10235,419,324,95,123,57,66,151
2021,Eastleigh 011,E02004722,6671,6119,270,202,68,101,48,53,181
2021,Eastleigh 012,E02004723,9343,8554,486,371,115,116,61,55,187
2021,Eastleigh 013,E02004724,9039,8284,396,288,108,144,67,77,215
2021,Eastleigh 014,E02004725,5217,4710,255,195,60,104,51,53,148
2021,Eastleigh 015,E02004726,5721,5239,282,209,73,61,36,25,139
2021,Fareham 001,E02004727,9704,8964,452,360,92,114,59,55,174
2021,Fareham 002,E02004728,8628,7878,427,291,136,125,50,75,198
2021,Fareham 003,E02004729,6890,6265,307,226,81,136,63,73,182
2021,Fareham 004,E02004730,8324,7595,458,353,105,95,45,50,176
2021,Fareham 005,E02004731,7257,6636,370,292,78,91,43,48,160
2021,Fareham 006,E02004732,8420,7681,444,352,92,104,47,57,191
2021,Fareham 007,E02004733,7631,6934,414,314,100,124,62,62,159
2021,Fareham 008,E02004734,9683,8841,517,379,138,116,56,60,209
2021,Fareham 009,E02004735,7154,6528,352,263,89,103,63,40,171
2021,Fareham 010,E02004736,7794,7031,434,346,88,101,42,59,228
2021,Fareham 011,E02004737,7113,6530,290,215,75,111,51,60,182
2021,Fareham 012,E02004738,6915,6334,301,218,83,99,61,38,181
2021,Fareham 013,E02004739,7006,6380,348,267,81,101,53,48,177
2021,Fareham 014,E02004740,6838,6120,417,317,100,107,55,52,194
2021,Gosport 001,E02004741,7182,6461,317,202,115,147,75,72,257
2021,Gosport 002,E02004742,6703,5934,320,227,93,165,86,79,284
2021,Gosport 003,E02004743,6926,6318,310,230,80,115,50,65,183
2021,Gosport 004,E02004744,8942,8209,283,192,91,174,73,101,276
2021,Gosport 005,E02004745,8029,7302,315,237,78,174,66,108,238
2021,Gosport 006,E02004746,10676,9664,557,402,155,176,98,78,279
2021,Gosport 007,E02004747,5932,5339,297,223,74,107,56,51,189
2021,Gosport 008,E02004748,8843,8032,366,252,114,189,91,98,256
2021,Gosport 009,E02004749,6926,6298,375,282,93,82,48,34,171
2021,Gosport 010,E02004750,7544,6902,379,276,103,103,52,51,160
2021,Hart 001,E02004751,8022,7399,361,273,88,95,47,48,167
2021,Hart 002,E02004752,7577,7024,342,270,72,81,38,43,130
2021,Hart 003,E02004753,10988,10157,458,359,99,160,66,94,213
2021,Hart 004,E02004754,6825,6274,323,246,77,69,36,33,159
2021,Hart 005,E02004755,11514,10819,433,335,98,104,53,51,158
2021,Hart 006,E02004756,9082,8417,395,317,78,101,49,52,169
2021,Hart 007,E02004757,7598,7009,383,306,77,77,41,36,129
2021,Hart 008,E02004758,8713,8057,379,290,89,95,59,36,182
2021,Hart 009,E02004759,7825,7202,354,295,59,115,63,52,154
2021,Hart 010,E02004760,9965,9292,409,318,91,97,40,57,167
2021,Hart 011,E02004761,6138,5675,275,225,50,66,34,32,122
2021,Havant 003,E02004764,7878,7070,431,318,113,123,59,64,254
2021,Havant 004,E02004765,5792,5312,287,217,70,71,33,38,122
2021,Havant 005,E02004766,6739,6122,258,203,55,140,64,76,219
2021,Havant 006,E02004767,5431,4937,167,104,63,115,34,81,212
2021,Havant 007,E02004768,5068,4603,215,157,58,100,33,67,150
2021,Havant 008,E02004769,5912,5264,213,138,75,162,68,94,273
2021,Havant 009,E02004770,6392,5766,243,164,79,141,61,80,242
2021,Havant 010,E02004771,8369,7504,326,214,112,181,74,107,358
2021,Havant 011,E02004772,8934,8181,391,301,90,122,63,59,240
2021,Havant 013,E02004774,9850,8946,533,424,109,139,78,61,232
2021,Havant 014,E02004775,9812,8947,494,373,121,140,67,73,231
2021,Havant 015,E02004776,5788,5204,302,222,80,94,55,39,188
2021,Havant 016,E02004777,5068,4526,245,176,69,92,43,49,205
2021,Havant 017,E02004778,5970,5319,302,207,95,127,62,65,222
2021,New Forest 001,E02004779,10508,9502,575,442,133,147,74,73,284
2021,New Forest 002,E02004780,5558,4996,267,198,69,103,48,55,192
2021,New Forest 003,E02004781,7610,6933,390,309,81,127,68,59,160
2021,New Forest 004,E02004782,7333,6627,346,265,81,116,63,53,244
2021,New Forest 005,E02004783,6678,6099,339,244,95,89,44,45,151
2021,New Forest 006,E02004784,5462,4921,333,269,64,69,33,36,139
2021,New Forest 007,E02004785,5351,4832,318,248,70,70,40,30,131
2021,New Forest 008,E02004786,7816,7099,418,325,93,119,57,62,180
2021,New Forest 009,E02004787,6989,6306,397,291,106,93,45,48,193
2021,New Forest 010,E02004788,6961,6328,396,303,93,108,59,49,129
2021,New Forest 011,E02004789,9908,8893,504,384,120,197,99,98,314
2021,New Forest 012,E02004790,7676,6996,357,273,84,113,58,55,210
2021,New Forest 013,E02004791,5266,4713,246,172,74,118,53,65,189
2021,New Forest 014,E02004792,8068,7264,430,317,113,121,67,54,253
2021,New Forest 015,E02004793,7154,6469,436,342,94,74,44,30,175
2021,New Forest 016,E02004794,6653,5995,382,303,79,83,51,32,193
2021,New Forest 017,E02004795,8244,7489,468,375,93,112,55,57,175
2021,New Forest 018,E02004796,9313,8421,462,349,113,129,58,71,301
2021,New Forest 019,E02004797,7733,6972,421,321,100,128,52,76,212
2021,New Forest 020,E02004798,5860,5268,264,182,82,123,50,73,205
2021,New Forest 021,E02004799,7610,6889,324,229,95,138,74,64,259
2021,New Forest 022,E02004800,7270,6554,369,266,103,106,55,51,241
2021,New Forest 023,E02004801,7539,6831,425,326,99,90,49,41,193
2021,Rushmoor 001,E02004802,6389,5889,221,164,57,109,44,65,170
2021,Rushmoor 002,E02004803,7080,6505,227,165,62,150,61,89,198
2021,Rushmoor 003,E02004804,6776,6266,272,193,79,99,48,51,139
2021,Rushmoor 004,E02004805,8109,7524,354,281,73,90,44,46,141
2021,Rushmoor 005,E02004806,7549,7014,337,262,75,80,45,35,118
2021,Rushmoor 006,E02004807,8872,8169,332,243,89,139,75,64,232
2021,Rushmoor 007,E02004808,11362,10649,409,308,101,119,60,59,185
2021,Rushmoor 008,E02004809,9837,9321,200,135,65,150,68,82,166
2021,Rushmoor 009,E02004810,7536,6973,265,200,65,119,59,60,179
2021,Rushmoor 010,E02004811,7565,7005,305,238,67,109,49,60,146
2021,Rushmoor 011,E02004812,6382,5908,265,203,62,93,51,42,116
2021,Rushmoor 012,E02004813,6102,5560,250,188,62,133,49,84,159
2021,Test Valley 001,E02004814,6742,6200,332,259,73,80,43,37,130
2021,Test Valley 002,E02004815,6935,6303,258,184,74,142,60,82,232
2021,Test Valley 004,E02004817,7149,6556,317,235,82,111,47,64,165
2021,Test Valley 005,E02004818,9814,9011,472,385,87,115,64,51,216
2021,Test Valley 006,E02004819,7470,6905,332,273,59,86,38,48,147
2021,Test Valley 007,E02004820,6923,6363,320,240,80,101,57,44,139
2021,Test Valley 008,E02004821,5021,4590,290,234,56,67,27,40,74
2021,Test Valley 009,E02004822,7674,7011,390,317,73,98,61,37,175
2021,Test Valley 010,E02004823,8224,7513,455,362,93,90,43,47,166
2021,Test Valley 011,E02004824,5663,5163,269,204,65,80,36,44,151
2021,Test Valley 012,E02004825,10414,9462,557,442,115,149,80,69,246
2021,Test Valley 013,E02004826,9170,8392,457,360,97,115,53,62,206
2021,Test Valley 014,E02004827,6995,6492,355,283,72,62,36,26,86
2021,Test Valley 015,E02004828,6910,6306,379,292,87,86,38,48,139
2021,Winchester 001,E02004829,5553,5140,238,191,47,62,31,31,113
2021,Winchester 002,E02004830,6610,6076,331,261,70,74,31,43,129
2021,Winchester 003,E02004831,9956,9194,453,352,101,100,52,48,209
2021,Winchester 004,E02004832,8212,7536,435,342,93,74,31,43,167
2021,Winchester 005,E02004833,9621,8960,396,309,87,105,57,48,160
2021,Winchester 006,E02004834,7279,6758,266,191,75,107,46,61,148
2021,Winchester 007,E02004835,10303,9656,424,349,75,96,47,49,127
2021,Winchester 008,E02004836,6536,6056,250,188,62,77,37,40,153
2021,Winchester 009,E02004837,7882,7264,409,312,97,86,38,48,123
2021,Winchester 010,E02004838,9273,8539,497,396,101,86,49,37,151
2021,Winchester 011,E02004839,8555,7803,484,385,99,85,46,39,183
2021,Winchester 012,E02004840,9680,8836,515,390,125,112,66,46,217
2021,Winchester 013,E02004841,11116,10283,514,410,104,137,64,73,182
2021,Winchester 014,E02004842,10830,9890,517,396,121,130,70,60,293
2021,Broxbourne 001,E02004843,6884,6331,276,203,73,114,60,54,163
2021,Broxbourne 002,E02004844,7040,6396,319,237,82,134,64,70,191
2021,Broxbourne 003,E02004845,7417,6845,281,206,75,106,53,53,185
2021,Broxbourne 004,E02004846,6119,5598,309,233,76,74,36,38,138
2021,Broxbourne 005,E02004847,9604,8830,376,285,91,165,81,84,233
2021,Broxbourne 006,E02004848,7270,6622,355,254,101,130,65,65,163
2021,Broxbourne 007,E02004849,6450,5888,314,219,95,99,46,53,149
2021,Broxbourne 008,E02004850,6999,6435,263,189,74,137,64,73,164
2021,Broxbourne 009,E02004851,5606,5072,240,169,71,118,64,54,176
2021,Broxbourne 010,E02004852,7560,6984,282,197,85,132,56,76,162
2021,Broxbourne 011,E02004853,6547,5908,318,236,82,138,58,80,183
2021,Broxbourne 012,E02004854,7593,6993,292,204,88,142,53,89,166
2021,Broxbourne 013,E02004855,7968,7405,226,150,76,182,79,103,155
2021,Dacorum 001,E02004856,5468,4985,258,204,54,86,38,48,139
2021,Dacorum 002,E02004857,5736,5290,299,250,49,47,24,23,100
2021,Dacorum 003,E02004858,4726,4316,235,182,53,71,37,34,104
2021,Dacorum 004,E02004859,5076,4645,279,221,58,50,25,25,102
2021,Dacorum 005,E02004860,5348,4882,233,178,55,92,42,50,141
2021,Dacorum 006,E02004861,5301,4864,285,233,52,48,28,20,104
2021,Dacorum 007,E02004862,7302,6651,298,201,97,133,71,62,220
2021,Dacorum 008,E02004863,7352,6662,300,218,82,176,68,108,214
2021,Dacorum 009,E02004864,6047,5547,344,270,74,58,24,34,98
2021,Dacorum 010,E02004865,5185,4770,214,149,65,92,47,45,109
2021,Dacorum 011,E02004866,6340,5756,289,205,84,105,51,54,190
2021,Dacorum 012,E02004867,6112,5647,292,232,60,70,37,33,103
2021,Dacorum 013,E02004868,7071,6465,272,210,62,126,47,79,208
2021,Dacorum 014,E02004869,5527,5124,251,196,55,62,29,33,90
2021,Dacorum 015,E02004870,10818,9987,437,317,120,185,99,86,209
2021,Dacorum 016,E02004871,4730,4299,221,175,46,82,28,54,128
2021,Dacorum 017,E02004872,7001,6381,330,241,89,120,64,56,170
2021,Dacorum 018,E02004873,10895,10070,512,403,109,131,68,63,182
2021,Dacorum 019,E02004874,5646,5190,247,174,73,97,50,47,112
2021,Dacorum 020,E02004875,9732,8860,438,300,138,183,91,92,251
2021,Dacorum 021,E02004876,9111,8342,456,352,104,115,68,47,198
2021,Dacorum 022,E02004877,4983,4522,283,206,77,82,38,44,96
2021,East Hertfordshire 001,E02004878,8709,7974,371,292,79,116,63,53,248
2021,East Hertfordshire 003,E02004880,10203,9440,498,382,116,111,54,57,154
2021,East Hertfordshire 004,E02004881,6484,6011,296,235,61,67,33,34,110
2021,East Hertfordshire 005,E02004882,8054,7484,360,283,77,101,54,47,109
2021,East Hertfordshire 006,E02004883,5920,5443,284,219,65,69,30,39,124
2021,East Hertfordshire 007,E02004884,9815,9087,420,330,90,135,69,66,173
2021,East Hertfordshire 008,E02004885,8178,7573,404,321,83,78,40,38,123
2021,East Hertfordshire 009,E02004886,6285,5756,327,256,71,80,48,32,122
2021,East Hertfordshire 010,E02004887,7182,6571,371,297,74,92,55,37,148
2021,East Hertfordshire 011,E02004888,8303,7644,397,298,99,85,51,34,177
2021,East Hertfordshire 012,E02004889,10576,9750,448,355,93,153,83,70,225
2021,East Hertfordshire 013,E02004890,7945,7382,356,277,79,88,40,48,119
2021,East Hertfordshire 014,E02004891,7431,6832,354,278,76,99,49,50,146
2021,East Hertfordshire 015,E02004892,5462,5010,247,195,52,93,37,56,112
2021,East Hertfordshire 016,E02004893,5575,5162,241,166,75,64,34,30,108
2021,East Hertfordshire 017,E02004894,9056,8430,409,329,80,100,54,46,117
2021,East Hertfordshire 018,E02004895,8940,8263,405,304,101,100,55,45,172
2021,Hertsmere 001,E02004896,7624,6983,371,280,91,93,54,39,177
2021,Hertsmere 002,E02004897,6503,5935,327,245,82,97,53,44,144
2021,Hertsmere 003,E02004898,7342,6691,343,254,89,129,60,69,179
2021,Hertsmere 004,E02004899,5115,4635,280,201,79,80,40,40,120
2021,Hertsmere 005,E02004900,7811,7081,473,371,102,101,54,47,156
2021,Hertsmere 006,E02004901,9492,8765,335,233,102,191,84,107,201
2021,Hertsmere 007,E02004902,7548,6917,315,231,84,150,69,81,166
2021,Hertsmere 008,E02004903,7040,6459,336,257,79,113,63,50,132
2021,Hertsmere 009,E02004904,6382,5892,223,148,75,121,71,50,146
2021,Hertsmere 010,E02004905,6237,5719,309,237,72,104,53,51,105
2021,Hertsmere 011,E02004906,10291,9463,429,306,123,191,88,103,208
2021,Hertsmere 012,E02004907,10145,9320,473,356,117,149,77,72,203
2021,Hertsmere 013,E02004908,10002,9112,534,407,127,147,76,71,209
2021,North Hertfordshire 001,E02004909,5416,5004,226,162,64,89,37,52,97
2021,North Hertfordshire 002,E02004910,10861,10008,498,375,123,119,65,54,236
2021,North Hertfordshire 003,E02004911,6415,5800,309,216,93,106,54,52,200
2021,North Hertfordshire 004,E02004912,10120,9236,512,400,112,152,72,80,220
2021,North Hertfordshire 006,E02004914,7548,6889,320,233,87,142,61,81,197
2021,North Hertfordshire 007,E02004915,5318,4830,232,152,80,100,48,52,156
2021,North Hertfordshire 008,E02004916,7079,6400,382,299,83,105,45,60,192
2021,North Hertfordshire 009,E02004917,6059,5455,340,245,95,102,42,60,162
2021,North Hertfordshire 010,E02004918,7621,7083,326,249,77,100,37,63,112
2021,North Hertfordshire 011,E02004919,7262,6613,355,283,72,126,51,75,168
2021,North Hertfordshire 012,E02004920,10908,9989,526,387,139,151,63,88,242
2021,North Hertfordshire 013,E02004921,7422,6860,360,280,80,99,51,48,103
2021,North Hertfordshire 014,E02004922,9601,8721,513,394,119,128,76,52,239
2021,North Hertfordshire 015,E02004923,9851,8981,504,371,133,141,66,75,225
2021,St Albans 001,E02004924,7340,6755,386,311,75,82,47,35,117
2021,St Albans 002,E02004925,7443,6892,318,258,60,90,39,51,143
2021,St Albans 003,E02004926,7670,7153,341,270,71,79,42,37,97
2021,St Albans 004,E02004927,6341,5796,322,244,78,89,45,44,134
2021,St Albans 005,E02004928,6462,5985,324,272,52,50,29,21,103
2021,St Albans 006,E02004929,6043,5490,335,255,80,71,30,41,147
2021,St Albans 007,E02004930,6610,6101,312,247,65,62,34,28,135
2021,St Albans 008,E02004931,6624,6131,305,225,80,60,32,28,128
2021,St Albans 009,E02004932,7263,6610,322,243,79,143,60,83,188
2021,St Albans 010,E02004933,6537,6062,337,280,57,45,22,23,93
2021,St Albans 011,E02004934,7259,6811,285,222,63,65,30,35,98
2021,St Albans 012,E02004935,8417,7961,290,241,49,83,43,40,83
2021,St Albans 013,E02004936,6151,5736,266,207,59,59,32,27,90
2021,St Albans 014,E02004937,6916,6382,343,283,60,70,32,38,121
2021,St Albans 016,E02004939,6278,5765,283,217,66,92,45,47,138
2021,St Albans 017,E02004940,7096,6544,321,241,80,85,52,33,146
2021,St Albans 018,E02004941,9234,8451,402,294,108,169,71,98,212
2021,St Albans 019,E02004942,6096,5537,316,243,73,103,59,44,140
2021,St Albans 020,E02004943,7814,7070,439,323,116,128,62,66,177
2021,Stevenage 001,E02004944,7520,6860,286,210,76,187,80,107,187
2021,Stevenage 002,E02004945,11507,10542,499,349,150,181,87,94,285
2021,Stevenage 003,E02004946,6038,5505,259,181,78,129,65,64,145
2021,Stevenage 005,E02004948,5702,5165,246,169,77,109,54,55,182
2021,Stevenage 006,E02004949,8281,7533,364,268,96,153,68,85,231
2021,Stevenage 007,E02004950,6379,5809,250,190,60,133,58,75,187
2021,Stevenage 008,E02004951,7482,6873,264,200,64,147,59,88,198
2021,Stevenage 009,E02004952,6500,5873,327,245,82,139,60,79,161
2021,Stevenage 010,E02004953,6091,5473,281,194,87,136,69,67,201
2021,Stevenage 011,E02004954,6655,6045,296,208,88,122,59,63,192
2021,Stevenage 012,E02004955,5645,5072,280,214,66,112,50,62,181
2021,Three Rivers 001,E02004956,8590,7815,467,355,112,148,80,68,160
2021,Three Rivers 002,E02004957,10099,9278,455,342,113,152,68,84,214
2021,Three Rivers 003,E02004958,7487,6848,385,298,87,92,53,39,162
2021,Three Rivers 004,E02004959,5970,5507,316,245,71,70,37,33,77
2021,Three Rivers 005,E02004960,5478,5013,319,244,75,58,30,28,88
2021,Three Rivers 006,E02004961,9139,8387,476,368,108,105,60,45,171
2021,Three Rivers 007,E02004962,8511,7835,439,345,94,102,47,55,135
2021,Three Rivers 008,E02004963,7128,6468,356,263,93,138,66,72,166
2021,Three Rivers 009,E02004964,5385,4928,254,191,63,88,36,52,115
2021,Three Rivers 010,E02004965,6585,5939,337,255,82,118,62,56,191
2021,Three Rivers 011,E02004966,6961,6309,427,329,98,107,73,34,118
2021,Three Rivers 012,E02004967,7317,6700,270,183,87,161,72,89,186
2021,Watford 001,E02004968,7193,6571,335,249,86,130,68,62,157
2021,Watford 002,E02004969,6855,6269,324,243,81,119,59,60,143
2021,Watford 003,E02004970,7879,7211,330,228,102,139,64,75,199
2021,Watford 004,E02004971,8140,7521,304,228,76,139,72,67,176
2021,Watford 005,E02004972,5816,5328,266,192,74,94,51,43,128
2021,Watford 006,E02004973,8046,7505,265,197,68,150,56,94,126
2021,Watford 007,E02004974,8501,7858,379,277,102,119,60,59,145
2021,Watford 008,E02004975,7812,7142,414,303,111,98,60,38,158
2021,Watford 009,E02004976,10601,10021,296,227,69,149,59,90,135
2021,Watford 010,E02004977,8538,8043,216,156,60,168,72,96,111
2021,Watford 011,E02004978,9592,8862,299,201,98,191,89,102,240
2021,Watford 012,E02004979,6740,6212,304,241,63,104,55,49,120
2021,Welwyn Hatfield 001,E02004980,5978,5446,347,262,85,68,34,34,117
2021,Welwyn Hatfield 002,E02004981,7669,7014,359,276,83,115,59,56,181
2021,Welwyn Hatfield 003,E02004982,5606,5059,337,257,80,76,40,36,134
2021,Welwyn Hatfield 004,E02004983,5739,5212,256,178,78,102,47,55,169
2021,Welwyn Hatfield 005,E02004984,5934,5420,311,240,71,95,49,46,108
2021,Welwyn Hatfield 006,E02004985,6619,6008,356,282,74,86,47,39,169
2021,Welwyn Hatfield 007,E02004986,8170,7488,315,235,80,156,73,83,211
2021,Welwyn Hatfield 008,E02004987,7217,6601,337,248,89,113,61,52,166
2021,Welwyn Hatfield 009,E02004988,7294,6709,312,222,90,98,45,53,175
2021,Welwyn Hatfield 010,E02004989,11996,11284,386,265,121,168,71,97,158
2021,Welwyn Hatfield 011,E02004990,6865,6319,278,198,80,117,45,72,151
2021,Welwyn Hatfield 012,E02004991,7675,7131,279,173,106,120,49,71,145
2021,Welwyn Hatfield 013,E02004992,9934,9373,282,219,63,128,46,82,151
2021,Welwyn Hatfield 015,E02004994,5883,5391,316,246,70,74,40,34,102
2021,Welwyn Hatfield 016,E02004995,5388,4885,327,244,83,77,37,40,99
2021,Ashford 001,E02004996,8032,7311,408,299,109,114,45,69,199
2021,Ashford 002,E02004997,7887,7074,429,319,110,136,64,72,248
2021,Ashford 003,E02004998,6489,5898,292,219,73,109,48,61,190
2021,Ashford 005,E02005000,11280,10360,389,283,106,234,109,125,297
2021,Ashford 006,E02005001,9017,8210,384,278,106,166,80,86,257
2021,Ashford 007,E02005002,9308,8520,321,224,97,192,73,119,275
2021,Ashford 008,E02005003,8584,7826,278,184,94,201,99,102,279
2021,Ashford 009,E02005004,11075,10088,486,344,142,190,79,111,311
2021,Ashford 010,E02005005,9703,8884,433,317,116,141,77,64,245
2021,Ashford 011,E02005006,5929,5413,264,184,80,87,45,42,165
2021,Ashford 012,E02005007,8867,8063,417,314,103,148,68,80,239
2021,Ashford 013,E02005008,8400,7589,451,336,115,113,61,52,247
2021,Ashford 014,E02005009,5718,5159,276,201,75,120,62,58,163
2021,Canterbury 001,E02005010,7168,6531,292,201,91,146,61,85,199
2021,Canterbury 002,E02005011,7243,6515,356,275,81,128,69,59,244
2021,Canterbury 003,E02005012,8552,7654,393,281,112,150,63,87,355
2021,Canterbury 004,E02005013,7899,6977,418,298,120,179,99,80,325
2021,Canterbury 005,E02005014,8179,7366,428,328,100,147,74,73,238
2021,Canterbury 006,E02005015,9068,8242,425,322,103,138,69,69,263
2021,Canterbury 007,E02005016,7481,6740,390,297,93,123,63,60,228
2021,Canterbury 008,E02005017,6351,5778,337,262,75,99,44,55,137
2021,Canterbury 009,E02005018,8384,7515,414,297,117,163,92,71,292
2021,Canterbury 010,E02005019,6206,5619,311,228,83,116,59,57,160
2021,Canterbury 011,E02005020,7121,6386,333,236,97,129,49,80,273
2021,Canterbury 012,E02005021,10762,10056,441,329,112,99,53,46,166
2021,Canterbury 013,E02005022,7741,7153,252,194,58,135,62,73,201
2021,Canterbury 014,E02005023,9186,8513,295,198,97,146,64,82,232
2021,Canterbury 016,E02005025,9564,8932,355,280,75,103,49,54,174
2021,Canterbury 017,E02005026,7646,6926,376,282,94,137,57,80,207
2021,Canterbury 018,E02005027,5296,4729,322,247,75,101,50,51,144
2021,Dartford 001,E02005028,12900,12094,309,210,99,208,81,127,289
2021,Dartford 002,E02005029,13405,12553,446,331,115,180,86,94,226
2021,Dartford 003,E02005030,11365,10572,417,316,101,169,78,91,207
2021,Dartford 004,E02005031,7548,6953,246,171,75,136,58,78,213
2021,Dartford 005,E02005032,9000,8309,357,268,89,123,56,67,211
2021,Dartford 006,E02005033,7091,6505,271,184,87,111,42,69,204
2021,Dartford 007,E02005034,7340,6726,335,235,100,100,51,49,179
2021,Dartford 008,E02005035,8026,7398,335,262,73,133,61,72,160
2021,Dartford 009,E02005036,6309,5710,238,166,72,132,70,62,229
2021,Dartford 010,E02005037,6774,6149,336,251,85,98,47,51,191
2021,Dartford 011,E02005038,5722,5155,327,241,86,78,36,42,162
2021,Dartford 012,E02005039,6463,5852,277,182,95,129,65,64,205
2021,Dartford 013,E02005040,6534,5833,370,290,80,104,56,48,227
2021,Dover 001,E02005041,6973,6280,353,251,102,120,67,53,220
2021,Dover 002,E02005042,8614,7692,442,289,153,180,90,90,300
2021,Dover 003,E02005043,6881,6147,347,253,94,129,69,60,258
2021,Dover 004,E02005044,5887,5299,317,219,98,103,51,52,168
2021,Dover 005,E02005045,8818,7838,442,302,140,189,76,113,349
2021,Dover 006,E02005046,8297,7395,375,257,118,202,93,109,325
2021,Dover 007,E02005047,7383,6598,376,268,108,142,59,83,267
2021,Dover 008,E02005048,6360,5638,372,267,105,124,62,62,226
2021,Dover 009,E02005049,6740,5978,394,300,94,130,71,59,238
2021,Dover 010,E02005050,9231,8310,497,385,112,164,67,97,260
2021,Dover 011,E02005051,12736,11440,497,352,145,332,148,184,467
2021,Dover 012,E02005052,7875,7188,281,206,75,172,64,108,234
2021,Dover 013,E02005053,8521,7673,344,224,120,220,98,122,284
2021,Dover 014,E02005054,6424,5762,325,217,108,139,78,61,198
2021,Gravesham 001,E02005055,7673,7056,249,170,79,161,71,90,207
2021,Gravesham 002,E02005056,9450,8812,288,195,93,139,71,68,211
2021,Gravesham 003,E02005057,10745,9900,346,226,120,191,95,96,308
2021,Gravesham 004,E02005058,7423,6781,275,187,88,158,74,84,209
2021,Gravesham 005,E02005059,9118,8306,455,342,113,144,71,73,213
2021,Gravesham 006,E02005060,8081,7381,330,233,97,158,75,83,212
2021,Gravesham 007,E02005061,7074,6360,267,193,74,155,74,81,292
2021,Gravesham 008,E02005062,6683,6082,274,191,83,132,65,67,195
2021,Gravesham 009,E02005063,6874,6164,341,242,99,136,63,73,233
2021,Gravesham 010,E02005064,6294,5678,307,219,88,121,60,61,188
2021,Gravesham 011,E02005065,7772,7050,268,179,89,170,87,83,284
2021,Gravesham 012,E02005066,7424,6640,418,305,113,129,60,69,237
2021,Gravesham 013,E02005067,5690,5104,325,251,74,86,35,51,175
2021,Maidstone 001,E02005068,6791,6227,340,266,74,84,49,35,140
2021,Maidstone 002,E02005069,8576,7851,390,287,103,116,61,55,219
2021,Maidstone 003,E02005070,9275,8444,448,334,114,119,62,57,264
2021,Maidstone 004,E02005071,11547,10853,316,235,81,176,81,95,202
2021,Maidstone 005,E02005072,7658,7053,355,279,76,103,49,54,147
2021,Maidstone 006,E02005073,11565,10806,409,315,94,162,72,90,188
2021,Maidstone 007,E02005074,7667,6966,437,334,103,98,48,50,166
2021,Maidstone 008,E02005075,10361,9501,403,266,137,187,92,95,270
2021,Maidstone 009,E02005076,9314,8517,367,266,101,175,70,105,255
2021,Maidstone 010,E02005077,7692,6899,373,264,109,154,58,96,266
2021,Maidstone 011,E02005078,9260,8393,456,350,106,151,73,78,260
2021,Maidstone 012,E02005079,8559,7811,399,284,115,119,64,55,230
2021,Maidstone 013,E02005080,11189,10078,411,277,134,269,130,139,431
2021,Maidstone 014,E02005081,6658,6026,340,260,80,107,52,55,185
2021,Maidstone 015,E02005082,11104,10095,516,384,132,170,80,90,323
2021,Maidstone 016,E02005083,7405,6754,363,278,85,93,37,56,195
2021,Maidstone 017,E02005084,7104,6452,372,291,81,107,52,55,173
2021,Maidstone 018,E02005085,7317,6670,367,283,84,88,34,54,192
2021,Maidstone 019,E02005086,6356,5818,309,231,78,91,38,53,138
2021,Sevenoaks 001,E02005087,6762,6106,362,269,93,106,48,58,188
2021,Sevenoaks 002,E02005088,9260,8256,383,268,115,220,90,130,401
2021,Sevenoaks 003,E02005089,6404,5859,284,209,75,103,53,50,158
2021,Sevenoaks 004,E02005090,5676,5097,302,228,74,95,57,38,182
2021,Sevenoaks 005,E02005091,6428,5847,322,236,86,110,46,64,149
2021,Sevenoaks 007,E02005093,5777,5169,315,237,78,101,49,52,192
2021,Sevenoaks 008,E02005094,9125,8364,440,329,111,130,65,65,191
2021,Sevenoaks 009,E02005095,7189,6538,399,333,66,96,49,47,156
2021,Sevenoaks 010,E02005096,9233,8502,426,323,103,111,47,64,194
2021,Sevenoaks 011,E02005097,9081,8476,406,327,79,75,34,41,124
2021,Sevenoaks 012,E02005098,9655,8973,449,351,98,89,47,42,144
2021,Sevenoaks 013,E02005099,7510,6848,392,306,86,106,55,51,164
2021,Sevenoaks 014,E02005100,9238,8446,441,339,102,121,48,73,230
2021,Sevenoaks 015,E02005101,6741,6175,319,249,70,80,37,43,167
2021,Folkestone and Hythe 001,E02005102,5892,5222,374,278,96,102,56,46,194
2021,Folkestone and Hythe 002,E02005103,9567,8614,424,300,124,199,88,111,330
2021,Folkestone and Hythe 003,E02005104,7580,6767,345,252,93,172,74,98,296
2021,Folkestone and Hythe 004,E02005105,7136,6441,285,198,87,164,65,99,246
2021,Folkestone and Hythe 005,E02005106,9422,8467,418,285,133,227,122,105,310
2021,Folkestone and Hythe 006,E02005107,12421,11187,643,459,184,228,111,117,363
2021,Folkestone and Hythe 008,E02005109,6499,5865,341,262,79,112,72,40,181
2021,Folkestone and Hythe 009,E02005110,6781,6031,377,261,116,126,63,63,247
2021,Folkestone and Hythe 010,E02005111,6935,6194,357,245,112,149,60,89,235
2021,Folkestone and Hythe 011,E02005112,6822,5937,380,266,114,154,77,77,351
2021,Folkestone and Hythe 012,E02005113,6979,6231,306,217,89,162,77,85,280
2021,Folkestone and Hythe 013,E02005114,6076,5332,273,172,101,164,83,81,307
2021,Swale 001,E02005115,6079,5481,191,115,76,153,64,89,254
2021,Swale 002,E02005116,6093,5403,198,134,64,193,81,112,299
2021,Swale 003,E02005117,6330,5616,280,179,101,148,72,76,286
2021,Swale 004,E02005118,10178,9125,475,324,151,240,116,124,338
2021,Swale 005,E02005119,6187,5502,253,178,75,155,64,91,277
2021,Swale 006,E02005120,9290,8360,386,258,128,181,83,98,363
2021,Swale 007,E02005121,13094,11921,530,388,142,235,104,131,408
2021,Swale 008,E02005122,7341,6599,369,272,97,150,79,71,223
2021,Swale 009,E02005123,11906,10861,487,353,134,209,87,122,349
2021,Swale 010,E02005124,8223,7429,272,189,83,205,79,126,317
2021,Swale 011,E02005125,7952,7270,301,233,68,139,55,84,242
2021,Swale 012,E02005126,7720,6976,341,258,83,145,83,62,258
2021,Swale 013,E02005127,8513,7707,396,303,93,134,57,77,276
2021,Swale 014,E02005128,8466,7650,410,306,104,147,72,75,259
2021,Swale 015,E02005129,10869,9892,463,339,124,164,77,87,350
2021,Swale 016,E02005130,8986,8072,428,298,130,174,75,99,312
2021,Swale 017,E02005131,5551,4983,283,213,70,115,60,55,170
2021,Thanet 001,E02005132,9709,8876,268,178,90,251,98,153,314
2021,Thanet 002,E02005133,8329,7425,431,317,114,141,68,73,332
2021,Thanet 003,E02005134,7436,6732,301,196,105,159,65,94,244
2021,Thanet 004,E02005135,7374,6604,303,216,87,170,76,94,297
2021,Thanet 005,E02005136,7678,6838,346,245,101,167,86,81,327
2021,Thanet 006,E02005137,7250,6444,293,192,101,179,87,92,334
2021,Thanet 007,E02005138,8649,7771,379,279,100,176,79,97,323
2021,Thanet 008,E02005139,8602,7610,438,294,144,170,88,82,384
2021,Thanet 009,E02005140,7267,6512,395,286,109,140,67,73,220
2021,Thanet 010,E02005141,6791,6161,338,249,89,111,60,51,181
2021,Thanet 011,E02005142,7013,6167,338,237,101,162,76,86,346
2021,Thanet 012,E02005143,7777,6981,350,237,113,175,70,105,271
2021,Thanet 013,E02005144,8364,7345,323,207,116,244,101,143,452
2021,Thanet 014,E02005145,7682,6853,387,281,106,158,63,95,284
2021,Thanet 015,E02005146,7636,6938,306,217,89,169,73,96,223
2021,Thanet 016,E02005147,8188,7441,334,230,104,166,72,94,247
2021,Thanet 017,E02005148,7511,6709,344,239,105,160,68,92,298
2021,Tonbridge and Malling 001,E02005149,11394,10440,508,377,131,172,79,93,274
2021,Tonbridge and Malling 002,E02005150,11028,10090,430,305,125,201,92,109,307
2021,Tonbridge and Malling 003,E02005151,11960,10915,532,395,137,186,88,98,327
2021,Tonbridge and Malling 005,E02005153,8769,7992,369,279,90,142,68,74,266
2021,Tonbridge and Malling 006,E02005154,11103,10081,584,474,110,173,97,76,265
2021,Tonbridge and Malling 007,E02005155,11870,10948,551,435,116,138,69,69,233
2021,Tonbridge and Malling 008,E02005156,6885,6171,381,282,99,115,50,65,218
2021,Tonbridge and Malling 009,E02005157,6374,5716,289,210,79,145,79,66,224
2021,Tonbridge and Malling 010,E02005158,6326,5774,352,289,63,78,39,39,122
2021,Tonbridge and Malling 011,E02005159,7371,6657,380,282,98,137,75,62,197
2021,Tonbridge and Malling 012,E02005160,11771,10883,476,366,110,166,86,80,246
2021,Tonbridge and Malling 013,E02005161,8051,7410,354,253,101,118,54,64,169
2021,Tunbridge Wells 001,E02005162,10004,9132,490,360,130,145,80,65,237
2021,Tunbridge Wells 002,E02005163,7652,7028,351,268,83,96,43,53,177
2021,Tunbridge Wells 003,E02005164,8317,7764,301,234,67,105,51,54,147
2021,Tunbridge Wells 004,E02005165,7219,6584,378,298,80,99,45,54,158
2021,Tunbridge Wells 005,E02005166,6479,5919,241,169,72,125,53,72,194
2021,Tunbridge Wells 006,E02005167,7313,6707,367,295,72,72,41,31,167
2021,Tunbridge Wells 007,E02005168,7184,6637,351,285,66,85,45,40,111
2021,Tunbridge Wells 008,E02005169,8535,8047,290,220,70,102,46,56,96
2021,Tunbridge Wells 009,E02005170,9244,8592,394,309,85,106,48,58,152
2021,Tunbridge Wells 010,E02005171,5817,5281,246,189,57,98,36,62,192
2021,Tunbridge Wells 011,E02005172,7884,7234,419,323,96,92,44,48,139
2021,Tunbridge Wells 012,E02005173,7976,7378,389,316,73,77,42,35,132
2021,Tunbridge Wells 013,E02005174,7190,6583,329,250,79,102,49,53,176
2021,Tunbridge Wells 014,E02005175,8332,7644,407,308,99,107,53,54,174
2021,Burnley 001,E02005176,8575,7755,389,281,108,187,89,98,244
2021,Burnley 002,E02005177,6233,5726,213,134,79,132,61,71,162
2021,Burnley 003,E02005178,10854,10043,255,149,106,297,125,172,259
2021,Burnley 004,E02005179,8754,7860,377,263,114,184,84,100,333
2021,Burnley 005,E02005180,6748,6088,333,239,94,126,62,64,201
2021,Burnley 006,E02005181,6225,5642,222,153,69,142,65,77,219
2021,Burnley 007,E02005182,5890,5363,219,142,77,125,53,72,183
2021,Burnley 008,E02005183,5795,5153,305,210,95,148,81,67,189
2021,Burnley 009,E02005184,4921,4412,270,188,82,96,51,45,143
2021,Burnley 010,E02005185,8897,8016,291,198,93,249,115,134,341
2021,Burnley 011,E02005186,5907,5309,293,228,65,133,62,71,172
2021,Chorley 001,E02005189,5013,4468,237,163,74,111,52,59,197
2021,Chorley 002,E02005190,5767,5163,360,275,85,107,54,53,137
2021,Chorley 003,E02005191,9178,8343,430,334,96,161,67,94,244
2021,Chorley 004,E02005192,8368,7630,448,337,111,113,60,53,177
2021,Chorley 005,E02005193,8305,7510,434,322,112,144,80,64,217
2021,Chorley 006,E02005194,7577,6878,355,248,107,139,59,80,205
2021,Chorley 007,E02005195,7651,7063,389,302,87,89,48,41,110
2021,Chorley 008,E02005196,10570,9647,507,378,129,150,67,83,266
2021,Chorley 009,E02005197,6811,6170,279,211,68,145,61,84,217
2021,Chorley 010,E02005198,9151,8284,420,293,127,178,90,88,269
2021,Chorley 011,E02005199,7252,6478,465,326,139,121,64,57,188
2021,Chorley 012,E02005200,8616,7791,378,261,117,181,78,103,266
2021,Chorley 013,E02005201,7872,7065,362,253,109,166,76,90,279
2021,Chorley 014,E02005202,9546,8639,478,350,128,193,86,107,236
2021,Fylde 001,E02005203,8045,7212,444,324,120,166,82,84,223
2021,Fylde 002,E02005204,11909,10766,581,443,138,206,94,112,356
2021,Fylde 003,E02005205,6416,5777,353,272,81,90,49,41,196
2021,Fylde 004,E02005206,7221,6432,380,284,96,170,88,82,239
2021,Fylde 005,E02005207,8232,7343,448,310,138,161,76,85,280
2021,Fylde 006,E02005208,9744,8769,480,348,132,198,82,116,297
2021,Fylde 007,E02005209,8362,7503,404,302,102,173,95,78,282
2021,Fylde 008,E02005210,9934,8935,528,402,126,186,96,90,285
2021,Fylde 009,E02005211,8204,7370,476,336,140,136,79,57,222
2021,Hyndburn 001,E02005212,10410,9370,481,337,144,232,107,125,327
2021,Hyndburn 002,E02005213,10827,9754,494,359,135,236,106,130,343
2021,Hyndburn 003,E02005214,6290,5628,310,206,104,142,56,86,210
2021,Hyndburn 004,E02005215,11782,10620,497,325,172,270,127,143,395
2021,Hyndburn 005,E02005216,5009,4520,182,129,53,107,42,65,200
2021,Hyndburn 006,E02005217,12309,11257,329,178,151,344,152,192,379
2021,Hyndburn 007,E02005218,6850,6189,281,193,88,152,55,97,228
2021,Hyndburn 008,E02005219,8187,7329,447,307,140,171,84,87,240
2021,Hyndburn 009,E02005220,5641,4970,326,238,88,126,60,66,219
2021,Lancaster 001,E02005221,9556,8611,544,400,144,147,65,82,254
2021,Lancaster 002,E02005222,5772,5174,357,272,85,83,35,48,158
2021,Lancaster 003,E02005223,6981,6257,429,322,107,93,45,48,202
2021,Lancaster 004,E02005224,5027,4466,270,194,76,96,50,46,195
2021,Lancaster 005,E02005225,5747,5198,320,248,72,86,50,36,143
2021,Lancaster 006,E02005226,7012,6250,302,203,99,211,88,123,249
2021,Lancaster 008,E02005228,5423,4812,243,164,79,163,75,88,205
2021,Lancaster 009,E02005229,5412,4872,203,147,56,124,48,76,213
2021,Lancaster 010,E02005230,6228,5521,270,194,76,170,71,99,267
2021,Lancaster 011,E02005231,7766,7057,293,202,91,163,74,89,253
2021,Lancaster 013,E02005233,7593,6951,336,234,102,129,57,72,177
2021,Lancaster 014,E02005234,8815,8408,237,189,48,73,31,42,97
2021,Lancaster 015,E02005235,4921,4607,182,138,44,49,23,26,83
2021,Lancaster 016,E02005236,12689,11361,583,407,176,282,129,153,463
2021,Lancaster 017,E02005237,9830,8989,470,353,117,175,92,83,196
2021,Lancaster 018,E02005238,5305,4852,246,175,71,94,49,45,113
2021,Lancaster 019,E02005239,10590,9904,444,350,94,95,52,43,147
2021,Pendle 001,E02005240,5238,4802,216,145,71,77,32,45,143
2021,Pendle 002,E02005241,5321,4827,256,189,67,97,40,57,141
2021,Pendle 003,E02005242,5905,5354,254,181,73,124,64,60,173
2021,Pendle 006,E02005245,6636,6021,350,254,96,94,43,51,171
2021,Pendle 007,E02005246,5082,4613,190,130,60,110,42,68,169
2021,Pendle 008,E02005247,9396,8442,557,431,126,171,90,81,226
2021,Pendle 009,E02005248,7137,6561,181,105,76,205,73,132,190
2021,Pendle 010,E02005249,9616,8828,279,186,93,225,93,132,284
2021,Pendle 011,E02005250,8741,8048,235,151,84,229,115,114,229
2021,Pendle 012,E02005251,6828,6153,280,181,99,148,57,91,247
2021,Pendle 013,E02005252,9710,8787,371,252,119,260,111,149,292
2021,Preston 001,E02005253,6775,6185,350,275,75,93,46,47,147
2021,Preston 002,E02005254,9137,8336,495,376,119,131,75,56,175
2021,Preston 003,E02005255,9021,8198,436,306,130,171,70,101,216
2021,Preston 004,E02005256,6521,5927,334,245,89,116,59,57,144
2021,Preston 005,E02005257,5431,4875,215,142,73,148,62,86,193
2021,Preston 006,E02005258,7983,7170,407,278,129,151,77,74,255
2021,Preston 007,E02005259,9865,8955,355,237,118,242,107,135,313
2021,Preston 008,E02005260,6360,5717,342,235,107,120,68,52,181
2021,Preston 009,E02005261,9579,8635,308,204,104,258,98,160,378
2021,Preston 010,E02005262,6854,6242,344,244,100,100,54,46,168
2021,Preston 011,E02005263,6700,6186,214,138,76,135,60,75,165
2021,Preston 012,E02005264,11748,10891,429,276,153,211,100,111,217
2021,Preston 013,E02005265,10161,9106,443,323,120,265,127,138,347
2021,Preston 014,E02005266,8181,7572,235,147,88,171,67,104,203
2021,Preston 015,E02005267,6052,5639,148,86,62,139,68,71,126
2021,Preston 016,E02005268,8632,7926,272,157,115,205,86,119,229
2021,Preston 017,E02005269,9919,9211,333,222,111,182,83,99,193
2021,Ribble Valley 001,E02005270,7192,6518,434,324,110,105,58,47,135
2021,Ribble Valley 002,E02005271,7774,7099,387,296,91,109,55,54,179
2021,Ribble Valley 003,E02005272,8508,7808,360,274,86,127,67,60,213
2021,Ribble Valley 004,E02005273,5666,5104,328,247,81,106,64,42,128
2021,Ribble Valley 005,E02005274,7481,6768,440,342,98,113,68,45,160
2021,Ribble Valley 006,E02005275,5449,4995,243,169,74,80,47,33,131
2021,Ribble Valley 007,E02005276,8463,7722,451,346,105,109,48,61,181
2021,Ribble Valley 008,E02005277,8401,7569,516,378,138,141,72,69,175
2021,Rossendale 001,E02005278,7525,6877,361,271,90,118,58,60,169
2021,Rossendale 002,E02005279,9732,8825,426,302,124,193,75,118,288
2021,Rossendale 003,E02005280,10487,9466,412,271,141,248,106,142,361
2021,Rossendale 004,E02005281,8390,7659,340,252,88,169,72,97,222
2021,Rossendale 007,E02005284,5810,5237,327,244,83,98,43,55,148
2021,Rossendale 008,E02005285,6003,5463,292,207,85,94,51,43,154
2021,Rossendale 009,E02005286,7410,6649,334,243,91,176,95,81,251
2021,South Ribble 001,E02005287,5093,4599,292,229,63,80,31,49,122
2021,South Ribble 002,E02005288,5696,5141,296,208,88,101,45,56,158
2021,South Ribble 003,E02005289,5636,5109,290,234,56,103,60,43,134
2021,South Ribble 004,E02005290,6812,6156,402,312,90,100,44,56,154
2021,South Ribble 005,E02005291,5382,4824,280,189,91,114,46,68,164
2021,South Ribble 006,E02005292,5334,4782,272,186,86,114,49,65,166
2021,South Ribble 007,E02005293,5194,4660,274,179,95,95,52,43,165
2021,South Ribble 008,E02005294,6650,6052,283,216,67,123,47,76,192
2021,South Ribble 009,E02005295,7146,6460,391,284,107,108,57,51,187
2021,South Ribble 010,E02005296,5851,5217,369,278,91,86,45,41,179
2021,South Ribble 011,E02005297,7973,7123,484,370,114,143,71,72,223
2021,South Ribble 012,E02005298,7895,7139,397,290,107,151,70,81,208
2021,South Ribble 013,E02005299,6965,6333,336,260,76,127,59,68,169
2021,South Ribble 014,E02005300,4822,4355,263,200,63,87,38,49,117
2021,South Ribble 015,E02005301,5819,5229,263,199,64,147,72,75,180
2021,South Ribble 016,E02005302,7306,6626,381,304,77,121,59,62,178
2021,South Ribble 017,E02005303,5965,5380,223,142,81,146,71,75,216
2021,West Lancashire 001,E02005304,8620,7707,499,365,134,147,83,64,267
2021,West Lancashire 002,E02005305,7644,6759,421,297,124,172,80,92,292
2021,West Lancashire 003,E02005306,7206,6411,414,277,137,141,72,69,240
2021,West Lancashire 004,E02005307,9154,8238,472,334,138,182,85,97,262
2021,West Lancashire 005,E02005308,6299,5669,354,254,100,111,61,50,165
2021,West Lancashire 006,E02005309,8415,7533,460,323,137,152,74,78,270
2021,West Lancashire 007,E02005310,9910,9261,354,268,86,126,63,63,169
2021,West Lancashire 008,E02005311,6591,5973,367,276,91,98,46,52,153
2021,West Lancashire 009,E02005312,6022,5400,305,228,77,121,68,53,196
2021,West Lancashire 010,E02005313,8312,7483,274,171,103,216,91,125,339
2021,West Lancashire 011,E02005314,6083,5435,270,180,90,150,72,78,228
2021,West Lancashire 012,E02005315,7760,6878,502,380,122,131,91,40,249
2021,West Lancashire 013,E02005316,6145,5553,236,165,71,132,59,73,224
2021,West Lancashire 014,E02005317,6787,6137,208,127,81,176,80,96,266
2021,West Lancashire 015,E02005318,7236,6437,396,285,111,162,85,77,241
2021,Wyre 001,E02005319,7725,6877,330,213,117,243,103,140,275
2021,Wyre 002,E02005320,5583,4942,284,195,89,147,56,91,210
2021,Wyre 003,E02005321,5826,5079,258,165,93,158,50,108,331
2021,Wyre 004,E02005322,9922,8762,525,374,151,199,98,101,436
2021,Wyre 005,E02005323,7098,6302,317,221,96,179,63,116,300
2021,Wyre 006,E02005324,6937,6322,342,267,75,113,59,54,160
2021,Wyre 007,E02005325,8990,8075,480,370,110,149,91,58,286
2021,Wyre 008,E02005326,8003,7021,385,259,126,225,100,125,372
2021,Wyre 009,E02005327,6417,5668,371,273,98,133,78,55,245
2021,Wyre 010,E02005328,7283,6348,457,319,138,174,88,86,304
2021,Wyre 011,E02005329,8832,7901,468,321,147,167,70,97,296
2021,Wyre 012,E02005330,8500,7535,498,360,138,172,80,92,295
2021,Wyre 013,E02005331,7958,7173,406,307,99,141,69,72,238
2021,Wyre 014,E02005332,7980,7095,484,363,121,141,79,62,260
2021,Blaby 002,E02005334,5698,5214,257,187,70,114,60,54,113
2021,Blaby 003,E02005335,7205,6531,382,296,86,108,47,61,184
2021,Blaby 004,E02005336,6806,6215,292,212,80,139,61,78,160
2021,Blaby 005,E02005337,9455,8578,423,286,137,216,117,99,238
2021,Blaby 006,E02005338,10687,9704,499,371,128,192,97,95,292
2021,Blaby 007,E02005339,8237,7469,478,358,120,121,61,60,169
2021,Blaby 008,E02005340,8429,7638,399,291,108,130,64,66,262
2021,Blaby 009,E02005341,7156,6461,370,294,76,126,59,67,199
2021,Blaby 010,E02005342,7008,6365,343,260,83,122,57,65,178
2021,Blaby 011,E02005343,7574,6852,417,320,97,108,58,50,197
2021,Blaby 012,E02005344,8670,7920,406,297,109,122,55,67,222
2021,Charnwood 001,E02005345,6073,5486,312,233,79,116,61,55,159
2021,Charnwood 002,E02005346,11930,11043,374,254,120,221,95,126,292
2021,Charnwood 003,E02005347,10975,10394,315,242,73,113,51,62,153
2021,Charnwood 004,E02005348,5326,4866,239,179,60,83,40,43,138
2021,Charnwood 005,E02005349,7473,6783,348,262,86,125,59,66,217
2021,Charnwood 006,E02005350,6598,6020,329,259,70,86,41,45,163
2021,Charnwood 007,E02005351,10981,10385,316,248,68,113,58,55,167
2021,Charnwood 008,E02005352,6019,5489,344,267,77,76,51,25,110
2021,Charnwood 009,E02005353,10089,9210,395,290,105,199,88,111,285
2021,Charnwood 010,E02005354,9706,8837,541,408,133,122,71,51,206
2021,Charnwood 011,E02005355,6978,6358,351,264,87,116,65,51,153
2021,Charnwood 012,E02005356,6956,6390,345,262,83,81,47,34,140
2021,Charnwood 013,E02005357,7898,7176,390,293,97,112,58,54,220
2021,Charnwood 014,E02005358,11450,10462,574,445,129,172,86,86,242
2021,Charnwood 015,E02005359,7232,6575,372,283,89,111,60,51,174
2021,Charnwood 016,E02005360,6080,5476,385,298,87,76,43,33,143
2021,Charnwood 017,E02005361,6005,5442,330,230,100,109,58,51,124
2021,Charnwood 018,E02005362,6838,6191,334,245,89,118,61,57,195
2021,Charnwood 019,E02005363,8555,7706,477,339,138,141,76,65,231
2021,Charnwood 020,E02005364,5007,4499,288,222,66,86,51,35,134
2021,Charnwood 021,E02005365,9391,8453,418,285,133,193,99,94,327
2021,Charnwood 022,E02005366,7232,6617,318,224,94,105,42,63,192
2021,Harborough 002,E02005368,6178,5665,353,271,82,66,39,27,94
2021,Harborough 003,E02005369,12056,10913,676,511,165,193,99,94,274
2021,Harborough 004,E02005370,9165,8415,452,342,110,124,64,60,174
2021,Harborough 005,E02005371,10307,9383,558,418,140,156,79,77,210
2021,Harborough 006,E02005372,9788,8908,564,417,147,140,84,56,176
2021,Harborough 007,E02005373,11590,10583,595,460,135,147,78,69,265
2021,Harborough 008,E02005374,6294,5753,259,198,61,107,51,56,175
2021,Harborough 009,E02005375,8918,8210,418,327,91,131,82,49,159
2021,Harborough 010,E02005376,10286,9438,478,338,140,122,62,60,248
2021,Hinckley and Bosworth 001,E02005377,8595,7739,449,311,138,165,82,83,242
2021,Hinckley and Bosworth 002,E02005378,5061,4572,274,201,73,77,41,36,138
2021,Hinckley and Bosworth 003,E02005379,5743,5183,326,261,65,97,57,40,137
2021,Hinckley and Bosworth 004,E02005380,8305,7533,463,348,115,102,51,51,207
2021,Hinckley and Bosworth 005,E02005381,8473,7651,439,309,130,138,70,68,245
2021,Hinckley and Bosworth 006,E02005382,10057,9096,468,346,122,188,78,110,305
2021,Hinckley and Bosworth 007,E02005383,8715,7873,383,269,114,184,66,118,275
2021,Hinckley and Bosworth 008,E02005384,7104,6398,409,311,98,107,54,53,190
2021,Hinckley and Bosworth 009,E02005385,6345,5706,374,295,79,101,59,42,164
2021,Hinckley and Bosworth 010,E02005386,8615,7841,418,300,118,155,73,82,201
2021,Hinckley and Bosworth 011,E02005387,9363,8536,437,313,124,138,60,78,252
2021,Hinckley and Bosworth 012,E02005388,5858,5349,263,210,53,90,36,54,156
2021,Hinckley and Bosworth 013,E02005389,5793,5187,293,214,79,103,40,63,210
2021,Hinckley and Bosworth 014,E02005390,9928,9051,517,406,111,114,52,62,246
2021,Melton 001,E02005391,9372,8436,572,439,133,125,55,70,239
2021,Melton 002,E02005392,8815,8068,401,303,98,122,59,63,224
2021,Melton 003,E02005393,7073,6373,405,300,105,98,44,54,197
2021,Melton 004,E02005394,9025,8259,371,270,101,174,70,104,221
2021,Melton 005,E02005395,8399,7687,360,272,88,146,71,75,206
2021,Melton 006,E02005396,6649,6006,380,292,88,92,49,43,171
2021,North West Leicestershire 001,E02005397,8823,7988,459,344,115,150,76,74,226
2021,North West Leicestershire 002,E02005398,6595,6010,330,253,77,101,44,57,154
2021,North West Leicestershire 003,E02005399,7858,7211,362,282,80,101,50,51,184
2021,North West Leicestershire 004,E02005400,5548,4978,270,200,70,121,62,59,179
2021,North West Leicestershire 005,E02005401,6187,5585,348,245,103,109,48,61,145
2021,North West Leicestershire 006,E02005402,6501,5931,330,248,82,78,39,39,162
2021,North West Leicestershire 007,E02005403,6261,5614,338,258,80,109,51,58,200
2021,North West Leicestershire 008,E02005404,8279,7468,400,295,105,146,69,77,265
2021,North West Leicestershire 009,E02005405,6820,6091,321,227,94,155,64,91,253
2021,North West Leicestershire 010,E02005406,7373,6744,294,200,94,149,63,86,186
2021,North West Leicestershire 011,E02005407,10266,9400,450,320,130,157,73,84,259
2021,North West Leicestershire 012,E02005408,7441,6792,316,226,90,137,60,77,196
2021,North West Leicestershire 013,E02005409,11306,10233,520,389,131,209,80,129,344
2021,Oadby and Wigston 003,E02005412,8387,7591,400,297,103,169,92,77,227
2021,Oadby and Wigston 005,E02005414,7771,7033,322,232,90,171,66,105,245
2021,Oadby and Wigston 006,E02005415,7604,6883,344,240,104,162,73,89,215
2021,Oadby and Wigston 007,E02005416,8593,7739,451,318,133,158,68,90,245
2021,Boston 001,E02005417,7301,6488,350,241,109,164,73,91,299
2021,Boston 002,E02005418,10321,9601,249,162,87,209,85,124,262
2021,Boston 003,E02005419,8228,7756,214,147,67,115,53,62,143
2021,Boston 004,E02005420,8382,7703,265,186,79,168,70,98,246
2021,Boston 006,E02005422,6381,5662,311,223,88,128,66,62,280
2021,Boston 007,E02005423,9911,8912,434,302,132,212,95,117,353
2021,East Lindsey 001,E02005424,9827,8717,522,360,162,209,110,99,379
2021,East Lindsey 002,E02005425,6279,5504,329,228,101,170,81,89,276
2021,East Lindsey 003,E02005426,9905,8757,496,351,145,265,103,162,387
2021,East Lindsey 004,E02005427,6639,6001,324,241,83,131,59,72,183
2021,East Lindsey 005,E02005428,8155,7090,319,193,126,258,111,147,488
2021,East Lindsey 006,E02005429,6118,5171,307,195,112,178,79,99,462
2021,East Lindsey 007,E02005430,6809,5990,364,271,93,152,86,66,303
2021,East Lindsey 008,E02005431,8508,7452,392,261,131,252,113,139,412
2021,East Lindsey 009,E02005432,7505,6667,404,293,111,158,76,82,276
2021,East Lindsey 010,E02005433,6847,5856,251,153,98,242,102,140,498
2021,East Lindsey 011,E02005434,7197,6422,361,272,89,167,87,80,247
2021,East Lindsey 012,E02005435,7492,6565,278,183,95,218,99,119,431
2021,East Lindsey 013,E02005436,7865,6951,394,278,116,176,90,86,344
2021,East Lindsey 014,E02005437,5939,5387,194,134,60,150,66,84,208
2021,East Lindsey 015,E02005438,6652,5788,275,174,101,203,92,111,386
2021,East Lindsey 016,E02005439,11401,10269,480,336,144,211,104,107,441
2021,East Lindsey 017,E02005440,5332,4610,240,160,80,176,87,89,306
2021,East Lindsey 018,E02005441,8196,7234,415,282,133,188,84,104,359
2021,Lincoln 001,E02005442,6160,5495,235,154,81,167,72,95,263
2021,Lincoln 002,E02005443,7070,6441,258,174,84,124,56,68,247
2021,Lincoln 003,E02005444,13053,12173,457,347,110,178,77,101,245
2021,Lincoln 004,E02005445,11984,11053,352,228,124,232,91,141,347
2021,Lincoln 005,E02005446,10292,9885,269,209,60,61,27,34,77
2021,Lincoln 006,E02005447,7947,7525,198,150,48,95,33,62,129
2021,Lincoln 007,E02005448,6826,6157,247,175,72,154,60,94,268
2021,Lincoln 008,E02005449,9014,8339,346,252,94,124,73,51,205
2021,Lincoln 009,E02005450,8018,7221,377,262,115,157,81,76,263
2021,Lincoln 010,E02005451,7513,6817,247,175,72,181,76,105,268
2021,Lincoln 011,E02005452,10820,9746,524,366,158,206,98,108,344
2021,North Kesteven 001,E02005453,10324,9307,535,392,143,175,91,84,307
2021,North Kesteven 003,E02005455,13684,12489,617,472,145,209,114,95,369
2021,North Kesteven 004,E02005456,10281,9387,414,308,106,170,76,94,310
2021,North Kesteven 005,E02005457,8328,7497,393,291,102,164,76,88,274
2021,North Kesteven 006,E02005458,6502,5842,357,269,88,123,70,53,180
2021,North Kesteven 007,E02005459,8123,7169,393,276,117,198,98,100,363
2021,North Kesteven 008,E02005460,6047,5576,220,165,55,81,42,39,170
2021,North Kesteven 009,E02005461,6165,5480,349,252,97,107,47,60,229
2021,North Kesteven 010,E02005462,9299,8454,355,244,111,194,101,93,296
2021,North Kesteven 011,E02005463,9477,8731,378,286,92,132,69,63,236
2021,North Kesteven 012,E02005464,8331,7442,429,313,116,169,86,83,291
2021,South Holland 001,E02005465,8424,7544,383,282,101,172,74,98,325
2021,South Holland 002,E02005466,6478,5767,300,199,101,144,64,80,267
2021,South Holland 003,E02005467,7334,6612,316,230,86,149,69,80,257
2021,South Holland 004,E02005468,7319,6570,351,257,94,128,70,58,270
2021,South Holland 005,E02005469,7542,6846,303,224,79,139,59,80,254
2021,South Holland 006,E02005470,12159,11355,376,251,125,170,81,89,258
2021,South Holland 007,E02005471,8676,7961,313,218,95,163,70,93,239
2021,South Holland 008,E02005472,9488,8462,425,290,135,227,103,124,374
2021,South Holland 009,E02005473,9294,8575,366,260,106,139,65,74,214
2021,South Holland 010,E02005474,6848,6057,361,256,105,136,67,69,294
2021,South Holland 011,E02005475,6823,6113,354,255,99,125,55,70,231
2021,South Kesteven 001,E02005476,6941,6238,397,294,103,105,51,54,201
2021,South Kesteven 002,E02005477,8784,7881,471,365,106,151,82,69,281
2021,South Kesteven 003,E02005478,9559,8623,402,295,107,203,85,118,331
2021,South Kesteven 004,E02005479,9322,8589,411,312,99,94,56,38,228
2021,South Kesteven 005,E02005480,6907,6260,217,148,69,169,79,90,261
2021,South Kesteven 006,E02005481,11533,10671,424,305,119,173,75,98,265
2021,South Kesteven 007,E02005482,9233,8363,491,362,129,134,80,54,245
2021,South Kesteven 008,E02005483,7578,6774,374,287,87,169,76,93,261
2021,South Kesteven 009,E02005484,6886,6235,321,235,86,129,53,76,201
2021,South Kesteven 010,E02005485,7930,7301,325,250,75,100,55,45,204
2021,South Kesteven 011,E02005486,9056,8288,372,269,103,139,72,67,257
2021,South Kesteven 012,E02005487,9445,8519,549,419,130,133,81,52,244
2021,South Kesteven 013,E02005488,6746,6206,281,206,75,101,40,61,158
2021,South Kesteven 014,E02005489,6944,6322,376,282,94,114,49,65,132
2021,South Kesteven 015,E02005490,8783,7997,368,267,101,155,63,92,263
2021,South Kesteven 016,E02005491,11004,10140,493,385,108,168,72,96,203
2021,West Lindsey 001,E02005492,9467,8510,493,386,107,159,95,64,305
2021,West Lindsey 002,E02005493,9689,8778,443,332,111,179,80,99,289
2021,West Lindsey 003,E02005494,9303,8378,467,329,138,163,73,90,295
2021,West Lindsey 004,E02005495,9883,8869,388,259,129,266,100,166,360
2021,West Lindsey 005,E02005496,6024,5393,303,213,90,129,70,59,199
2021,West Lindsey 006,E02005497,6960,6207,296,193,103,183,66,117,274
2021,West Lindsey 007,E02005498,7152,6396,377,279,98,133,64,69,246
2021,West Lindsey 008,E02005499,8177,7393,427,316,111,136,76,60,221
2021,West Lindsey 009,E02005500,7007,6356,344,241,103,114,61,53,193
2021,West Lindsey 010,E02005501,7752,7037,412,302,110,103,59,44,200
2021,West Lindsey 011,E02005502,9333,8345,476,332,144,174,95,79,338
2021,Breckland 001,E02005503,7151,6514,335,260,75,114,55,59,188
2021,Breckland 002,E02005504,8905,7993,420,309,111,178,85,93,314
2021,Breckland 003,E02005505,7276,6582,338,243,95,126,53,73,230
2021,Breckland 004,E02005506,6689,6006,310,219,91,124,60,64,249
2021,Breckland 005,E02005507,11050,10045,450,330,120,223,100,123,332
2021,Breckland 006,E02005508,6975,6287,372,279,93,134,74,60,182
2021,Breckland 007,E02005509,8148,7382,348,244,104,154,62,92,264
2021,Breckland 008,E02005510,7055,6233,381,291,90,150,80,70,291
2021,Breckland 009,E02005511,8506,7734,314,218,96,167,77,90,291
2021,Breckland 010,E02005512,9639,8795,413,322,91,172,79,93,259
2021,Breckland 011,E02005513,10000,9092,437,324,113,220,98,122,251
2021,Breckland 012,E02005514,6557,5865,324,209,115,144,65,79,224
2021,Breckland 013,E02005515,6213,5630,313,234,79,107,54,53,163
2021,Breckland 014,E02005516,6748,6128,330,242,88,97,48,49,193
2021,Breckland 015,E02005517,5562,5139,155,114,41,111,46,65,157
2021,Breckland 016,E02005518,10108,9413,348,249,99,120,62,58,227
2021,Breckland 017,E02005519,8105,7406,265,194,71,167,79,88,267
2021,Broadland 001,E02005520,8525,7672,469,348,121,124,74,50,260
2021,Broadland 002,E02005521,8336,7516,456,337,119,132,80,52,232
2021,Broadland 003,E02005522,5264,4746,286,222,64,81,32,49,151
2021,Broadland 004,E02005523,8145,7471,361,272,89,121,58,63,192
2021,Broadland 005,E02005524,5107,4620,265,208,57,79,34,45,143
2021,Broadland 006,E02005525,9417,8617,476,365,111,129,68,61,195
2021,Broadland 007,E02005526,5126,4679,236,175,61,87,40,47,124
2021,Broadland 008,E02005527,8689,7845,473,361,112,127,58,69,244
2021,Broadland 009,E02005528,8099,7319,450,327,123,128,59,69,202
2021,Broadland 010,E02005529,5475,4917,286,217,69,95,41,54,177
2021,Broadland 011,E02005530,5204,4748,222,155,67,91,53,38,143
2021,Broadland 012,E02005531,5119,4593,299,227,72,100,48,52,127
2021,Broadland 013,E02005532,8974,8215,405,301,104,133,69,64,221
2021,Broadland 014,E02005533,8651,7801,487,365,122,132,70,62,231
2021,Broadland 015,E02005534,7076,6421,390,299,91,103,46,57,162
2021,Broadland 016,E02005535,6861,6304,332,238,94,102,51,51,123
2021,Broadland 017,E02005536,5947,5355,339,258,81,102,54,48,151
2021,Broadland 018,E02005537,5768,5194,273,200,73,107,54,53,194
2021,Great Yarmouth 001,E02005538,9375,8384,394,256,138,187,84,103,410
2021,Great Yarmouth 002,E02005539,7702,6831,401,293,108,168,71,97,302
2021,Great Yarmouth 003,E02005540,8520,7587,364,240,124,190,96,94,379
2021,Great Yarmouth 004,E02005541,5630,5034,240,151,89,147,60,87,209
2021,Great Yarmouth 005,E02005542,6722,6062,215,140,75,202,66,136,243
2021,Great Yarmouth 006,E02005543,8697,7897,230,138,92,250,83,167,320
2021,Great Yarmouth 007,E02005544,6657,6027,224,158,66,173,62,111,233
2021,Great Yarmouth 008,E02005545,6226,5603,287,185,102,121,58,63,215
2021,Great Yarmouth 009,E02005546,7432,6612,313,204,109,212,75,137,295
2021,Great Yarmouth 010,E02005547,8132,7280,381,277,104,183,83,100,288
2021,Great Yarmouth 011,E02005548,6968,6165,263,167,96,244,111,133,296
2021,Great Yarmouth 012,E02005549,5403,4817,253,179,74,124,48,76,209
2021,Great Yarmouth 013,E02005550,7333,6610,351,255,96,145,64,81,227
2021,King's Lynn and West Norfolk 001,E02005551,5097,4558,234,153,81,98,51,47,207
2021,King's Lynn and West Norfolk 002,E02005552,6327,5667,342,248,94,126,77,49,192
2021,King's Lynn and West Norfolk 003,E02005553,8486,7588,396,303,93,175,81,94,327
2021,King's Lynn and West Norfolk 004,E02005554,6816,6056,334,235,99,145,67,78,281
2021,King's Lynn and West Norfolk 005,E02005555,6592,5977,355,262,93,110,53,57,150
2021,King's Lynn and West Norfolk 006,E02005556,7344,6711,329,230,99,125,48,77,179
2021,King's Lynn and West Norfolk 007,E02005557,6385,5821,168,100,68,146,68,78,250
2021,King's Lynn and West Norfolk 008,E02005558,7041,6253,355,251,104,152,73,79,281
2021,King's Lynn and West Norfolk 009,E02005559,6981,6385,244,177,67,141,68,73,211
2021,King's Lynn and West Norfolk 010,E02005560,8493,7804,298,215,83,147,61,86,244
2021,King's Lynn and West Norfolk 011,E02005561,10211,9431,324,236,88,194,95,99,262
2021,King's Lynn and West Norfolk 012,E02005562,7158,6375,397,295,102,138,68,70,248
2021,King's Lynn and West Norfolk 013,E02005563,7692,6826,412,289,123,157,60,97,297
2021,King's Lynn and West Norfolk 014,E02005564,9176,8299,448,316,132,151,89,62,278
2021,King's Lynn and West Norfolk 015,E02005565,6993,6256,362,258,104,125,65,60,250
2021,King's Lynn and West Norfolk 016,E02005566,9922,8838,446,315,131,216,102,114,422
2021,King's Lynn and West Norfolk 017,E02005567,10810,9805,459,336,123,181,103,78,365
2021,King's Lynn and West Norfolk 018,E02005568,7284,6551,348,243,105,134,69,65,251
2021,King's Lynn and West Norfolk 019,E02005569,8254,7528,352,249,103,136,53,83,238
2021,North Norfolk 001,E02005570,6911,6191,372,274,98,117,59,58,231
2021,North Norfolk 002,E02005571,5638,5024,323,256,67,96,51,45,195
2021,North Norfolk 003,E02005572,7312,6592,335,235,100,138,61,77,247
2021,North Norfolk 004,E02005573,5545,4996,251,188,63,114,62,52,184
2021,North Norfolk 005,E02005574,6721,5945,414,295,119,133,74,59,229
2021,North Norfolk 006,E02005575,6784,6083,371,285,86,113,63,50,217
2021,North Norfolk 007,E02005576,6445,5689,360,271,89,143,67,76,253
2021,North Norfolk 008,E02005577,5734,5168,266,181,85,106,51,55,194
2021,North Norfolk 009,E02005578,5653,5110,266,198,68,123,60,63,154
2021,North Norfolk 011,E02005580,7646,6936,346,268,78,144,64,80,220
2021,North Norfolk 012,E02005581,7565,6877,358,271,87,130,73,57,200
2021,North Norfolk 013,E02005582,6547,5832,341,246,95,128,67,61,246
2021,North Norfolk 014,E02005583,8362,7463,435,321,114,138,72,66,326
2021,Norwich 001,E02005584,10466,9596,387,279,108,197,97,100,286
2021,Norwich 002,E02005585,10560,9618,376,277,99,257,107,150,309
2021,Norwich 003,E02005586,9812,9090,377,295,82,155,71,84,190
2021,Norwich 004,E02005587,9805,8858,393,266,127,201,93,108,353
2021,Norwich 005,E02005588,12306,11349,405,262,143,233,102,131,319
2021,Norwich 006,E02005589,11552,10558,432,305,127,241,94,147,321
2021,Norwich 009,E02005592,8829,8268,379,308,71,95,54,41,87
2021,Norwich 010,E02005593,10553,9894,328,253,75,138,67,71,193
2021,Norwich 011,E02005594,10524,9723,487,383,104,133,72,61,181
2021,Norwich 012,E02005595,9041,8204,504,381,123,117,51,66,216
2021,Norwich 013,E02005596,9347,8524,394,269,125,175,73,102,254
2021,South Norfolk 002,E02005598,9380,8595,450,337,113,135,66,69,200
2021,South Norfolk 003,E02005599,6776,6202,309,225,84,118,58,60,147
2021,South Norfolk 004,E02005600,6151,5581,326,251,75,76,45,31,168
2021,South Norfolk 005,E02005601,5286,4798,268,213,55,83,36,47,137
2021,South Norfolk 006,E02005602,12048,10890,695,530,165,172,91,81,291
2021,South Norfolk 007,E02005603,11964,11050,507,381,126,139,73,66,268
2021,South Norfolk 008,E02005604,8419,7586,499,384,115,133,70,63,201
2021,South Norfolk 009,E02005605,10193,9229,567,431,136,123,66,57,274
2021,South Norfolk 010,E02005606,5660,5082,321,235,86,100,50,50,157
2021,South Norfolk 011,E02005607,11012,9983,574,446,128,186,96,90,269
2021,South Norfolk 012,E02005608,7362,6640,392,283,109,127,67,60,203
2021,South Norfolk 013,E02005609,7223,6554,379,284,95,102,40,62,188
2021,South Norfolk 014,E02005610,7793,7033,403,284,119,134,68,66,223
2021,South Norfolk 015,E02005611,10447,9579,459,331,128,145,65,80,264
2021,North Northamptonshire 002,E02005612,6941,6363,288,209,79,116,61,55,174
2021,North Northamptonshire 003,E02005613,8817,8073,315,209,106,170,81,89,259
2021,North Northamptonshire 006,E02005614,12721,11830,402,275,127,204,103,101,285
2021,North Northamptonshire 004,E02005615,8856,8059,326,217,109,204,84,120,267
2021,North Northamptonshire 005,E02005616,5484,5015,178,121,57,111,54,57,180
2021,North Northamptonshire 007,E02005617,10513,9577,317,208,109,245,94,151,374
2021,West Northamptonshire 001,E02005619,6086,5541,348,279,69,66,35,31,131
2021,West Northamptonshire 002,E02005620,8243,7573,402,319,83,94,57,37,174
2021,West Northamptonshire 004,E02005621,8694,8004,400,302,98,117,59,58,173
2021,West Northamptonshire 005,E02005622,9426,8510,546,435,111,150,82,68,220
2021,West Northamptonshire 003,E02005623,10822,9990,444,336,108,155,70,85,233
2021,West Northamptonshire 010,E02005624,10784,9943,411,292,119,184,91,93,246
2021,West Northamptonshire 016,E02005625,8920,8152,369,262,107,157,66,91,242
2021,West Northamptonshire 022,E02005626,6706,6096,250,168,82,154,58,96,206
2021,West Northamptonshire 027,E02005627,7285,6601,387,289,98,103,56,47,194
2021,West Northamptonshire 042,E02005628,8078,7399,413,330,83,98,49,49,168
2021,North Northamptonshire 001,E02005629,6167,5568,312,243,69,123,60,63,164
2021,North Northamptonshire 010,E02005630,10231,9420,483,382,101,108,60,48,220
2021,North Northamptonshire 011,E02005631,10575,9717,489,389,100,129,48,81,240
2021,North Northamptonshire 024,E02005632,6251,5623,338,250,88,112,54,58,178
2021,North Northamptonshire 025,E02005633,9293,8513,358,251,107,159,73,86,263
2021,North Northamptonshire 027,E02005634,8769,7977,375,292,83,171,86,85,246
2021,North Northamptonshire 035,E02005635,8949,8167,421,327,94,150,74,76,211
2021,North Northamptonshire 034,E02005636,11642,10646,492,358,134,196,94,102,308
2021,North Northamptonshire 037,E02005637,8731,7987,353,250,103,160,65,95,231
2021,North Northamptonshire 039,E02005638,9539,8698,457,341,116,148,71,77,236
2021,North Northamptonshire 012,E02005639,5367,4875,299,226,73,69,35,34,124
2021,North Northamptonshire 013,E02005640,11200,10304,437,312,125,157,76,81,302
2021,North Northamptonshire 014,E02005641,8126,7404,340,236,104,139,65,74,243
2021,North Northamptonshire 015,E02005642,8067,7363,357,272,85,142,68,74,205
2021,North Northamptonshire 016,E02005643,8108,7385,276,180,96,150,76,74,297
2021,North Northamptonshire 017,E02005644,8563,7995,268,196,72,139,42,97,161
2021,North Northamptonshire 018,E02005645,11828,10977,421,303,118,176,83,93,254
2021,North Northamptonshire 019,E02005646,6244,5642,278,220,58,114,52,62,210
2021,North Northamptonshire 022,E02005647,7212,6573,312,223,89,127,49,78,200
2021,North Northamptonshire 021,E02005648,9149,8290,506,378,128,141,81,60,212
2021,West Northamptonshire 006,E02005650,6587,6073,277,206,71,99,50,49,138
2021,West Northamptonshire 007,E02005651,6148,5587,304,237,67,95,47,48,162
2021,West Northamptonshire 008,E02005652,6369,5814,292,217,75,100,43,57,163
2021,West Northamptonshire 011,E02005653,8282,7660,251,180,71,155,59,96,216
2021,West Northamptonshire 009,E02005654,8137,7492,283,199,84,137,55,82,225
2021,West Northamptonshire 012,E02005655,6090,5505,286,206,80,111,52,59,188
2021,West Northamptonshire 014,E02005656,6217,5668,191,125,66,149,61,88,209
2021,West Northamptonshire 013,E02005657,6261,5734,275,212,63,95,50,45,157
2021,West Northamptonshire 015,E02005658,6466,5995,192,136,56,118,47,71,161
2021,West Northamptonshire 018,E02005659,5683,5158,254,193,61,103,54,49,168
2021,West Northamptonshire 026,E02005660,6260,5707,209,155,54,163,70,93,181
2021,West Northamptonshire 017,E02005661,6561,6026,233,169,64,135,54,81,167
2021,West Northamptonshire 019,E02005662,6450,5968,236,170,66,111,55,56,135
2021,West Northamptonshire 023,E02005663,5244,4784,251,188,63,86,44,42,123
2021,West Northamptonshire 025,E02005664,5836,5438,202,142,60,76,38,38,120
2021,West Northamptonshire 024,E02005665,8051,7389,294,194,100,150,72,78,218
2021,West Northamptonshire 021,E02005666,8483,7796,255,168,87,201,68,133,231
2021,West Northamptonshire 020,E02005667,6392,5849,278,205,73,105,48,57,160
2021,West Northamptonshire 028,E02005668,6272,5683,304,224,80,103,39,64,182
2021,West Northamptonshire 029,E02005669,5798,5305,302,209,93,83,47,36,108
2021,West Northamptonshire 032,E02005670,8932,8433,197,130,67,147,65,82,155
2021,West Northamptonshire 030,E02005671,7439,6963,244,174,70,119,58,61,113
2021,West Northamptonshire 031,E02005672,7994,7585,189,135,54,123,46,77,97
2021,West Northamptonshire 033,E02005673,7252,6741,219,155,64,114,49,65,178
2021,West Northamptonshire 034,E02005674,8726,8264,239,169,70,114,35,79,109
2021,West Northamptonshire 036,E02005675,5994,5517,198,132,66,103,40,63,176
2021,West Northamptonshire 038,E02005676,5910,5398,234,176,58,107,48,59,171
2021,West Northamptonshire 037,E02005677,9455,8791,352,249,103,141,57,84,171
2021,West Northamptonshire 041,E02005679,8524,7919,338,267,71,107,54,53,160
2021,West Northamptonshire 044,E02005680,8322,7689,376,300,76,107,45,62,150
2021,West Northamptonshire 040,E02005681,8246,7448,433,315,118,141,72,69,224
2021,West Northamptonshire 043,E02005682,7193,6604,360,268,92,87,47,40,142
2021,West Northamptonshire 046,E02005683,14197,13109,610,453,157,202,84,118,276
2021,West Northamptonshire 045,E02005684,8298,7634,394,305,89,85,41,44,185
2021,West Northamptonshire 047,E02005685,9466,8760,391,309,82,115,65,50,200
2021,West Northamptonshire 048,E02005686,7702,7070,374,295,79,92,44,48,166
2021,West Northamptonshire 049,E02005687,6394,5884,328,270,58,81,43,38,101
2021,West Northamptonshire 050,E02005688,9244,8510,402,308,94,132,70,62,200
2021,West Northamptonshire 051,E02005689,9936,9298,389,291,98,102,55,47,147
2021,West Northamptonshire 053,E02005690,5212,4820,219,165,54,59,27,32,114
2021,West Northamptonshire 052,E02005691,6457,5871,346,264,82,87,38,49,153
2021,North Northamptonshire 026,E02005692,6670,6007,337,237,100,133,75,58,193
2021,North Northamptonshire 028,E02005693,8188,7458,338,234,104,176,82,94,216
2021,North Northamptonshire 029,E02005694,7275,6641,337,239,98,119,60,59,178
2021,North Northamptonshire 030,E02005695,9379,8796,248,180,68,150,62,88,185
2021,North Northamptonshire 031,E02005696,6001,5437,205,141,64,134,63,71,225
2021,North Northamptonshire 032,E02005697,6878,6335,249,183,66,123,50,73,171
2021,North Northamptonshire 033,E02005698,5709,5168,231,149,82,115,51,64,195
2021,North Northamptonshire 036,E02005699,8054,7310,319,224,95,164,83,81,261
2021,North Northamptonshire 038,E02005700,9724,8831,514,367,147,127,70,57,252
2021,North Northamptonshire 040,E02005701,10725,9697,566,424,142,184,92,92,278
2021,Northumberland 004,E02005702,6459,5893,303,233,70,92,53,39,171
2021,Northumberland 005,E02005703,6560,6015,287,201,86,104,48,56,154
2021,Northumberland 006,E02005704,12134,10727,672,459,213,315,159,156,420
2021,Northumberland 007,E02005705,7369,6569,447,324,123,122,71,51,231
2021,Northumberland 001,E02005706,8748,7988,322,210,112,176,72,104,262
2021,Northumberland 002,E02005707,6831,6126,323,242,81,127,59,68,255
2021,Northumberland 003,E02005708,9701,8678,471,338,133,211,109,102,341
2021,Northumberland 022,E02005709,6347,5679,205,124,81,183,59,124,280
2021,Northumberland 023,E02005710,8886,8022,380,259,121,196,79,117,288
2021,Northumberland 024,E02005711,7400,6597,259,168,91,190,90,100,354
2021,Northumberland 025,E02005712,8768,7898,373,253,120,198,92,106,299
2021,Northumberland 026,E02005713,6024,5397,337,252,85,108,55,53,182
2021,Northumberland 029,E02005715,8739,7846,375,252,123,198,89,109,320
2021,Northumberland 030,E02005717,7113,6389,365,262,103,143,83,60,216
2021,Northumberland 031,E02005718,6046,5436,292,206,86,119,52,67,199
2021,Northumberland 032,E02005719,7743,6953,350,243,107,173,87,86,267
2021,Northumberland 008,E02005720,11661,10418,531,378,153,269,119,150,443
2021,Northumberland 011,E02005721,5205,4660,306,230,76,101,42,59,138
2021,Northumberland 015,E02005722,9037,8192,484,368,116,141,86,55,220
2021,Northumberland 016,E02005723,5800,5176,288,217,71,156,57,99,180
2021,Northumberland 018,E02005724,6353,5731,374,295,79,91,48,43,157
2021,Northumberland 033,E02005725,6719,6128,304,230,74,101,58,43,186
2021,Northumberland 034,E02005726,7588,6871,415,319,96,119,69,50,183
2021,Northumberland 019,E02005727,5825,5249,306,234,72,91,40,51,179
2021,Northumberland 037,E02005728,6460,5847,306,232,74,116,58,58,191
2021,Northumberland 036,E02005729,5400,4869,303,228,75,83,44,39,145
2021,Northumberland 035,E02005730,12174,11041,620,481,139,223,104,119,290
2021,Northumberland 038,E02005731,10248,9292,449,318,131,202,102,100,305
2021,Northumberland 040,E02005733,7943,7203,427,322,105,117,51,66,196
2021,Northumberland 009,E02005734,5632,4936,231,133,98,191,79,112,274
2021,Northumberland 010,E02005735,6704,5991,223,148,75,220,77,143,270
2021,Northumberland 013,E02005736,8202,7299,301,187,114,238,104,134,364
2021,Northumberland 017,E02005739,8587,7513,444,319,125,237,113,124,393
2021,Northumberland 020,E02005740,9569,8542,393,261,132,239,107,132,395
2021,Northumberland 021,E02005741,8118,7299,424,317,107,149,58,91,246
2021,Craven 001,E02005742,7146,6485,395,293,102,93,47,46,173
2021,Craven 003,E02005744,7631,6878,457,339,118,122,64,58,174
2021,Craven 005,E02005746,6360,5762,332,243,89,119,68,51,147
2021,Craven 006,E02005747,6532,5953,280,204,76,134,60,74,165
2021,Craven 007,E02005748,7465,6787,420,332,88,111,52,59,147
2021,Craven 008,E02005749,9610,8712,503,379,124,162,79,83,233
2021,Hambleton 001,E02005750,7402,6636,406,305,101,131,60,71,229
2021,Hambleton 002,E02005751,8312,7428,537,414,123,121,66,55,226
2021,Hambleton 003,E02005752,6641,6035,362,267,95,92,53,39,152
2021,Hambleton 005,E02005754,7163,6411,429,323,106,119,62,57,204
2021,Hambleton 006,E02005755,6466,5878,314,224,90,97,53,44,177
2021,Hambleton 007,E02005756,6026,5477,334,267,67,80,41,39,135
2021,Hambleton 008,E02005757,8282,7512,437,326,111,119,56,63,214
2021,Hambleton 009,E02005758,9051,8219,451,335,116,133,65,68,248
2021,Hambleton 010,E02005759,8901,8074,498,385,113,132,78,54,197
2021,Hambleton 011,E02005760,5958,5420,352,275,77,62,32,30,124
2021,Harrogate 001,E02005761,5290,4799,297,227,70,69,30,39,125
2021,Harrogate 002,E02005762,6007,5563,224,171,53,87,44,43,133
2021,Harrogate 003,E02005763,6149,5646,302,243,59,70,35,35,131
2021,Harrogate 004,E02005764,9907,9022,421,304,117,176,92,84,288
2021,Harrogate 005,E02005765,6805,6199,360,286,74,101,49,52,145
2021,Harrogate 006,E02005766,5794,5230,349,253,96,76,44,32,139
2021,Harrogate 007,E02005767,7074,6462,373,287,86,94,54,40,145
2021,Harrogate 008,E02005768,7649,7205,285,228,57,70,41,29,89
2021,Harrogate 009,E02005769,6660,6065,319,241,78,94,39,55,182
2021,Harrogate 010,E02005770,8588,7816,433,313,120,123,58,65,216
2021,Harrogate 011,E02005771,7168,6583,340,258,82,107,51,56,138
2021,Harrogate 012,E02005772,5676,5140,345,268,77,66,36,30,125
2021,Harrogate 013,E02005773,8539,7837,354,260,94,135,72,63,213
2021,Harrogate 014,E02005774,8892,8099,427,329,98,144,76,68,222
2021,Harrogate 015,E02005775,8891,8266,407,320,87,99,49,50,119
2021,Harrogate 016,E02005776,8959,8185,461,361,100,106,55,51,207
2021,Harrogate 017,E02005777,7882,7193,422,324,98,96,44,52,171
2021,Harrogate 018,E02005778,5877,5331,333,272,61,81,51,30,132
2021,Harrogate 019,E02005779,7133,6537,405,315,90,74,41,33,117
2021,Harrogate 020,E02005780,10578,9737,506,399,107,113,61,52,222
2021,Harrogate 021,E02005781,5856,5400,277,207,70,54,30,24,125
2021,Richmondshire 001,E02005782,7258,6532,404,310,94,123,53,70,199
2021,Richmondshire 002,E02005783,7785,7062,420,322,98,103,53,50,200
2021,Richmondshire 003,E02005784,5557,5047,264,201,63,91,50,41,155
2021,Richmondshire 004,E02005785,13034,12145,357,236,121,227,104,123,305
2021,Richmondshire 005,E02005786,5568,5055,304,239,65,75,41,34,134
2021,Richmondshire 006,E02005787,8247,7486,467,348,119,112,55,57,182
2021,Ryedale 001,E02005788,6122,5467,409,293,116,79,45,34,167
2021,Ryedale 002,E02005789,10231,9245,517,387,130,168,81,87,301
2021,Ryedale 003,E02005790,6845,6220,363,281,82,114,56,58,148
2021,Ryedale 004,E02005791,6527,5876,339,250,89,82,37,45,230
2021,Ryedale 007,E02005794,8937,8047,548,428,120,136,79,57,206
2021,Scarborough 001,E02005795,6674,6092,279,200,79,104,59,45,199
2021,Scarborough 002,E02005796,6288,5669,311,223,88,108,61,47,200
2021,Scarborough 003,E02005797,5927,5408,227,165,62,109,59,50,183
2021,Scarborough 004,E02005798,7941,7073,461,342,119,155,93,62,252
2021,Scarborough 005,E02005799,8994,8078,475,350,125,170,75,95,271
2021,Scarborough 006,E02005800,7046,6396,261,176,85,182,88,94,207
2021,Scarborough 007,E02005801,5259,4771,180,127,53,108,43,65,200
2021,Scarborough 008,E02005802,7307,6621,354,241,113,161,79,82,171
2021,Scarborough 009,E02005803,8805,7924,391,295,96,193,84,109,297
2021,Scarborough 010,E02005804,7412,6794,297,201,96,118,56,62,203
2021,Scarborough 011,E02005805,7361,6570,358,268,90,166,74,92,267
2021,Scarborough 012,E02005806,7619,6817,317,232,85,169,77,92,316
2021,Scarborough 013,E02005807,6241,5492,424,334,90,123,52,71,202
2021,Scarborough 014,E02005808,11153,9874,571,402,169,262,130,132,446
2021,Selby 001,E02005809,7131,6484,372,277,95,111,53,58,164
2021,Selby 002,E02005810,8958,8179,488,375,113,112,58,54,179
2021,Selby 003,E02005811,9370,8530,466,352,114,132,66,66,242
2021,Selby 004,E02005812,10625,9804,429,309,120,162,80,82,230
2021,Selby 005,E02005813,12371,11312,471,325,146,252,107,145,336
2021,Selby 006,E02005814,6645,6054,266,196,70,115,55,60,210
2021,Selby 007,E02005815,8248,7474,429,325,104,133,61,72,212
2021,Selby 008,E02005816,8266,7520,385,266,119,149,77,72,212
2021,Selby 009,E02005817,7039,6359,352,261,91,111,47,64,217
2021,Selby 010,E02005818,8380,7570,446,345,101,157,74,83,207
2021,Ashfield 001,E02005819,5960,5175,344,237,107,187,84,103,254
2021,Ashfield 002,E02005820,5315,4577,362,261,101,144,70,74,232
2021,Ashfield 003,E02005821,6322,5631,298,190,108,162,92,70,231
2021,Ashfield 004,E02005822,9633,8594,412,297,115,234,76,158,393
2021,Ashfield 005,E02005823,7265,6430,292,194,98,191,82,109,352
2021,Ashfield 006,E02005824,9338,8256,537,382,155,220,98,122,325
2021,Ashfield 007,E02005825,7378,6473,411,290,121,186,87,99,308
2021,Ashfield 008,E02005826,5777,5102,259,177,82,155,63,92,261
2021,Ashfield 009,E02005827,8972,7904,519,382,137,231,115,116,318
2021,Ashfield 010,E02005828,7297,6354,483,348,135,169,86,83,291
2021,Ashfield 011,E02005829,6287,5526,341,232,109,149,60,89,271
2021,Ashfield 012,E02005830,5652,4901,358,264,94,174,87,87,219
2021,Ashfield 013,E02005831,9972,8964,501,360,141,212,104,108,295
2021,Ashfield 014,E02005832,8811,7953,392,268,124,189,80,109,277
2021,Ashfield 015,E02005833,7282,6453,453,333,120,154,67,87,222
2021,Ashfield 016,E02005834,8260,7402,326,220,106,207,109,98,325
2021,Bassetlaw 001,E02005835,10511,9443,430,279,151,264,109,155,374
2021,Bassetlaw 002,E02005836,8859,7947,460,338,122,141,76,65,311
2021,Bassetlaw 003,E02005837,7554,6783,436,329,107,123,44,79,212
2021,Bassetlaw 004,E02005838,7810,6887,387,242,145,229,103,126,307
2021,Bassetlaw 005,E02005839,6078,5431,308,211,97,120,64,56,219
2021,Bassetlaw 006,E02005840,9166,8280,424,300,124,192,92,100,270
2021,Bassetlaw 008,E02005842,8321,7522,367,263,104,179,71,108,253
2021,Bassetlaw 009,E02005843,6637,6040,318,225,93,101,61,40,178
2021,Bassetlaw 010,E02005844,8267,7473,377,261,116,163,73,90,254
2021,Bassetlaw 012,E02005846,6289,5782,169,100,69,158,57,101,180
2021,Bassetlaw 013,E02005847,6600,5919,329,236,93,151,69,82,201
2021,Bassetlaw 014,E02005848,6130,5421,342,236,106,137,73,64,230
2021,Bassetlaw 015,E02005849,9065,8205,429,314,115,159,72,87,272
2021,Broxtowe 001,E02005850,6394,5634,367,265,102,148,61,87,245
2021,Broxtowe 002,E02005851,5876,5245,266,185,81,153,67,86,212
2021,Broxtowe 003,E02005852,7897,7058,429,316,113,136,69,67,274
2021,Broxtowe 004,E02005853,8684,7717,523,381,142,176,76,100,268
2021,Broxtowe 007,E02005856,6947,6181,473,370,103,118,55,63,175
2021,Broxtowe 008,E02005857,5804,5233,283,195,88,116,55,61,172
2021,Broxtowe 009,E02005858,7745,7085,375,277,98,115,60,55,170
2021,Broxtowe 010,E02005859,8783,7889,477,339,138,175,80,95,242
2021,Broxtowe 011,E02005860,8758,8175,352,269,83,108,60,48,123
2021,Broxtowe 012,E02005861,5123,4678,259,188,71,75,45,30,111
2021,Broxtowe 013,E02005862,7139,6419,343,259,84,123,61,62,254
2021,Broxtowe 014,E02005863,7095,6429,400,324,76,102,51,51,164
2021,Broxtowe 015,E02005864,7762,7045,457,347,110,97,47,50,163
2021,Gedling 001,E02005865,8195,7276,542,416,126,158,83,75,219
2021,Gedling 002,E02005866,8761,7773,532,401,131,199,98,101,257
2021,Gedling 004,E02005868,6926,6183,384,276,108,130,57,73,229
2021,Gedling 005,E02005869,5555,4944,268,201,67,140,54,86,203
2021,Gedling 006,E02005870,6340,5660,313,223,90,149,78,71,218
2021,Gedling 007,E02005871,6738,6003,400,292,108,131,67,64,204
2021,Gedling 008,E02005872,6302,5654,414,312,102,97,48,49,137
2021,Gedling 009,E02005873,9583,8593,625,494,131,135,65,70,230
2021,Gedling 010,E02005874,7980,7195,457,345,112,136,75,61,192
2021,Gedling 011,E02005875,7700,6926,402,291,111,160,63,97,212
2021,Gedling 012,E02005876,8369,7453,492,352,140,164,81,83,260
2021,Gedling 013,E02005877,6995,6272,366,265,101,149,79,70,208
2021,Gedling 014,E02005878,9234,8255,515,363,152,192,100,92,272
2021,Gedling 015,E02005879,6832,6237,283,207,76,124,67,57,188
2021,Mansfield 001,E02005880,6035,5204,302,208,94,204,93,111,325
2021,Mansfield 002,E02005881,5873,5137,325,232,93,161,77,84,250
2021,Mansfield 003,E02005882,7511,6561,465,323,142,184,79,105,301
2021,Mansfield 004,E02005883,7821,6935,391,266,125,202,82,120,293
2021,Mansfield 005,E02005884,5810,5111,374,261,113,134,57,77,191
2021,Mansfield 006,E02005885,8430,7448,427,300,127,232,117,115,323
2021,Mansfield 007,E02005886,10827,9533,650,461,189,251,111,140,393
2021,Mansfield 008,E02005887,9528,8735,315,235,80,216,69,147,262
2021,Mansfield 009,E02005888,7920,7147,303,218,85,199,80,119,271
2021,Mansfield 010,E02005889,10098,8925,480,321,159,246,113,133,447
2021,Mansfield 011,E02005890,6275,5487,413,295,118,151,70,81,224
2021,Mansfield 012,E02005891,6002,5245,289,190,99,184,63,121,284
2021,Mansfield 013,E02005892,12388,10982,842,638,204,241,116,125,323
2021,Newark and Sherwood 001,E02005893,10668,9425,506,345,161,279,107,172,458
2021,Newark and Sherwood 002,E02005894,11023,9727,616,427,189,275,118,157,405
2021,Newark and Sherwood 003,E02005895,7773,6879,498,381,117,143,75,68,253
2021,Newark and Sherwood 004,E02005896,7277,6555,394,294,100,116,64,52,212
2021,Newark and Sherwood 005,E02005897,8875,7785,544,392,152,199,90,109,347
2021,Newark and Sherwood 006,E02005898,10766,9424,610,443,167,289,130,159,443
2021,Newark and Sherwood 007,E02005899,10959,10079,438,284,154,203,88,115,239
2021,Newark and Sherwood 008,E02005900,7342,6616,449,355,94,87,42,45,190
2021,Newark and Sherwood 009,E02005901,9113,8319,430,330,100,155,87,68,209
2021,Newark and Sherwood 010,E02005902,7707,6876,336,237,99,206,96,110,289
2021,Newark and Sherwood 011,E02005903,9864,8844,497,357,140,191,92,99,332
2021,Newark and Sherwood 012,E02005904,9029,8174,484,352,132,144,67,77,227
2021,Newark and Sherwood 013,E02005905,6500,5814,429,320,109,110,58,52,147
2021,Rushcliffe 001,E02005906,7004,6335,390,321,69,123,65,58,156
2021,Rushcliffe 002,E02005907,9571,8742,463,338,125,137,52,85,229
2021,Rushcliffe 003,E02005908,8854,8045,476,369,107,121,71,50,212
2021,Rushcliffe 004,E02005909,7868,7219,432,342,90,82,42,40,135
2021,Rushcliffe 005,E02005910,8557,7958,383,295,88,87,51,36,129
2021,Rushcliffe 006,E02005911,8126,7426,452,346,106,103,50,53,145
2021,Rushcliffe 007,E02005912,8918,8105,496,373,123,144,77,67,173
2021,Rushcliffe 008,E02005913,8090,7361,450,360,90,112,54,58,167
2021,Rushcliffe 009,E02005914,7715,6940,403,284,119,148,70,78,224
2021,Rushcliffe 010,E02005915,5460,4930,316,240,76,87,51,36,127
2021,Rushcliffe 011,E02005916,7242,6564,384,297,87,113,50,63,181
2021,Rushcliffe 012,E02005917,5722,5076,386,304,82,94,50,44,166
2021,Rushcliffe 013,E02005918,4844,4287,315,236,79,90,51,39,152
2021,Rushcliffe 014,E02005919,6968,6337,363,277,86,107,61,46,161
2021,Rushcliffe 015,E02005920,8285,7489,535,427,108,95,52,43,166
2021,Cherwell 001,E02005921,6490,6014,289,226,63,68,35,33,119
2021,Cherwell 002,E02005922,8249,7657,291,219,72,138,67,71,163
2021,Cherwell 003,E02005923,5643,5177,201,143,58,107,39,68,158
2021,Cherwell 004,E02005924,11782,11125,290,210,80,176,78,98,191
2021,Cherwell 005,E02005925,8317,7553,294,194,100,182,78,104,288
2021,Cherwell 006,E02005926,8656,7916,403,311,92,124,61,63,213
2021,Cherwell 007,E02005927,5329,4934,220,155,65,78,35,43,97
2021,Cherwell 008,E02005928,10381,9621,439,339,100,112,52,60,209
2021,Cherwell 009,E02005929,7027,6445,362,275,87,79,35,44,141
2021,Cherwell 010,E02005930,8871,8159,442,343,99,98,49,49,172
2021,Cherwell 011,E02005931,10499,9739,422,331,91,142,68,74,196
2021,Cherwell 012,E02005932,6353,5918,241,187,54,83,41,42,111
2021,Cherwell 013,E02005933,7289,6691,310,231,79,103,52,51,185
2021,Cherwell 014,E02005934,8403,7693,358,256,102,147,76,71,205
2021,Cherwell 015,E02005935,8058,7569,278,194,84,94,39,55,117
2021,Cherwell 016,E02005936,12201,11253,520,386,134,180,94,86,248
2021,Cherwell 017,E02005937,6270,5693,312,232,80,107,57,50,158
2021,Cherwell 018,E02005938,5398,4985,244,170,74,64,34,30,105
2021,Cherwell 019,E02005939,6440,5920,288,203,85,93,53,40,139
2021,Oxford 001,E02005940,5896,5397,310,243,67,66,36,30,123
2021,Oxford 002,E02005941,6821,6337,334,271,63,66,36,30,84
2021,Oxford 003,E02005942,6064,5713,263,221,42,46,27,19,42
2021,Oxford 004,E02005943,6959,6448,298,229,69,71,38,33,142
2021,Oxford 005,E02005944,7871,7289,242,176,66,159,74,85,181
2021,Oxford 006,E02005945,10737,10071,390,314,76,103,57,46,173
2021,Oxford 007,E02005946,8017,7416,358,272,86,102,52,50,141
2021,Oxford 008,E02005947,18220,17576,495,431,64,83,40,43,66
2021,Oxford 009,E02005948,6293,5872,263,214,49,69,35,34,89
2021,Oxford 010,E02005949,7266,6819,197,146,51,107,49,58,143
2021,Oxford 011,E02005950,10835,10296,342,284,58,115,53,62,82
2021,Oxford 012,E02005951,5363,4990,230,189,41,68,32,36,75
2021,Oxford 014,E02005953,5776,5382,250,206,44,66,32,34,78
2021,Oxford 015,E02005954,9843,9115,403,314,89,152,77,75,173
2021,Oxford 016,E02005955,10507,9646,369,274,95,206,90,116,286
2021,Oxford 017,E02005956,6189,5604,231,138,93,145,61,84,209
2021,Oxford 018,E02005957,6462,5873,250,174,76,143,59,84,196
2021,South Oxfordshire 001,E02005958,5102,4678,255,199,56,64,35,29,105
2021,South Oxfordshire 002,E02005959,5620,5114,296,239,57,71,25,46,139
2021,South Oxfordshire 003,E02005960,7402,6791,333,262,71,100,41,59,178
2021,South Oxfordshire 004,E02005961,6426,5867,347,258,89,71,32,39,141
2021,South Oxfordshire 005,E02005962,9563,8781,471,372,99,104,53,51,207
2021,South Oxfordshire 006,E02005963,7669,6974,396,298,98,110,58,52,189
2021,South Oxfordshire 007,E02005964,6962,6305,402,302,100,97,49,48,158
2021,South Oxfordshire 008,E02005965,5263,4812,286,220,66,64,27,37,101
2021,South Oxfordshire 009,E02005966,7659,7162,304,240,64,83,35,48,110
2021,South Oxfordshire 010,E02005967,8838,8218,311,243,68,112,57,55,197
2021,South Oxfordshire 011,E02005968,7516,7017,309,246,63,76,37,39,114
2021,South Oxfordshire 012,E02005969,9173,8413,456,366,90,108,59,49,196
2021,South Oxfordshire 013,E02005970,5204,4762,238,180,58,78,32,46,126
2021,South Oxfordshire 014,E02005971,6013,5528,249,187,62,107,60,47,129
2021,South Oxfordshire 015,E02005972,11176,10390,472,367,105,126,72,54,188
2021,South Oxfordshire 016,E02005973,5659,5244,243,185,58,54,28,26,118
2021,South Oxfordshire 017,E02005974,5975,5557,265,210,55,58,29,29,95
2021,South Oxfordshire 018,E02005975,7923,7280,405,319,86,74,45,29,164
2021,South Oxfordshire 019,E02005976,6117,5626,338,287,51,53,37,16,100
2021,South Oxfordshire 020,E02005977,5851,5366,271,217,54,73,39,34,141
2021,Vale of White Horse 001,E02005978,7267,6664,386,299,87,93,52,41,124
2021,Vale of White Horse 002,E02005979,9842,9092,440,351,89,124,58,66,186
2021,Vale of White Horse 003,E02005980,11220,10360,488,390,98,141,68,73,231
2021,Vale of White Horse 004,E02005981,8154,7468,445,361,84,100,43,57,141
2021,Vale of White Horse 005,E02005982,5419,4934,298,236,62,80,44,36,107
2021,Vale of White Horse 006,E02005983,10409,9663,417,320,97,136,79,57,193
2021,Vale of White Horse 007,E02005984,8646,7948,431,355,76,104,56,48,163
2021,Vale of White Horse 008,E02005985,7464,6818,321,238,83,139,70,69,186
2021,Vale of White Horse 009,E02005986,9182,8393,423,336,87,144,71,73,222
2021,Vale of White Horse 010,E02005987,9586,8777,447,358,89,139,67,72,223
2021,Vale of White Horse 011,E02005988,8464,7775,385,307,78,129,54,75,175
2021,Vale of White Horse 014,E02005991,9562,8770,464,343,121,128,54,74,200
2021,Vale of White Horse 015,E02005992,12932,11882,614,460,154,194,85,109,242
2021,West Oxfordshire 001,E02005993,6858,6301,289,220,69,114,56,58,154
2021,West Oxfordshire 002,E02005994,6004,5486,304,226,78,79,42,37,135
2021,West Oxfordshire 003,E02005995,6132,5601,330,255,75,70,33,37,131
2021,West Oxfordshire 004,E02005996,8535,7812,450,358,92,105,55,50,168
2021,West Oxfordshire 005,E02005997,5708,5151,337,259,78,90,48,42,130
2021,West Oxfordshire 006,E02005998,6675,6086,371,296,75,87,44,43,131
2021,West Oxfordshire 007,E02005999,6281,5720,341,275,66,87,45,42,133
2021,West Oxfordshire 008,E02006000,11205,10321,507,390,117,144,57,87,233
2021,West Oxfordshire 009,E02006001,6634,6079,292,217,75,103,50,53,160
2021,West Oxfordshire 010,E02006002,10250,9431,428,335,93,161,70,91,230
2021,West Oxfordshire 011,E02006003,5647,5137,290,214,76,79,33,46,141
2021,West Oxfordshire 012,E02006004,7076,6533,341,265,76,82,42,40,120
2021,West Oxfordshire 013,E02006005,9193,8619,282,224,58,111,59,52,181
2021,West Oxfordshire 014,E02006006,5354,4883,237,169,68,88,42,46,146
2021,West Oxfordshire 015,E02006007,6966,6393,337,258,79,97,42,55,139
2021,Shropshire 025,E02006008,9865,8943,518,399,119,167,80,87,237
2021,Shropshire 027,E02006009,7626,6954,383,289,94,113,48,65,176
2021,Shropshire 029,E02006010,11347,10155,622,485,137,216,102,114,354
2021,Shropshire 031,E02006011,5460,4952,299,227,72,78,41,37,131
2021,Shropshire 033,E02006012,5977,5406,293,203,90,101,54,47,177
2021,Shropshire 034,E02006013,7611,6729,464,340,124,158,92,66,260
2021,Shropshire 035,E02006014,9417,8476,484,353,131,181,89,92,276
2021,Shropshire 001,E02006015,9684,8834,462,336,126,179,95,84,209
2021,Shropshire 002,E02006016,7807,6924,474,357,117,160,88,72,249
2021,Shropshire 004,E02006017,7758,7025,372,254,118,136,73,63,225
2021,Shropshire 005,E02006018,11903,10702,551,383,168,228,99,129,422
2021,Shropshire 008,E02006019,6005,5441,274,190,84,94,48,46,196
2021,Shropshire 009,E02006020,7409,6781,354,251,103,114,57,57,160
2021,Shropshire 010,E02006021,8409,7584,471,337,134,142,69,73,212
2021,Shropshire 013,E02006022,5749,5188,317,245,72,105,58,47,139
2021,Shropshire 003,E02006023,9514,8532,489,352,137,187,86,101,306
2021,Shropshire 006,E02006024,9310,8455,374,259,115,185,81,104,296
2021,Shropshire 007,E02006025,9230,8433,403,307,96,168,73,95,226
2021,Shropshire 011,E02006026,7086,6399,325,236,89,145,80,65,217
2021,Shropshire 012,E02006027,5217,4687,268,196,72,99,54,45,163
2021,Shropshire 014,E02006028,9423,8526,486,354,132,167,85,82,244
2021,Shropshire 015,E02006029,7713,6975,301,220,81,162,70,92,275
2021,Shropshire 016,E02006030,8547,7778,369,242,127,145,60,85,255
2021,Shropshire 017,E02006031,7586,6978,350,256,94,109,53,56,149
2021,Shropshire 018,E02006032,8147,7338,390,272,118,172,83,89,247
2021,Shropshire 019,E02006033,8187,7569,405,312,93,104,61,43,109
2021,Shropshire 020,E02006034,10062,9225,488,380,108,138,61,77,211
2021,Shropshire 021,E02006035,5647,5051,309,228,81,94,59,35,193
2021,Shropshire 022,E02006036,6308,5735,332,246,86,101,49,52,140
2021,Shropshire 023,E02006037,9551,8740,487,385,102,133,64,69,191
2021,Shropshire 024,E02006038,7985,7188,440,339,101,130,79,51,227
2021,Shropshire 026,E02006039,7886,7057,457,353,104,136,73,63,236
2021,Shropshire 028,E02006040,7509,6775,452,362,90,112,67,45,170
2021,Shropshire 030,E02006041,5438,4897,301,219,82,104,41,63,136
2021,Shropshire 032,E02006042,5620,5013,365,281,84,77,39,38,165
2021,Shropshire 036,E02006043,6434,5753,338,278,60,141,71,70,202
2021,Shropshire 037,E02006044,5921,5386,285,213,72,114,67,47,136
2021,Shropshire 038,E02006045,10288,9249,479,348,131,210,96,114,350
2021,Shropshire 039,E02006046,8551,7649,452,344,108,188,81,107,262
2021,Mendip 001,E02006047,8408,7660,468,370,98,100,47,53,180
2021,Mendip 002,E02006048,6899,6263,368,268,100,100,47,53,168
2021,Mendip 003,E02006049,6866,6251,354,269,85,90,51,39,171
2021,Mendip 004,E02006050,8274,7485,417,317,100,138,53,85,234
2021,Mendip 005,E02006051,8137,7423,433,340,93,96,49,47,185
2021,Mendip 006,E02006052,7440,6729,426,311,115,112,49,63,173
2021,Mendip 007,E02006053,10413,9539,437,330,107,186,80,106,251
2021,Mendip 008,E02006054,7965,7198,409,306,103,124,57,67,234
2021,Mendip 009,E02006055,8531,7860,351,257,94,115,55,60,205
2021,Mendip 010,E02006056,7409,6729,378,283,95,105,55,50,197
2021,Mendip 011,E02006057,7327,6589,371,268,103,131,60,71,236
2021,Mendip 012,E02006058,8448,7707,407,324,83,134,69,65,200
2021,Mendip 013,E02006059,6680,6093,321,256,65,93,60,33,173
2021,Mendip 014,E02006060,7832,7216,319,239,80,101,49,52,196
2021,Sedgemoor 001,E02006061,8976,8181,471,356,115,116,69,47,208
2021,Sedgemoor 002,E02006062,10689,9515,568,404,164,202,103,99,404
2021,Sedgemoor 003,E02006063,6689,6064,394,315,79,96,50,46,135
2021,Sedgemoor 004,E02006064,7528,6797,369,268,101,129,62,67,233
2021,Sedgemoor 005,E02006065,8434,7530,354,258,96,218,104,114,332
2021,Sedgemoor 006,E02006066,8125,7210,450,316,134,175,97,78,290
2021,Sedgemoor 007,E02006067,6871,6209,391,289,102,103,55,48,168
2021,Sedgemoor 008,E02006068,7418,6678,260,178,82,193,92,101,287
2021,Sedgemoor 009,E02006069,9975,9184,363,250,113,167,69,98,261
2021,Sedgemoor 010,E02006070,8199,7545,336,238,98,125,70,55,193
2021,Sedgemoor 011,E02006071,9119,8347,421,312,109,144,59,85,207
2021,Sedgemoor 012,E02006072,9050,8123,530,399,131,164,84,80,233
2021,Sedgemoor 013,E02006073,7361,6703,247,183,64,151,73,78,260
2021,Sedgemoor 014,E02006074,10907,10014,478,338,140,175,96,79,240
2021,South Somerset 001,E02006075,5107,4664,274,203,71,69,35,34,100
2021,South Somerset 002,E02006076,8768,7975,414,312,102,138,64,74,241
2021,South Somerset 003,E02006077,5932,5333,320,245,75,99,53,46,180
2021,South Somerset 004,E02006078,6044,5470,326,240,86,81,41,40,167
2021,South Somerset 005,E02006079,7888,7199,368,281,87,132,52,80,189
2021,South Somerset 006,E02006080,6572,6030,267,204,63,86,38,48,189
2021,South Somerset 007,E02006081,5537,4987,308,234,74,99,40,59,143
2021,South Somerset 008,E02006082,6710,6065,335,242,93,107,28,79,203
2021,South Somerset 009,E02006083,5385,4863,266,200,66,85,43,42,171
2021,South Somerset 010,E02006084,7203,6493,378,306,72,103,56,47,229
2021,South Somerset 011,E02006085,7234,6611,321,245,76,131,53,78,171
2021,South Somerset 012,E02006086,7341,6747,322,239,83,98,47,51,174
2021,South Somerset 013,E02006087,5661,5129,240,168,72,133,60,73,159
2021,South Somerset 014,E02006088,7373,6740,267,196,71,149,63,86,217
2021,South Somerset 015,E02006089,6811,6375,213,148,65,94,38,56,129
2021,South Somerset 016,E02006090,6799,6223,264,202,62,112,56,56,200
2021,South Somerset 017,E02006091,9594,8672,498,363,135,188,98,90,236
2021,South Somerset 018,E02006092,6207,5671,309,236,73,78,42,36,149
2021,South Somerset 019,E02006093,8356,7679,343,258,85,123,69,54,211
2021,South Somerset 020,E02006094,5210,4630,304,239,65,88,43,45,188
2021,South Somerset 021,E02006095,7997,7179,399,290,109,145,77,68,274
2021,South Somerset 022,E02006096,6935,6286,323,238,85,119,50,69,207
2021,South Somerset 023,E02006097,6547,5975,261,188,73,119,51,68,192
2021,South Somerset 024,E02006098,7225,6488,430,312,118,111,54,57,196
2021,Somerset West and Taunton 006,E02006099,6870,6253,358,288,70,108,55,53,151
2021,Somerset West and Taunton 007,E02006100,7758,7149,344,264,80,106,53,53,159
2021,Somerset West and Taunton 013,E02006101,5570,4999,321,239,82,99,60,39,151
2021,Somerset West and Taunton 010,E02006102,6536,5848,268,188,80,149,64,85,271
2021,Somerset West and Taunton 009,E02006103,7672,6847,446,316,130,148,92,56,231
2021,Somerset West and Taunton 008,E02006104,10025,9234,426,333,93,155,74,81,210
2021,Somerset West and Taunton 011,E02006105,10614,9844,380,289,91,205,105,100,185
2021,Somerset West and Taunton 012,E02006106,9337,8548,386,302,84,166,77,89,237
2021,Somerset West and Taunton 014,E02006107,7881,7153,308,221,87,180,82,98,240
2021,Somerset West and Taunton 015,E02006108,8309,7642,383,306,77,112,49,63,172
2021,Somerset West and Taunton 016,E02006109,7609,6885,420,328,92,114,54,60,190
2021,Somerset West and Taunton 018,E02006110,9873,8981,428,314,114,194,77,117,270
2021,Somerset West and Taunton 017,E02006111,10305,9369,533,419,114,152,80,72,251
2021,Somerset West and Taunton 019,E02006112,8007,7277,450,355,95,109,62,47,171
2021,Somerset West and Taunton 001,E02006113,7124,6460,313,236,77,127,66,61,224
2021,Somerset West and Taunton 002,E02006114,6174,5481,343,254,89,136,69,67,214
2021,Somerset West and Taunton 003,E02006115,7244,6452,366,243,123,159,78,81,267
2021,Somerset West and Taunton 004,E02006116,7741,6912,437,319,118,156,83,73,236
2021,Somerset West and Taunton 005,E02006117,5449,4907,309,227,82,93,49,44,140
2021,Cannock Chase 001,E02006118,7086,6334,419,300,119,140,74,66,193
2021,Cannock Chase 002,E02006119,7722,6974,320,217,103,168,77,91,260
2021,Cannock Chase 003,E02006120,8765,7832,424,292,132,206,77,129,303
2021,Cannock Chase 004,E02006121,5529,4942,260,160,100,123,58,65,204
2021,Cannock Chase 005,E02006122,7539,6723,397,274,123,168,62,106,251
2021,Cannock Chase 006,E02006123,6136,5524,314,231,83,132,62,70,166
2021,Cannock Chase 007,E02006124,6931,6123,272,166,106,199,71,128,337
2021,Cannock Chase 008,E02006125,6909,6176,300,186,114,184,75,109,249
2021,Cannock Chase 009,E02006126,7934,7125,400,264,136,164,68,96,245
2021,Cannock Chase 010,E02006127,6726,6129,361,257,104,102,52,50,134
2021,Cannock Chase 011,E02006128,8104,7186,457,342,115,176,88,88,285
2021,Cannock Chase 012,E02006129,7757,6983,310,223,87,183,81,102,281
2021,Cannock Chase 013,E02006130,7816,6972,409,298,111,179,77,102,256
2021,East Staffordshire 001,E02006131,7437,6699,412,332,80,119,75,44,207
2021,East Staffordshire 002,E02006132,6655,6059,301,215,86,136,61,75,159
2021,East Staffordshire 003,E02006133,6608,6089,324,233,91,75,37,38,120
2021,East Staffordshire 004,E02006134,9964,9008,542,424,118,149,70,79,265
2021,East Staffordshire 005,E02006135,7452,6739,395,296,99,112,49,63,206
2021,East Staffordshire 006,E02006136,8733,7993,462,359,103,104,56,48,174
2021,East Staffordshire 007,E02006137,8598,7837,341,237,104,170,76,94,250
2021,East Staffordshire 008,E02006138,7401,6909,210,133,77,127,54,73,155
2021,East Staffordshire 009,E02006139,7855,7329,214,157,57,132,42,90,180
2021,East Staffordshire 010,E02006140,7920,7196,324,243,81,167,68,99,233
2021,East Staffordshire 011,E02006141,11205,10536,272,200,72,182,56,126,215
2021,East Staffordshire 012,E02006142,5012,4590,240,175,65,74,38,36,108
2021,East Staffordshire 013,E02006143,8784,8115,362,268,94,130,51,79,177
2021,East Staffordshire 014,E02006144,7713,7062,272,200,72,146,67,79,233
2021,East Staffordshire 015,E02006145,5717,5191,301,241,60,81,43,38,144
2021,Lichfield 001,E02006146,8278,7400,446,322,124,159,78,81,273
2021,Lichfield 002,E02006147,8012,7346,390,307,83,105,56,49,171
2021,Lichfield 003,E02006148,6876,6161,430,304,126,102,54,48,183
2021,Lichfield 004,E02006149,10181,9303,412,306,106,180,79,101,286
2021,Lichfield 005,E02006150,10993,9993,568,444,124,172,88,84,260
2021,Lichfield 006,E02006151,9244,8315,465,350,115,168,82,86,296
2021,Lichfield 007,E02006152,9871,8910,593,469,124,140,72,68,228
2021,Lichfield 008,E02006153,8597,7856,414,318,96,121,59,62,206
2021,Lichfield 009,E02006154,9268,8265,500,364,136,190,100,90,313
2021,Lichfield 010,E02006155,5349,4747,266,170,96,137,77,60,199
2021,Lichfield 011,E02006156,7651,6918,441,329,112,93,55,38,199
2021,Lichfield 012,E02006157,6885,6279,306,218,88,120,57,63,180
2021,Newcastle-under-Lyme 001,E02006158,7790,6953,478,340,138,130,60,70,229
2021,Newcastle-under-Lyme 002,E02006159,5404,4803,268,190,78,123,47,76,210
2021,Newcastle-under-Lyme 003,E02006160,8141,7257,379,256,123,176,77,99,329
2021,Newcastle-under-Lyme 004,E02006161,6291,5563,368,254,114,137,69,68,223
2021,Newcastle-under-Lyme 005,E02006162,7957,7080,462,331,131,149,88,61,266
2021,Newcastle-under-Lyme 006,E02006163,7420,6634,330,230,100,172,65,107,284
2021,Newcastle-under-Lyme 007,E02006164,6770,6108,221,131,90,166,85,81,275
2021,Newcastle-under-Lyme 008,E02006165,7016,6395,337,238,99,103,51,52,181
2021,Newcastle-under-Lyme 009,E02006166,6692,6051,406,310,96,98,54,44,137
2021,Newcastle-under-Lyme 010,E02006167,9400,8506,367,262,105,228,101,127,299
2021,Newcastle-under-Lyme 011,E02006168,8035,7343,327,235,92,138,73,65,227
2021,Newcastle-under-Lyme 012,E02006169,7301,6677,349,255,94,123,55,68,152
2021,Newcastle-under-Lyme 013,E02006170,4947,4357,322,230,92,128,62,66,140
2021,Newcastle-under-Lyme 014,E02006171,8585,7672,462,340,122,165,76,89,286
2021,Newcastle-under-Lyme 015,E02006172,9060,8139,545,395,150,133,76,57,243
2021,Newcastle-under-Lyme 016,E02006173,6698,5959,438,318,120,126,70,56,175
2021,South Staffordshire 001,E02006174,10413,9312,591,420,171,203,100,103,307
2021,South Staffordshire 002,E02006175,6452,5848,284,209,75,144,57,87,176
2021,South Staffordshire 003,E02006176,7065,6290,416,320,96,115,56,59,244
2021,South Staffordshire 004,E02006177,9290,8282,508,366,142,235,114,121,265
2021,South Staffordshire 005,E02006178,7146,6391,356,246,110,162,64,98,237
2021,South Staffordshire 006,E02006179,9258,8489,392,286,106,164,88,76,213
2021,South Staffordshire 007,E02006180,6597,5877,349,247,102,148,58,90,223
2021,South Staffordshire 008,E02006181,5273,4732,262,193,69,98,43,55,181
2021,South Staffordshire 009,E02006182,6829,6129,400,288,112,136,72,64,164
2021,South Staffordshire 012,E02006185,6805,6095,380,272,108,128,57,71,202
2021,South Staffordshire 013,E02006186,11966,10673,799,596,203,202,102,100,292
2021,South Staffordshire 014,E02006187,6865,6110,413,323,90,136,80,56,206
2021,Stafford 001,E02006188,5742,5093,342,251,91,124,67,57,183
2021,Stafford 002,E02006189,6937,6181,452,333,119,113,63,50,191
2021,Stafford 003,E02006190,10530,9532,562,435,127,157,84,73,279
2021,Stafford 004,E02006191,7730,6980,438,329,109,114,61,53,198
2021,Stafford 005,E02006192,8782,7922,502,379,123,132,74,58,226
2021,Stafford 006,E02006193,7066,6333,400,310,90,112,58,54,221
2021,Stafford 007,E02006194,7883,7146,344,243,101,157,66,91,236
2021,Stafford 008,E02006195,8390,7536,492,371,121,133,67,66,229
2021,Stafford 009,E02006196,6813,6310,247,174,73,107,59,48,149
2021,Stafford 010,E02006197,8831,8186,332,242,90,132,56,76,181
2021,Stafford 011,E02006198,8501,7780,428,332,96,109,56,53,184
2021,Stafford 012,E02006199,7985,7187,470,357,113,127,76,51,201
2021,Stafford 013,E02006200,7224,6485,295,207,88,175,75,100,269
2021,Stafford 014,E02006201,11609,10461,702,542,160,150,89,61,296
2021,Stafford 015,E02006202,8863,7957,526,409,117,149,75,74,231
2021,Stafford 016,E02006203,7269,6449,373,252,121,165,87,78,282
2021,Staffordshire Moorlands 001,E02006204,7091,6343,333,240,93,170,75,95,245
2021,Staffordshire Moorlands 002,E02006205,7005,6187,476,359,117,129,83,46,213
2021,Staffordshire Moorlands 003,E02006206,7560,6788,342,245,97,187,81,106,243
2021,Staffordshire Moorlands 004,E02006207,6033,5352,370,267,103,99,52,47,212
2021,Staffordshire Moorlands 005,E02006208,7597,6842,419,310,109,143,67,76,193
2021,Staffordshire Moorlands 006,E02006209,10158,9063,656,508,148,162,86,76,277
2021,Staffordshire Moorlands 007,E02006210,5002,4456,327,249,78,80,35,45,139
2021,Staffordshire Moorlands 008,E02006211,6126,5451,388,294,94,110,71,39,177
2021,Staffordshire Moorlands 009,E02006212,7432,6614,461,337,124,124,65,59,233
2021,Staffordshire Moorlands 010,E02006213,6276,5607,357,251,106,100,40,60,212
2021,Staffordshire Moorlands 011,E02006214,5864,5257,307,217,90,128,61,67,172
2021,Staffordshire Moorlands 012,E02006215,7553,6693,449,325,124,150,80,70,261
2021,Staffordshire Moorlands 013,E02006216,8070,7281,427,322,105,132,67,65,230
2021,Tamworth 001,E02006217,9633,8683,470,334,136,182,75,107,298
2021,Tamworth 002,E02006218,7991,7269,312,209,103,140,54,86,270
2021,Tamworth 003,E02006219,7812,7071,324,215,109,130,69,61,287
2021,Tamworth 004,E02006220,6975,6249,321,216,105,140,61,79,265
2021,Tamworth 005,E02006221,5545,5032,288,218,70,86,33,53,139
2021,Tamworth 006,E02006222,6513,5908,253,177,76,125,49,76,227
2021,Tamworth 007,E02006223,6394,5778,178,115,63,153,63,90,285
2021,Tamworth 008,E02006224,7084,6363,343,239,104,161,75,86,217
2021,Tamworth 009,E02006225,6987,6337,346,254,92,121,60,61,183
2021,Tamworth 010,E02006226,9269,8467,372,269,103,192,86,106,238
2021,Babergh 001,E02006227,6199,5583,352,249,103,92,44,48,172
2021,Babergh 002,E02006228,5867,5335,303,226,77,76,35,41,153
2021,Babergh 003,E02006229,5955,5407,298,215,83,94,41,53,156
2021,Babergh 004,E02006230,10541,9700,420,318,102,162,88,74,259
2021,Babergh 005,E02006231,8232,7514,413,309,104,116,53,63,189
2021,Babergh 006,E02006232,5854,5261,308,223,85,110,54,56,175
2021,Babergh 007,E02006233,11069,10136,451,347,104,191,80,111,291
2021,Babergh 008,E02006234,9403,8569,389,269,120,143,55,88,302
2021,Babergh 009,E02006235,7870,7119,452,357,95,98,56,42,201
2021,Babergh 010,E02006236,10066,9137,549,416,133,138,74,64,242
2021,Babergh 011,E02006237,7314,6569,453,338,115,117,57,60,175
2021,West Suffolk 002,E02006238,9206,8346,350,242,108,182,74,108,328
2021,West Suffolk 001,E02006239,8060,7574,234,177,57,81,49,32,171
2021,West Suffolk 003,E02006240,9375,8725,361,267,94,100,42,58,189
2021,West Suffolk 004,E02006241,8358,7601,347,253,94,123,49,74,287
2021,West Suffolk 007,E02006242,9809,9169,362,281,81,95,48,47,183
2021,West Suffolk 008,E02006243,8817,8225,295,217,78,135,67,68,162
2021,Ipswich 001,E02006245,7775,6966,335,232,103,183,87,96,291
2021,Ipswich 002,E02006246,7034,6375,372,284,88,107,63,44,180
2021,Ipswich 003,E02006247,8512,7786,315,225,90,154,69,85,257
2021,Ipswich 004,E02006248,8055,7292,378,279,99,152,71,81,233
2021,Ipswich 005,E02006249,8028,7391,381,296,85,94,42,52,162
2021,Ipswich 006,E02006250,9478,8829,300,218,82,165,80,85,184
2021,Ipswich 007,E02006251,10059,9363,371,272,99,150,64,86,175
2021,Ipswich 008,E02006252,9128,8465,383,293,90,108,59,49,172
2021,Ipswich 009,E02006253,7100,6389,404,313,91,118,60,58,189
2021,Ipswich 010,E02006254,8812,8149,287,201,86,170,78,92,206
2021,Ipswich 011,E02006255,7666,7035,346,267,79,129,55,74,156
2021,Ipswich 012,E02006256,9157,8456,325,222,103,160,58,102,216
2021,Ipswich 013,E02006257,6423,5717,293,204,89,174,88,86,239
2021,Ipswich 014,E02006258,9078,8150,354,231,123,207,93,114,367
2021,Ipswich 015,E02006259,6771,6181,266,198,68,146,66,80,178
2021,Ipswich 016,E02006260,8238,7498,311,209,102,179,88,91,250
2021,Mid Suffolk 001,E02006261,7702,6996,416,315,101,108,51,57,182
2021,Mid Suffolk 002,E02006262,8669,7945,405,316,89,130,65,65,189
2021,Mid Suffolk 003,E02006263,7265,6596,382,294,88,110,60,50,177
2021,Mid Suffolk 004,E02006264,8420,7668,424,319,105,109,47,62,219
2021,Mid Suffolk 005,E02006265,7064,6394,393,305,88,96,40,56,181
2021,Mid Suffolk 006,E02006266,9047,8135,524,393,131,130,66,64,258
2021,Mid Suffolk 007,E02006267,8097,7285,487,374,113,139,73,66,186
2021,Mid Suffolk 008,E02006268,5887,5263,292,198,94,114,59,55,218
2021,Mid Suffolk 009,E02006269,7343,6756,366,285,81,83,47,36,138
2021,Mid Suffolk 010,E02006270,12056,11159,502,376,126,159,71,88,236
2021,Mid Suffolk 011,E02006271,9278,8525,419,312,107,123,56,67,211
2021,Mid Suffolk 012,E02006272,7374,6587,465,354,111,120,59,61,202
2021,West Suffolk 005,E02006273,6547,5920,321,236,85,104,55,49,202
2021,West Suffolk 006,E02006274,6290,5779,292,210,82,111,42,69,108
2021,West Suffolk 009,E02006275,6616,6045,242,168,74,139,62,77,190
2021,West Suffolk 016,E02006276,7830,7148,352,271,81,107,54,53,223
2021,West Suffolk 012,E02006277,7252,6731,308,252,56,92,42,50,121
2021,West Suffolk 011,E02006278,8033,7525,302,240,62,83,34,49,123
2021,West Suffolk 014,E02006279,8235,7534,378,292,86,108,52,56,215
2021,West Suffolk 010,E02006280,9307,8494,461,319,142,119,65,54,233
2021,West Suffolk 013,E02006281,8016,7382,359,264,95,92,57,35,183
2021,West Suffolk 017,E02006282,6307,5692,360,280,80,78,39,39,177
2021,West Suffolk 018,E02006283,7912,7283,348,270,78,109,62,47,172
2021,West Suffolk 019,E02006284,7286,6676,310,215,95,98,47,51,202
2021,West Suffolk 021,E02006285,7122,6624,260,200,60,90,45,45,148
2021,West Suffolk 020,E02006286,10492,9649,369,254,115,198,90,108,276
2021,East Suffolk 016,E02006287,6043,5425,335,248,87,101,59,42,182
2021,East Suffolk 017,E02006288,9661,8787,498,394,104,144,68,76,232
2021,East Suffolk 018,E02006289,9227,8383,414,302,112,160,77,83,270
2021,East Suffolk 019,E02006290,7761,7025,383,302,81,138,67,71,215
2021,East Suffolk 020,E02006291,7344,6678,374,284,90,118,66,52,174
2021,East Suffolk 021,E02006292,6556,5850,438,343,95,104,46,58,164
2021,East Suffolk 023,E02006293,10643,9697,527,393,134,161,80,81,258
2021,East Suffolk 022,E02006294,7620,6865,435,335,100,113,59,54,207
2021,East Suffolk 024,E02006295,8938,8067,435,325,110,169,90,79,267
2021,East Suffolk 025,E02006296,12470,11324,664,517,147,173,92,81,309
2021,East Suffolk 026,E02006297,7782,6963,494,396,98,130,74,56,195
2021,East Suffolk 027,E02006298,8722,7889,409,313,96,154,89,65,270
2021,East Suffolk 028,E02006299,8006,7242,396,299,97,122,65,57,246
2021,East Suffolk 029,E02006300,7475,6723,328,246,82,165,77,88,259
2021,East Suffolk 030,E02006301,6047,5487,292,212,80,116,45,71,152
2021,East Suffolk 001,E02006302,6461,5732,367,263,104,132,69,63,230
2021,East Suffolk 002,E02006303,7534,6740,291,178,113,211,92,119,292
2021,East Suffolk 003,E02006304,7782,6973,380,269,111,160,71,89,269
2021,East Suffolk 004,E02006305,9026,8133,336,236,100,247,101,146,310
2021,East Suffolk 005,E02006306,6954,6253,288,209,79,161,65,96,252
2021,East Suffolk 007,E02006307,7119,6369,395,281,114,132,71,61,223
2021,East Suffolk 006,E02006308,7191,6515,262,170,92,175,75,100,239
2021,East Suffolk 009,E02006309,6452,5663,326,207,119,169,73,96,294
2021,East Suffolk 008,E02006310,7665,6885,370,264,106,151,68,83,259
2021,East Suffolk 010,E02006311,7892,7096,388,276,112,142,73,69,266
2021,East Suffolk 011,E02006312,8164,7326,458,342,116,130,57,73,250
2021,East Suffolk 012,E02006313,9523,8440,511,350,161,216,95,121,356
2021,East Suffolk 013,E02006314,6946,6183,391,295,96,126,61,65,246
2021,East Suffolk 014,E02006315,5633,5029,320,246,74,103,53,50,181
2021,East Suffolk 015,E02006316,6785,6107,331,228,103,119,60,59,228
2021,Elmbridge 001,E02006317,5967,5486,295,222,73,58,25,33,128
2021,Elmbridge 002,E02006318,6521,6061,296,236,60,71,45,26,93
2021,Elmbridge 003,E02006319,6710,6138,316,227,89,94,44,50,162
2021,Elmbridge 004,E02006320,6632,6063,281,214,67,127,55,72,161
2021,Elmbridge 005,E02006321,6181,5756,283,222,61,47,20,27,95
2021,Elmbridge 006,E02006322,6126,5694,262,206,56,70,36,34,100
2021,Elmbridge 007,E02006323,7025,6506,295,233,62,83,35,48,141
2021,Elmbridge 008,E02006324,7329,6794,298,222,76,100,39,61,137
2021,Elmbridge 009,E02006325,8694,8100,401,338,63,62,33,29,131
2021,Elmbridge 010,E02006326,6997,6514,280,216,64,86,40,46,117
2021,Elmbridge 011,E02006327,6335,5900,260,208,52,70,42,28,105
2021,Elmbridge 012,E02006328,9029,8398,357,279,78,113,59,54,161
2021,Elmbridge 013,E02006329,6774,6256,301,225,76,87,39,48,130
2021,Elmbridge 014,E02006330,9291,8571,419,313,106,127,65,62,174
2021,Elmbridge 015,E02006331,6878,6372,334,265,69,67,27,40,105
2021,Elmbridge 016,E02006332,6336,5915,265,205,60,69,46,23,87
2021,Elmbridge 017,E02006333,9452,8791,372,273,99,128,48,80,161
2021,Elmbridge 018,E02006334,8130,7576,351,283,68,74,40,34,129
2021,Epsom and Ewell 001,E02006335,7503,6912,356,265,91,78,37,41,157
2021,Epsom and Ewell 002,E02006336,6702,6144,274,203,71,110,55,55,174
2021,Epsom and Ewell 003,E02006337,8386,7688,386,296,90,108,53,55,204
2021,Epsom and Ewell 004,E02006338,6395,5879,305,226,79,84,48,36,127
2021,Epsom and Ewell 005,E02006339,10204,9478,402,296,106,155,55,100,169
2021,Epsom and Ewell 007,E02006341,9647,8869,402,310,92,148,71,77,228
2021,Epsom and Ewell 008,E02006342,7703,7238,266,197,69,88,42,46,111
2021,Epsom and Ewell 009,E02006343,8584,7795,489,400,89,116,60,56,184
2021,Guildford 001,E02006344,8181,7464,440,337,103,97,57,40,180
2021,Guildford 002,E02006345,7323,6802,295,232,63,77,36,41,149
2021,Guildford 003,E02006346,9562,8806,500,406,94,91,44,47,165
2021,Guildford 004,E02006347,6721,6140,314,248,66,99,54,45,168
2021,Guildford 005,E02006348,8002,7289,395,314,81,107,55,52,211
2021,Guildford 006,E02006349,7553,7036,307,235,72,70,27,43,140
2021,Guildford 007,E02006350,6002,5508,205,142,63,110,53,57,179
2021,Guildford 008,E02006351,7966,7326,386,303,83,96,55,41,158
2021,Guildford 009,E02006352,5855,5467,214,166,48,69,27,42,105
2021,Guildford 010,E02006353,5782,5196,285,219,66,126,61,65,175
2021,Guildford 011,E02006354,9196,8489,471,369,102,87,52,35,149
2021,Guildford 012,E02006355,9466,8867,287,211,76,138,78,60,174
2021,Guildford 013,E02006356,10892,10218,444,355,89,106,55,51,124
2021,Guildford 014,E02006357,6741,6171,324,251,73,94,51,43,152
2021,Guildford 015,E02006358,8672,8245,280,225,55,51,24,27,96
2021,Guildford 016,E02006359,5855,5435,291,243,48,54,29,25,75
2021,Guildford 017,E02006360,7759,7124,410,325,85,77,39,38,148
2021,Guildford 018,E02006361,5439,4919,345,295,50,67,27,40,108
2021,Mole Valley 001,E02006362,6557,5961,386,296,90,73,41,32,137
2021,Mole Valley 002,E02006363,5781,5302,292,217,75,69,37,32,118
2021,Mole Valley 003,E02006364,7179,6641,273,207,66,104,49,55,161
2021,Mole Valley 004,E02006365,6014,5516,294,230,64,75,40,35,129
2021,Mole Valley 005,E02006366,7642,7002,408,314,94,72,35,37,160
2021,Mole Valley 006,E02006367,5723,5207,340,274,66,73,36,37,103
2021,Mole Valley 007,E02006368,5466,4981,305,242,63,56,32,24,124
2021,Mole Valley 008,E02006369,6035,5421,352,266,86,95,61,34,167
2021,Mole Valley 009,E02006370,6068,5572,319,254,65,69,41,28,108
2021,Mole Valley 010,E02006371,7007,6427,381,309,72,92,35,57,107
2021,Mole Valley 011,E02006372,6048,5485,316,233,83,91,45,46,156
2021,Mole Valley 012,E02006373,7209,6557,391,304,87,75,38,37,186
2021,Mole Valley 013,E02006374,6654,6048,344,263,81,118,58,60,144
2021,Reigate and Banstead 001,E02006375,6422,5915,298,239,59,77,47,30,132
2021,Reigate and Banstead 002,E02006376,8866,8173,388,298,90,112,63,49,193
2021,Reigate and Banstead 003,E02006377,5915,5388,305,227,78,82,38,44,140
2021,Reigate and Banstead 004,E02006378,8353,7622,451,359,92,121,72,49,159
2021,Reigate and Banstead 005,E02006379,6412,5816,299,220,79,122,60,62,175
2021,Reigate and Banstead 006,E02006380,6773,6189,369,302,67,74,41,33,141
2021,Reigate and Banstead 007,E02006381,6922,6351,322,240,82,89,38,51,160
2021,Reigate and Banstead 008,E02006382,6361,5824,247,186,61,121,63,58,169
2021,Reigate and Banstead 009,E02006383,9609,8985,393,313,80,82,42,40,149
2021,Reigate and Banstead 010,E02006384,10267,9522,379,285,94,168,77,91,198
2021,Reigate and Banstead 011,E02006385,10441,9736,397,308,89,130,58,72,178
2021,Reigate and Banstead 012,E02006386,7927,7412,332,275,57,86,38,48,97
2021,Reigate and Banstead 013,E02006387,6367,5837,287,228,59,98,55,43,145
2021,Reigate and Banstead 014,E02006388,8743,8066,379,289,90,105,53,52,193
2021,Reigate and Banstead 015,E02006389,6927,6304,316,219,97,115,64,51,192
2021,Reigate and Banstead 016,E02006390,9677,8866,422,307,115,175,81,94,214
2021,Reigate and Banstead 017,E02006391,7230,6713,317,246,71,83,36,47,117
2021,Reigate and Banstead 018,E02006392,8586,7930,313,237,76,140,66,74,203
2021,Runnymede 001,E02006393,6625,6188,265,202,63,76,37,39,96
2021,Runnymede 002,E02006394,11484,10832,357,288,69,111,61,50,184
2021,Runnymede 003,E02006395,9130,8319,418,310,108,138,67,71,255
2021,Runnymede 004,E02006396,5700,5188,294,223,71,82,44,38,136
2021,Runnymede 005,E02006397,6052,5594,261,207,54,83,36,47,114
2021,Runnymede 006,E02006398,8078,7432,362,277,85,112,49,63,172
2021,Runnymede 007,E02006399,11425,10484,460,343,117,198,95,103,283
2021,Runnymede 008,E02006400,5386,4912,253,185,68,92,50,42,129
2021,Runnymede 009,E02006401,10065,9186,473,391,82,146,67,79,260
2021,Runnymede 010,E02006402,9356,8550,446,343,103,126,60,66,234
2021,Spelthorne 001,E02006403,6254,5711,251,163,88,122,51,71,170
2021,Spelthorne 002,E02006404,7216,6626,241,146,95,140,63,77,209
2021,Spelthorne 003,E02006405,10711,9862,485,371,114,141,61,80,223
2021,Spelthorne 004,E02006406,8408,7785,358,271,87,119,59,60,146
2021,Spelthorne 005,E02006407,8753,7988,408,287,121,135,72,63,222
2021,Spelthorne 006,E02006408,8287,7610,359,275,84,144,65,79,174
2021,Spelthorne 007,E02006409,6408,5767,324,229,95,131,74,57,186
2021,Spelthorne 008,E02006410,7964,7272,313,241,72,162,72,90,217
2021,Spelthorne 009,E02006411,6824,6220,351,272,79,106,51,55,147
2021,Spelthorne 010,E02006412,7351,6767,348,261,87,88,44,44,148
2021,Spelthorne 011,E02006413,6146,5618,283,218,65,83,42,41,162
2021,Spelthorne 012,E02006414,5928,5379,319,234,85,92,42,50,138
2021,Spelthorne 013,E02006415,6697,6080,347,259,88,96,51,45,174
2021,Surrey Heath 001,E02006416,7956,7335,346,279,67,104,39,65,171
2021,Surrey Heath 002,E02006417,5725,5310,251,183,68,57,25,32,107
2021,Surrey Heath 003,E02006418,6277,5785,320,253,67,71,34,37,101
2021,Surrey Heath 004,E02006419,7751,7093,314,242,72,138,53,85,206
2021,Surrey Heath 005,E02006420,7455,6898,327,239,88,94,53,41,136
2021,Surrey Heath 006,E02006421,9812,9088,466,374,92,91,51,40,167
2021,Surrey Heath 007,E02006422,5915,5459,265,195,70,68,32,36,123
2021,Surrey Heath 008,E02006423,10616,9787,440,317,123,176,72,104,213
2021,Surrey Heath 009,E02006424,6229,5723,294,215,79,93,44,49,119
2021,Surrey Heath 010,E02006425,6153,5713,221,165,56,83,40,43,136
2021,Surrey Heath 011,E02006426,5281,4924,224,168,56,61,36,25,72
2021,Surrey Heath 012,E02006427,6801,6262,303,235,68,89,47,42,147
2021,Tandridge 002,E02006429,7634,7072,342,270,72,83,50,33,137
2021,Tandridge 003,E02006430,8866,8082,441,325,116,152,75,77,191
2021,Tandridge 004,E02006431,10870,10027,494,396,98,135,65,70,214
2021,Tandridge 005,E02006432,5373,4910,273,208,65,79,41,38,111
2021,Tandridge 006,E02006433,8983,8255,472,371,101,95,54,41,161
2021,Tandridge 007,E02006434,6233,5658,289,216,73,106,57,49,180
2021,Tandridge 008,E02006435,5770,5274,286,215,71,81,36,45,129
2021,Tandridge 009,E02006436,5843,5332,286,207,79,84,46,38,141
2021,Tandridge 010,E02006437,7998,7303,395,301,94,86,50,36,214
2021,Tandridge 011,E02006438,8027,7310,399,297,102,117,69,48,201
2021,Waverley 001,E02006439,5914,5405,319,245,74,81,36,45,109
2021,Waverley 002,E02006440,6845,6323,296,211,85,80,39,41,146
2021,Waverley 003,E02006441,8019,7419,356,274,82,94,49,45,150
2021,Waverley 004,E02006442,6130,5665,279,222,57,75,40,35,111
2021,Waverley 005,E02006443,6994,6383,336,250,86,111,49,62,164
2021,Waverley 006,E02006444,6764,6207,328,266,62,88,46,42,141
2021,Waverley 007,E02006445,7943,7372,378,309,69,90,44,46,103
2021,Waverley 008,E02006446,6659,6137,325,258,67,62,35,27,135
2021,Waverley 009,E02006447,6435,5911,330,260,70,66,29,37,128
2021,Waverley 010,E02006448,6938,6395,335,273,62,85,48,37,123
2021,Waverley 011,E02006449,6601,6017,361,273,88,96,55,41,127
2021,Waverley 012,E02006450,6807,6297,320,261,59,74,33,41,116
2021,Waverley 013,E02006451,11250,10332,545,421,124,142,76,66,231
2021,Waverley 015,E02006453,8021,7358,406,327,79,91,48,43,166
2021,Waverley 016,E02006454,6418,5931,299,244,55,74,38,36,114
2021,Waverley 017,E02006455,5833,5386,261,211,50,58,36,22,128
2021,Woking 001,E02006456,7529,6928,319,246,73,114,54,60,168
2021,Woking 002,E02006457,8832,8125,486,377,109,85,47,38,136
2021,Woking 003,E02006458,8769,8000,470,358,112,112,58,54,187
2021,Woking 004,E02006459,9889,9103,306,197,109,243,112,131,237
2021,Woking 005,E02006460,8727,7968,398,299,99,142,75,67,219
2021,Woking 006,E02006461,6470,5974,283,231,52,88,46,42,125
2021,Woking 007,E02006462,7886,7219,369,276,93,131,54,77,167
2021,Woking 008,E02006463,9968,9389,340,262,78,103,53,50,136
2021,Woking 009,E02006464,6411,5836,324,238,86,91,47,44,160
2021,Woking 010,E02006465,5874,5419,292,234,58,47,21,26,116
2021,Woking 011,E02006466,10569,9594,469,316,153,221,105,116,285
2021,Woking 012,E02006467,6814,6264,350,280,70,75,34,41,125
2021,North Warwickshire 001,E02006468,10472,9441,522,399,123,182,80,102,327
2021,North Warwickshire 002,E02006469,8290,7415,367,248,119,178,89,89,330
2021,North Warwickshire 003,E02006470,11117,9995,494,370,124,230,94,136,398
2021,North Warwickshire 004,E02006471,6684,6008,373,284,89,127,73,54,176
2021,North Warwickshire 005,E02006472,9293,8404,412,289,123,192,98,94,285
2021,North Warwickshire 006,E02006473,9875,8976,493,357,136,167,83,84,239
2021,North Warwickshire 007,E02006474,6097,5456,327,237,90,109,60,49,205
2021,Nuneaton and Bedworth 001,E02006475,9011,8136,486,360,126,147,74,73,242
2021,Nuneaton and Bedworth 002,E02006476,8862,8093,282,184,98,197,78,119,290
2021,Nuneaton and Bedworth 003,E02006477,8264,7486,413,318,95,140,60,80,225
2021,Nuneaton and Bedworth 004,E02006478,7913,7172,383,279,104,138,54,84,220
2021,Nuneaton and Bedworth 005,E02006479,8614,7834,320,221,99,184,73,111,276
2021,Nuneaton and Bedworth 006,E02006480,7021,6323,297,185,112,162,68,94,239
2021,Nuneaton and Bedworth 007,E02006481,6857,6138,300,203,97,156,65,91,263
2021,Nuneaton and Bedworth 008,E02006482,6782,6143,306,220,86,130,56,74,203
2021,Nuneaton and Bedworth 009,E02006483,7495,6780,256,176,80,187,74,113,272
2021,Nuneaton and Bedworth 010,E02006484,7247,6565,315,220,95,152,71,81,215
2021,Nuneaton and Bedworth 011,E02006485,6339,5675,387,283,104,116,69,47,161
2021,Nuneaton and Bedworth 012,E02006486,6725,6029,312,214,98,154,79,75,230
2021,Nuneaton and Bedworth 013,E02006487,6558,5829,281,188,93,178,84,94,270
2021,Nuneaton and Bedworth 014,E02006488,5831,5187,326,228,98,128,64,64,190
2021,Nuneaton and Bedworth 015,E02006489,7542,6815,298,220,78,157,72,85,272
2021,Nuneaton and Bedworth 016,E02006490,7305,6538,346,228,118,153,70,83,268
2021,Rugby 002,E02006493,10042,9242,414,323,91,175,81,94,211
2021,Rugby 003,E02006494,6883,6383,208,159,49,117,53,64,175
2021,Rugby 004,E02006495,7396,6654,425,316,109,130,73,57,187
2021,Rugby 005,E02006496,6746,6317,200,142,58,113,52,61,116
2021,Rugby 006,E02006497,7637,7071,286,198,88,121,53,68,159
2021,Rugby 007,E02006498,13024,11903,584,438,146,193,80,113,344
2021,Rugby 008,E02006499,6092,5596,303,222,81,74,35,39,119
2021,Rugby 009,E02006500,5861,5362,281,212,69,98,43,55,120
2021,Rugby 010,E02006501,9655,8805,462,340,122,166,87,79,222
2021,Rugby 011,E02006502,10567,9526,536,389,147,174,79,95,331
2021,Rugby 012,E02006503,9602,8749,502,380,122,134,74,60,217
2021,Stratford-on-Avon 001,E02006504,5663,5155,296,234,62,86,47,39,126
2021,Stratford-on-Avon 002,E02006505,6688,6055,370,278,92,90,41,49,173
2021,Stratford-on-Avon 003,E02006506,5756,5258,243,176,67,99,51,48,156
2021,Stratford-on-Avon 004,E02006507,10462,9624,492,397,95,142,69,73,204
2021,Stratford-on-Avon 005,E02006508,10569,9636,538,423,115,144,84,60,251
2021,Stratford-on-Avon 006,E02006509,5631,5088,287,225,62,103,54,49,153
2021,Stratford-on-Avon 007,E02006510,6593,5983,352,284,68,74,44,30,184
2021,Stratford-on-Avon 008,E02006511,10081,9203,502,398,104,141,71,70,235
2021,Stratford-on-Avon 009,E02006512,11726,10842,508,391,117,160,85,75,216
2021,Stratford-on-Avon 010,E02006513,7961,7323,366,292,74,88,42,46,184
2021,Stratford-on-Avon 011,E02006514,8574,7864,405,298,107,115,66,49,190
2021,Stratford-on-Avon 012,E02006515,10581,9625,533,393,140,152,71,81,271
2021,Stratford-on-Avon 013,E02006516,9163,8343,495,366,129,106,61,45,219
2021,Stratford-on-Avon 014,E02006517,9250,8539,410,321,89,124,60,64,177
2021,Stratford-on-Avon 015,E02006518,9779,8922,519,403,116,125,66,59,213
2021,Warwick 001,E02006519,7646,7020,422,333,89,91,48,43,113
2021,Warwick 002,E02006520,8073,7354,444,350,94,95,53,42,180
2021,Warwick 003,E02006521,7010,6378,379,306,73,79,46,33,174
2021,Warwick 004,E02006522,5573,5073,329,258,71,85,44,41,86
2021,Warwick 005,E02006523,12382,11405,609,493,116,137,59,78,231
2021,Warwick 006,E02006524,5197,4752,208,146,62,105,53,52,132
2021,Warwick 007,E02006525,12462,11543,540,435,105,146,69,77,233
2021,Warwick 008,E02006526,8199,7453,397,302,95,141,74,67,208
2021,Warwick 009,E02006527,8962,8339,387,313,74,109,55,54,127
2021,Warwick 010,E02006528,10703,9988,405,324,81,129,68,61,181
2021,Warwick 011,E02006529,11948,11016,490,377,113,202,100,102,240
2021,Warwick 012,E02006530,12451,11543,506,398,108,159,81,78,243
2021,Warwick 013,E02006531,9888,9243,315,232,83,142,72,70,188
2021,Warwick 014,E02006532,10840,9954,557,422,135,139,64,75,190
2021,Warwick 015,E02006533,9680,8844,439,322,117,169,76,93,228
2021,Adur 001,E02006534,8638,7844,408,292,116,143,86,57,243
2021,Adur 002,E02006535,6974,6340,382,297,85,93,56,37,159
2021,Adur 003,E02006536,7175,6441,394,294,100,129,72,57,211
2021,Adur 004,E02006537,9928,8961,465,327,138,205,100,105,297
2021,Adur 005,E02006538,8839,8037,496,373,123,113,53,60,193
2021,Adur 006,E02006539,6966,6250,338,227,111,136,60,76,242
2021,Adur 007,E02006540,5426,4886,235,175,60,104,57,47,201
2021,Adur 008,E02006541,7407,6717,358,281,77,131,67,64,201
2021,Arun 001,E02006542,5556,5035,299,224,75,81,45,36,141
2021,Arun 002,E02006543,5416,4888,302,221,81,92,52,40,134
2021,Arun 003,E02006544,11071,10083,526,390,136,185,89,96,277
2021,Arun 004,E02006545,11246,10313,420,301,119,191,94,97,322
2021,Arun 005,E02006546,10453,9460,490,379,111,181,88,93,322
2021,Arun 006,E02006547,6562,5952,278,183,95,130,70,60,202
2021,Arun 007,E02006548,9280,8487,413,296,117,152,77,75,228
2021,Arun 008,E02006549,6108,5420,365,282,83,99,60,39,224
2021,Arun 009,E02006550,9246,8289,466,345,121,160,80,80,331
2021,Arun 010,E02006551,7790,6941,448,337,111,132,73,59,269
2021,Arun 011,E02006552,6994,6416,283,215,68,134,66,68,161
2021,Arun 012,E02006553,9110,8343,374,283,91,140,67,73,253
2021,Arun 013,E02006554,6385,5733,370,264,106,104,60,44,178
2021,Arun 014,E02006555,7309,6685,298,215,83,137,54,83,189
2021,Arun 015,E02006556,10162,9218,486,395,91,163,79,84,295
2021,Arun 016,E02006557,7327,6682,310,208,102,148,57,91,187
2021,Arun 017,E02006558,10255,9527,352,246,106,163,64,99,213
2021,Arun 018,E02006559,7982,7187,429,306,123,113,65,48,253
2021,Arun 019,E02006560,9383,8410,426,311,115,192,93,99,355
2021,Chichester 001,E02006561,6436,5939,293,216,77,92,44,48,112
2021,Chichester 002,E02006562,5911,5379,336,273,63,64,40,24,132
2021,Chichester 003,E02006563,5575,5052,327,245,82,81,46,35,115
2021,Chichester 004,E02006564,7673,7035,373,288,85,102,48,54,163
2021,Chichester 005,E02006565,7889,7277,346,279,67,93,49,44,173
2021,Chichester 006,E02006566,7855,7080,442,349,93,105,48,57,228
2021,Chichester 007,E02006567,7335,6606,432,339,93,114,54,60,183
2021,Chichester 008,E02006568,11659,10694,488,381,107,178,94,84,299
2021,Chichester 009,E02006569,9147,8436,430,329,101,95,46,49,186
2021,Chichester 010,E02006570,8574,7939,363,286,77,100,53,47,172
2021,Chichester 011,E02006571,8142,7450,404,317,87,112,58,54,176
2021,Chichester 012,E02006572,10822,9902,473,353,120,194,89,105,253
2021,Chichester 013,E02006573,11185,10043,634,489,145,210,107,103,298
2021,Chichester 014,E02006574,10554,9437,537,368,169,198,106,92,382
2021,Crawley 001,E02006575,8374,7683,300,211,89,182,81,101,209
2021,Crawley 002,E02006576,9908,9190,418,319,99,119,54,65,181
2021,Crawley 003,E02006577,8496,7751,320,224,96,167,80,87,258
2021,Crawley 004,E02006578,11707,10928,349,250,99,190,86,104,240
2021,Crawley 005,E02006579,7916,7271,334,241,93,141,72,69,170
2021,Crawley 006,E02006580,7870,7157,345,238,107,165,87,78,203
2021,Crawley 007,E02006581,9611,8923,348,239,109,145,62,83,195
2021,Crawley 008,E02006582,7441,6898,336,263,73,85,37,48,122
2021,Crawley 009,E02006583,8925,8139,406,290,116,155,69,86,225
2021,Crawley 010,E02006584,7272,6620,286,191,95,183,90,93,183
2021,Crawley 011,E02006585,7838,7139,325,222,103,138,60,78,236
2021,Crawley 012,E02006586,7521,6910,264,173,91,161,67,94,186
2021,Crawley 013,E02006587,7979,7278,305,208,97,177,79,98,219
2021,Horsham 001,E02006588,9746,9058,410,316,94,123,51,72,155
2021,Horsham 002,E02006589,10788,9918,519,401,118,134,70,64,217
2021,Horsham 003,E02006590,8359,7636,448,356,92,112,55,57,163
2021,Horsham 004,E02006591,7824,7198,370,284,86,110,55,55,146
2021,Horsham 005,E02006592,6368,5794,373,291,82,70,42,28,131
2021,Horsham 006,E02006593,10649,9839,450,359,91,135,67,68,225
2021,Horsham 007,E02006594,10195,9424,430,344,86,144,60,84,197
2021,Horsham 008,E02006595,8577,7868,455,372,83,79,39,40,175
2021,Horsham 009,E02006596,8892,8172,446,355,91,123,56,67,151
2021,Horsham 010,E02006597,11608,10672,547,428,119,141,69,72,248
2021,Horsham 011,E02006598,5252,4756,331,261,70,60,38,22,105
2021,Horsham 012,E02006599,6743,6129,380,297,83,79,41,38,155
2021,Horsham 013,E02006600,9428,8612,438,343,95,161,81,80,217
2021,Horsham 014,E02006601,8523,7704,482,384,98,120,58,62,217
2021,Horsham 015,E02006602,8291,7616,416,325,91,96,43,53,163
2021,Horsham 016,E02006603,8158,7397,489,384,105,105,50,55,167
2021,Mid Sussex 001,E02006604,12609,11618,564,407,157,179,72,107,248
2021,Mid Sussex 002,E02006605,6054,5530,306,226,80,94,55,39,124
2021,Mid Sussex 003,E02006606,7931,7332,404,321,83,67,36,31,128
2021,Mid Sussex 004,E02006607,7589,6975,390,289,101,85,45,40,139
2021,Mid Sussex 005,E02006608,6002,5502,288,228,60,70,35,35,142
2021,Mid Sussex 006,E02006609,6586,6021,360,298,62,74,40,34,131
2021,Mid Sussex 007,E02006610,7467,6920,328,260,68,87,43,44,132
2021,Mid Sussex 008,E02006611,10769,9989,487,395,92,117,57,60,176
2021,Mid Sussex 009,E02006612,11091,10330,458,345,113,125,57,68,178
2021,Mid Sussex 010,E02006613,7289,6643,356,273,83,131,61,70,159
2021,Mid Sussex 011,E02006614,12042,11110,565,439,126,148,84,64,219
2021,Mid Sussex 012,E02006615,6669,6171,288,222,66,95,49,46,115
2021,Mid Sussex 013,E02006616,9177,8365,477,375,102,127,55,72,208
2021,Mid Sussex 014,E02006617,8620,7867,385,302,83,146,73,73,222
2021,Mid Sussex 015,E02006618,6179,5666,306,242,64,49,23,26,158
2021,Mid Sussex 016,E02006619,8636,7919,415,320,95,120,61,59,182
2021,Mid Sussex 017,E02006620,9548,8710,497,392,105,122,71,51,219
2021,Worthing 001,E02006621,7471,6674,463,369,94,132,74,58,202
2021,Worthing 002,E02006622,7519,6738,406,300,106,141,72,69,234
2021,Worthing 003,E02006623,7646,6909,344,244,100,146,69,77,247
2021,Worthing 004,E02006624,7077,6436,399,316,83,88,50,38,154
2021,Worthing 005,E02006625,7633,6997,364,288,76,103,60,43,169
2021,Worthing 006,E02006626,9408,8488,393,283,110,216,98,118,311
2021,Worthing 007,E02006627,9073,8158,479,358,121,155,80,75,281
2021,Worthing 008,E02006628,8413,7733,371,262,109,120,52,68,189
2021,Worthing 009,E02006629,7412,6714,350,265,85,130,64,66,218
2021,Worthing 010,E02006630,8519,7843,359,267,92,113,45,68,204
2021,Worthing 011,E02006631,9709,9028,374,309,65,134,57,77,173
2021,Worthing 012,E02006632,7889,7149,424,331,93,101,54,47,215
2021,Worthing 013,E02006633,8122,7306,437,334,103,141,80,61,238
2021,Wiltshire 012,E02006634,8229,7546,421,323,98,95,47,48,167
2021,Wiltshire 019,E02006635,8821,8126,398,314,84,94,46,48,203
2021,Wiltshire 024,E02006636,6812,6213,345,268,77,103,44,59,151
2021,Wiltshire 025,E02006637,10466,9495,511,398,113,180,91,89,280
2021,Wiltshire 026,E02006638,6146,5495,355,274,81,102,56,46,194
2021,Wiltshire 028,E02006639,8146,7367,431,342,89,125,66,59,223
2021,Wiltshire 029,E02006640,7031,6432,357,279,78,85,50,35,157
2021,Wiltshire 034,E02006641,7873,7192,392,299,93,114,46,68,175
2021,Wiltshire 038,E02006642,5434,4938,273,212,61,83,38,45,140
2021,Wiltshire 001,E02006644,6554,5927,363,280,83,103,59,44,161
2021,Wiltshire 002,E02006645,7509,6919,333,255,78,106,41,65,151
2021,Wiltshire 003,E02006646,7756,7111,354,271,83,134,64,70,157
2021,Wiltshire 004,E02006647,5902,5370,334,264,70,67,39,28,131
2021,Wiltshire 005,E02006648,5987,5458,300,233,67,85,45,40,144
2021,Wiltshire 006,E02006649,7286,6648,303,223,80,140,71,69,195
2021,Wiltshire 007,E02006650,13354,12348,539,414,125,190,90,100,277
2021,Wiltshire 008,E02006651,6978,6366,378,299,79,103,55,48,131
2021,Wiltshire 009,E02006652,9211,8429,444,339,105,139,74,65,199
2021,Wiltshire 010,E02006653,9335,8514,469,368,101,155,72,83,197
2021,Wiltshire 011,E02006654,9121,8345,391,305,86,167,75,92,218
2021,Wiltshire 013,E02006655,7826,7160,397,322,75,106,51,55,163
2021,Wiltshire 014,E02006656,6365,5816,300,231,69,122,62,60,127
2021,Wiltshire 015,E02006657,10527,9543,464,325,139,204,74,130,316
2021,Wiltshire 016,E02006658,7539,6860,345,254,91,136,74,62,198
2021,Wiltshire 017,E02006659,7836,7220,360,285,75,94,49,45,162
2021,Wiltshire 018,E02006660,12813,11672,591,444,147,226,113,113,324
2021,Wiltshire 045,E02006661,9031,8477,276,200,76,117,65,52,161
2021,Wiltshire 046,E02006662,6776,6200,283,205,78,114,47,67,179
2021,Wiltshire 048,E02006663,12325,11268,494,351,143,212,102,110,351
2021,Wiltshire 049,E02006664,6149,5547,353,275,78,97,52,45,152
2021,Wiltshire 050,E02006665,6515,5878,344,254,90,103,54,49,190
2021,Wiltshire 051,E02006666,6505,5966,283,197,86,92,47,45,164
2021,Wiltshire 052,E02006667,7021,6399,281,198,83,118,51,67,223
2021,Wiltshire 053,E02006668,5673,5123,322,241,81,76,42,34,152
2021,Wiltshire 054,E02006669,9957,9015,520,405,115,163,76,87,259
2021,Wiltshire 055,E02006670,6562,6086,276,221,55,87,37,50,113
2021,Wiltshire 056,E02006671,5919,5503,243,190,53,75,34,41,98
2021,Wiltshire 057,E02006672,8917,8196,392,297,95,135,59,76,194
2021,Wiltshire 058,E02006673,4848,4439,224,181,43,61,36,25,124
2021,Wiltshire 059,E02006674,5713,5250,257,191,66,101,42,59,105
2021,Wiltshire 060,E02006675,7788,6972,512,386,126,112,61,51,192
2021,Wiltshire 061,E02006676,5935,5370,344,270,74,85,36,49,136
2021,Wiltshire 062,E02006677,7632,6932,430,327,103,114,54,60,156
2021,Wiltshire 020,E02006678,7353,6644,360,265,95,144,72,72,205
2021,Wiltshire 021,E02006679,11786,10756,567,421,146,176,68,108,287
2021,Wiltshire 022,E02006680,7243,6602,305,220,85,128,61,67,208
2021,Wiltshire 023,E02006681,5719,5179,340,278,62,70,35,35,130
2021,Wiltshire 027,E02006682,9920,9031,555,428,127,130,65,65,204
2021,Wiltshire 030,E02006683,7689,7004,388,304,84,97,46,51,200
2021,Wiltshire 031,E02006684,6504,5937,264,198,66,117,58,59,186
2021,Wiltshire 032,E02006685,9528,8726,436,329,107,136,63,73,230
2021,Wiltshire 033,E02006686,5183,4652,264,186,78,96,57,39,171
2021,Wiltshire 035,E02006687,7655,6991,317,220,97,138,78,60,209
2021,Wiltshire 036,E02006688,5311,4778,273,209,64,95,44,51,165
2021,Wiltshire 037,E02006689,6672,6062,364,268,96,94,48,46,152
2021,Wiltshire 039,E02006690,6696,6001,386,292,94,112,57,55,197
2021,Wiltshire 042,E02006692,5246,4806,217,145,72,84,52,32,139
2021,Wiltshire 043,E02006693,6166,5623,274,201,73,101,51,50,168
2021,Wiltshire 044,E02006694,5874,5288,312,229,83,100,54,46,174
2021,Wiltshire 047,E02006695,6203,5598,352,271,81,102,58,44,151
2021,Bromsgrove 001,E02006696,6898,6281,363,298,65,82,47,35,172
2021,Bromsgrove 002,E02006697,7156,6379,460,347,113,134,68,66,183
2021,Bromsgrove 003,E02006698,6097,5412,346,258,88,135,72,63,204
2021,Bromsgrove 004,E02006699,5625,5090,292,198,94,96,57,39,147
2021,Bromsgrove 005,E02006700,6035,5434,360,271,89,103,50,53,138
2021,Bromsgrove 006,E02006701,6903,6266,412,323,89,87,51,36,138
2021,Bromsgrove 007,E02006702,5614,5045,298,211,87,96,48,48,175
2021,Bromsgrove 008,E02006703,7594,6888,419,320,99,103,57,46,184
2021,Bromsgrove 009,E02006704,6605,5990,351,275,76,86,40,46,178
2021,Bromsgrove 010,E02006705,6960,6324,332,236,96,123,65,58,181
2021,Bromsgrove 011,E02006706,6655,6079,317,234,83,87,48,39,172
2021,Bromsgrove 012,E02006707,6463,5915,349,268,81,83,42,41,116
2021,Bromsgrove 013,E02006708,7501,6859,328,225,103,111,64,47,203
2021,Bromsgrove 014,E02006709,7913,7157,434,345,89,105,53,52,217
2021,Malvern Hills 001,E02006710,8094,7295,455,339,116,130,61,69,214
2021,Malvern Hills 002,E02006711,8236,7488,433,305,128,122,58,64,193
2021,Malvern Hills 003,E02006712,7320,6614,376,302,74,132,72,60,198
2021,Malvern Hills 004,E02006713,6065,5411,374,267,107,104,55,49,176
2021,Malvern Hills 005,E02006714,5651,5122,307,243,64,88,45,43,134
2021,Malvern Hills 006,E02006715,8337,7558,456,367,89,124,61,63,199
2021,Malvern Hills 007,E02006716,6057,5468,243,168,75,134,61,73,212
2021,Malvern Hills 008,E02006717,6582,5994,324,240,84,105,60,45,159
2021,Malvern Hills 009,E02006718,5797,5224,316,240,76,95,50,45,162
2021,Malvern Hills 010,E02006719,7216,6543,414,328,86,98,46,52,161
2021,Malvern Hills 011,E02006720,7013,6314,426,341,85,94,45,49,179
2021,Redditch 001,E02006721,6264,5659,310,233,77,110,56,54,185
2021,Redditch 002,E02006722,5095,4622,168,110,58,125,51,74,180
2021,Redditch 003,E02006723,8698,7975,322,232,90,152,70,82,249
2021,Redditch 004,E02006724,6530,5995,197,129,68,140,49,91,198
2021,Redditch 005,E02006725,5219,4732,203,146,57,111,58,53,173
2021,Redditch 006,E02006726,6017,5521,237,156,81,102,46,56,157
2021,Redditch 007,E02006727,5647,5117,254,168,86,107,56,51,169
2021,Redditch 008,E02006728,7332,6711,355,253,102,115,55,60,151
2021,Redditch 009,E02006729,7213,6522,308,211,97,153,67,86,230
2021,Redditch 010,E02006730,6294,5711,205,135,70,135,56,79,243
2021,Redditch 011,E02006731,5291,4791,261,180,81,95,34,61,144
2021,Redditch 012,E02006732,6660,6026,352,262,90,114,37,77,168
2021,Redditch 013,E02006733,5778,5226,327,246,81,99,54,45,126
2021,Worcester 001,E02006734,7877,7150,429,309,120,99,60,39,199
2021,Worcester 002,E02006735,5078,4570,177,127,50,140,51,89,191
2021,Worcester 003,E02006736,6153,5661,276,215,61,90,41,49,126
2021,Worcester 004,E02006737,7877,7209,348,270,78,113,50,63,207
2021,Worcester 005,E02006738,8645,7913,284,185,99,175,56,119,273
2021,Worcester 006,E02006739,5586,5174,218,151,67,73,42,31,121
2021,Worcester 007,E02006740,7077,6605,268,212,56,87,39,48,117
2021,Worcester 008,E02006741,5894,5465,242,193,49,76,37,39,111
2021,Worcester 009,E02006742,8559,7865,345,248,97,116,48,68,233
2021,Worcester 010,E02006743,6509,5931,251,170,81,131,55,76,196
2021,Worcester 011,E02006744,7064,6575,230,176,54,132,54,78,127
2021,Worcester 012,E02006745,8322,7593,406,296,110,123,59,64,200
2021,Worcester 013,E02006746,8537,7825,399,295,104,112,57,55,201
2021,Worcester 014,E02006747,5410,4978,277,211,66,59,28,31,96
2021,Wychavon 001,E02006748,8271,7561,376,287,89,158,82,76,176
2021,Wychavon 002,E02006749,5107,4612,173,127,46,118,56,62,204
2021,Wychavon 003,E02006750,5168,4674,258,190,68,92,39,53,144
2021,Wychavon 004,E02006751,5622,5111,234,175,59,106,49,57,171
2021,Wychavon 005,E02006752,7828,7157,379,295,84,104,47,57,188
2021,Wychavon 006,E02006753,7005,6362,345,271,74,121,49,72,177
2021,Wychavon 007,E02006754,5577,5023,328,267,61,98,42,56,128
2021,Wychavon 008,E02006755,5662,5107,335,263,72,79,34,45,141
2021,Wychavon 009,E02006756,6308,5728,328,256,72,101,48,53,151
2021,Wychavon 010,E02006757,6980,6299,380,300,80,119,70,49,182
2021,Wychavon 011,E02006758,6196,5635,314,219,95,91,38,53,156
2021,Wychavon 012,E02006759,8009,7214,405,298,107,133,72,61,257
2021,Wychavon 013,E02006760,8628,7784,409,313,96,149,81,68,286
2021,Wychavon 014,E02006761,5968,5564,198,150,48,82,29,53,124
2021,Wychavon 015,E02006762,6729,6163,291,228,63,99,46,53,176
2021,Wychavon 016,E02006763,8005,7411,320,231,89,129,60,69,145
2021,Wychavon 017,E02006764,5484,5062,193,149,44,95,49,46,134
2021,Wychavon 018,E02006765,6104,5525,320,230,90,93,52,41,166
2021,Wychavon 019,E02006766,7587,6823,458,348,110,106,47,59,200
2021,Wyre Forest 001,E02006767,9218,8228,508,354,154,178,88,90,304
2021,Wyre Forest 002,E02006768,6665,6009,333,225,108,127,63,64,196
2021,Wyre Forest 003,E02006769,6735,6108,328,256,72,117,55,62,182
2021,Wyre Forest 004,E02006770,7783,7129,280,197,83,176,76,100,198
2021,Wyre Forest 005,E02006771,6512,5833,308,225,83,121,65,56,250
2021,Wyre Forest 006,E02006772,6376,5740,294,210,84,103,59,44,239
2021,Wyre Forest 007,E02006773,7821,7110,341,242,99,138,63,75,232
2021,Wyre Forest 008,E02006774,7141,6451,351,255,96,135,69,66,204
2021,Wyre Forest 009,E02006775,5723,5166,213,141,72,157,64,93,187
2021,Wyre Forest 010,E02006776,6086,5469,308,230,78,135,65,70,174
2021,Wyre Forest 011,E02006777,6985,6261,390,273,117,134,67,67,200
2021,Wyre Forest 012,E02006778,6838,6168,328,246,82,136,71,65,206
2021,Wyre Forest 013,E02006779,7268,6510,353,241,112,157,63,94,248
2021,Wyre Forest 014,E02006780,5646,5060,246,170,76,101,57,44,239
2021,Isles of Scilly 001,E02006781,1957,1758,118,87,31,27,19,8,54
2021,Bromley 040,E02006782,7641,6985,326,231,95,129,59,70,201
2021,Lewisham 037,E02006783,7308,6668,247,174,73,171,65,106,222
2021,Lewisham 038,E02006784,7563,6852,295,207,88,179,88,91,237
2021,Bexley 029,E02006785,6249,5668,264,186,78,126,65,61,191
2021,Greenwich 033,E02006786,7068,6481,283,186,97,136,69,67,168
2021,Bromley 041,E02006787,7374,6800,326,256,70,99,55,44,149
2021,Croydon 045,E02006788,7096,6410,330,232,98,177,85,92,179
2021,Bromley 042,E02006789,6483,5818,347,260,87,127,63,64,191
2021,Tandridge 012,E02006790,7301,6602,420,313,107,85,47,38,194
2021,Ealing 040,E02006791,7116,6712,232,177,55,80,41,39,92
2021,Hounslow 029,E02006792,8544,8039,250,194,56,107,38,69,148
2021,Enfield 037,E02006793,8996,8212,293,179,114,258,89,169,233
2021,Haringey 037,E02006794,7705,7199,201,137,64,146,63,83,159
2021,Harrow 032,E02006795,7845,7191,329,229,100,160,84,76,165
2021,Hillingdon 033,E02006796,9051,8303,415,306,109,153,86,67,180
2021,Lewisham 039,E02006798,8426,7877,281,198,83,138,53,85,130
2021,Barking and Dagenham 023,E02006799,11118,10279,330,216,114,235,122,113,274
2021,Redbridge 034,E02006800,13536,12569,458,277,181,256,116,140,253
2021,Lambeth 036,E02006801,8335,7829,307,228,79,96,47,49,103
2021,Southwark 034,E02006802,8919,8365,292,211,81,122,63,59,140
2021,Sheffield 072,E02006803,8810,7965,468,363,105,130,54,76,247
2021,North East Derbyshire 014,E02006804,7835,7068,351,243,108,155,71,84,261
2021,Coventry 043,E02006805,8470,7719,318,217,101,195,93,102,238
2021,Nuneaton and Bedworth 018,E02006806,8075,7347,313,206,107,170,84,86,245
2021,Birmingham 132,E02006807,7717,6951,423,303,120,148,74,74,195
2021,Solihull 030,E02006808,6296,5819,251,188,63,102,51,51,124
2021,Birmingham 133,E02006809,9613,8715,440,287,153,207,108,99,251
2021,Sandwell 039,E02006810,10088,9075,473,320,153,222,89,133,318
2021,Middlesbrough 020,E02006811,10783,9785,528,377,151,183,98,85,287
2021,Redcar and Cleveland 021,E02006812,7227,6423,306,203,103,193,95,98,305
2021,Kingston upon Hull 033,E02006813,7787,7040,273,197,76,153,68,85,321
2021,East Riding of Yorkshire 043,E02006814,7658,6964,320,235,85,169,92,77,205
2021,Leicester 037,E02006815,10842,9916,370,246,124,226,93,133,330
2021,Harborough 011,E02006816,8321,7559,419,321,98,142,74,68,201
2021,Leicester 038,E02006817,8749,8064,352,258,94,172,86,86,161
2021,Oadby and Wigston 008,E02006818,7994,7155,435,305,130,152,75,77,252
2021,Leicester 039,E02006819,8192,7466,227,151,76,208,62,146,291
2021,Blaby 013,E02006820,10287,9220,574,424,150,202,114,88,291
2021,Portsmouth 026,E02006821,6328,5745,314,235,79,96,44,52,173
2021,Havant 018,E02006822,8891,8011,425,304,121,187,92,95,268
2021,Buckinghamshire 039,E02006823,8539,7819,458,373,85,92,58,34,170
2021,Buckinghamshire 036,E02006824,9122,8376,452,353,99,121,69,52,173
2021,East Cambridgeshire 011,E02006825,5890,5399,294,223,71,76,39,37,121
2021,West Suffolk 015,E02006826,9254,8667,321,242,79,98,38,60,168
2021,Amber Valley 017,E02006827,7540,6683,347,233,114,193,77,116,317
2021,Erewash 016,E02006828,6760,6089,367,263,104,123,58,65,181
2021,East Hampshire 016,E02006829,7091,6507,353,268,85,91,39,52,140
2021,Havant 019,E02006830,6248,5689,253,186,67,111,50,61,195
2021,Havant 020,E02006831,5931,5406,277,222,55,87,43,44,161
2021,Sevenoaks 016,E02006832,5709,5153,297,231,66,103,49,54,156
2021,Tonbridge and Malling 014,E02006833,11626,10614,521,395,126,180,90,90,311
2021,Nottingham 038,E02006834,7202,6487,255,165,90,174,89,85,286
2021,Gedling 016,E02006835,5770,5143,321,231,90,131,53,78,175
2021,Sutton 025,E02006836,8285,7631,389,307,82,126,63,63,139
2021,Epsom and Ewell 010,E02006837,11186,10301,527,428,99,132,70,62,226
2021,East Hampshire 017,E02006838,6679,6124,328,266,62,90,44,46,137
2021,Waverley 018,E02006839,8187,7582,373,294,79,85,40,45,147
2021,Torbay 019,E02006840,10797,9639,557,420,137,237,114,123,364
2021,Gateshead 027,E02006841,7408,6909,222,172,50,134,64,70,143
2021,Gateshead 028,E02006842,4786,4400,180,118,62,80,34,46,126
2021,Sheffield 073,E02006843,10333,10051,200,160,40,42,21,21,40
2021,Sheffield 074,E02006844,7604,7286,169,123,46,76,30,46,73
2021,North Somerset 026,E02006845,9049,8364,324,233,91,136,63,73,225
2021,North Somerset 027,E02006846,8815,8225,263,184,79,122,54,68,205
2021,Swindon 026,E02006847,9271,8672,326,238,88,115,45,70,158
2021,Swindon 027,E02006848,7947,7457,253,192,61,114,58,56,123
2021,Swindon 028,E02006849,9710,8972,430,319,111,128,63,65,180
2021,Leicester 040,E02006850,9818,9453,185,140,45,93,42,51,87
2021,Leicester 041,E02006851,9817,9522,204,169,35,65,30,35,26
2021,Leeds 109,E02006852,11296,10605,449,365,84,89,46,43,153
2021,Tower Hamlets 032,E02006853,10303,9809,212,148,64,130,48,82,152
2021,Tower Hamlets 033,E02006854,6725,6449,137,94,43,70,26,44,69
2021,Canterbury 019,E02006855,6048,5557,236,178,58,98,45,53,157
2021,Canterbury 020,E02006856,10708,10037,363,270,93,140,69,71,168
2021,Eastbourne 013,E02006857,8564,7680,406,276,130,182,84,98,296
2021,Eastbourne 014,E02006858,6604,6012,269,188,81,122,60,62,201
2021,Thurrock 019,E02006859,7128,6776,194,148,46,84,39,45,74
2021,Leeds 110,E02006861,13422,12970,301,244,57,74,39,35,77
2021,North Northamptonshire 009,E02006862,6323,5700,263,172,91,153,83,70,207
2021,North Northamptonshire 008,E02006863,11177,10508,325,233,92,164,61,103,180
2021,Boston 008,E02006864,8421,7646,372,268,104,163,66,97,240
2021,Boston 009,E02006865,7913,7262,310,218,92,122,70,52,219
2021,North Kesteven 013,E02006866,8207,7498,360,250,110,124,61,63,225
2021,North Kesteven 014,E02006867,7765,7041,365,273,92,127,60,67,232
2021,Sheffield 075,E02006868,11289,10257,393,252,141,277,122,155,362
2021,Sheffield 076,E02006869,10486,9380,493,344,149,259,124,135,354
2021,Lancaster 020,E02006871,11534,10348,575,399,176,241,111,130,370
2021,High Peak 013,E02006872,12272,11063,661,494,167,206,99,107,342
2021,South Cambridgeshire 020,E02006873,9167,8645,307,213,94,89,37,52,126
2021,South Cambridgeshire 021,E02006874,9639,8821,472,378,94,143,66,77,203
2021,Leeds 111,E02006875,9461,9250,161,132,29,31,16,15,19
2021,Leeds 112,E02006876,7476,7062,157,113,44,123,39,84,134
2021,Peterborough 022,E02006877,10064,9345,367,281,86,176,91,85,176
2021,Peterborough 023,E02006878,11987,11228,366,265,101,181,76,105,212
2021,Folkestone and Hythe 014,E02006879,6158,5665,205,148,57,116,45,71,172
2021,Folkestone and Hythe 015,E02006880,6380,5869,254,193,61,98,43,55,159
2021,Burnley 014,E02006881,10084,9079,438,277,161,233,105,128,334
2021,Harrow 033,E02006882,13594,12287,645,462,183,309,154,155,353
2021,"Bournemouth, Christchurch and Poole 040",E02006883,5480,5130,187,135,52,71,28,43,92
2021,Rossendale 010,E02006884,11734,10602,508,346,162,248,115,133,376
2021,"Bournemouth, Christchurch and Poole 045",E02006885,7206,6728,264,192,72,105,46,59,109
2021,Vale of White Horse 016,E02006886,12975,11978,587,451,136,147,76,71,263
2021,Bristol 054,E02006887,9641,9268,222,151,71,83,33,50,68
2021,Bristol 055,E02006888,6740,6243,231,163,68,126,66,60,140
2021,Bristol 056,E02006889,7469,6952,223,153,70,138,67,71,156
2021,Bristol 057,E02006890,8501,7868,351,263,88,140,67,73,142
2021,East Riding of Yorkshire 044,E02006891,7737,7029,379,271,108,125,63,62,204
2021,East Riding of Yorkshire 045,E02006892,5933,5393,242,186,56,125,54,71,173
2021,Newcastle upon Tyne 031,E02006893,10350,9174,558,377,181,219,113,106,399
2021,Wolverhampton 035,E02006894,13252,12309,306,189,117,314,145,169,323
2021,Birmingham 134,E02006895,8763,8309,209,138,71,126,57,69,119
2021,Birmingham 135,E02006896,5787,5527,110,82,28,98,38,60,52
2021,Birmingham 136,E02006897,7961,7614,169,125,44,106,46,60,72
2021,Birmingham 137,E02006898,7551,7221,186,141,45,95,46,49,49
2021,Birmingham 138,E02006899,5979,5806,114,81,33,40,18,22,19
2021,Birmingham 139,E02006900,14463,13289,376,210,166,387,151,236,411
2021,Manchester 054,E02006902,7665,7341,165,123,42,76,29,47,83
2021,Bassetlaw 016,E02006903,10546,9392,557,379,178,224,99,125,373
2021,Nottingham 039,E02006904,8966,8641,182,127,55,77,30,47,66
2021,Nottingham 040,E02006905,7426,6815,237,167,70,159,67,92,215
2021,Broxtowe 016,E02006906,11639,10404,646,485,161,230,122,108,359
2021,Norwich 014,E02006907,6886,6506,217,180,37,66,39,27,97
2021,Norwich 015,E02006908,5264,4885,213,175,38,69,28,41,97
2021,Hartlepool 014,E02006909,12214,10894,680,471,209,255,121,134,385
2021,Redcar and Cleveland 022,E02006910,9997,8948,380,250,130,282,107,175,387
2021,Manchester 055,E02006912,10055,9750,194,156,38,64,16,48,47
2021,Manchester 056,E02006913,7345,6921,163,101,62,136,53,83,125
2021,Manchester 057,E02006914,7740,7520,157,131,26,41,11,30,22
2021,Manchester 058,E02006915,8643,8032,203,118,85,199,73,126,209
2021,Manchester 059,E02006916,6712,6428,156,112,44,82,34,48,46
2021,Manchester 060,E02006917,6322,6140,134,100,34,31,9,22,17
2021,Hackney 028,E02006918,7722,7164,240,170,70,172,70,102,146
2021,South Derbyshire 012,E02006919,9788,8950,402,297,105,190,73,117,246
2021,South Derbyshire 013,E02006920,7579,6805,390,293,97,156,60,96,228
2021,Hackney 029,E02006921,6960,6487,226,135,91,118,52,66,129
2021,Colchester 022,E02006922,13386,12163,605,439,166,255,105,150,363
2021,Redbridge 035,E02006924,12816,11709,535,344,191,265,139,126,307
2021,Redbridge 036,E02006925,13739,12427,682,432,250,304,151,153,326
2021,Thurrock 020,E02006926,7520,7019,280,206,74,101,36,65,120
2021,Greenwich 034,E02006927,11536,10612,470,336,134,178,81,97,276
2021,Greenwich 035,E02006928,11409,10887,255,191,64,140,57,83,127
2021,Greenwich 037,E02006930,9154,8642,279,212,67,95,48,47,138
2021,Greenwich 038,E02006931,8855,8309,321,229,92,95,43,52,130
2021,Liverpool 060,E02006932,14017,13650,253,193,60,72,37,35,42
2021,Liverpool 061,E02006933,7052,6639,182,125,57,111,51,60,120
2021,Liverpool 062,E02006934,6570,6269,195,134,61,58,24,34,48
2021,St. Helens 024,E02006935,7041,6138,309,208,101,237,107,130,357
2021,St. Helens 025,E02006936,7318,6550,321,209,112,175,79,96,272
2021,Luton 022,E02006937,8651,8207,172,120,52,149,53,96,123
2021,Luton 023,E02006938,5939,5622,128,71,57,108,49,59,81
2021,Reading 019,E02006939,6636,6394,107,86,21,76,30,46,59
2021,Reading 020,E02006940,7776,7487,152,115,37,87,34,53,50
2021,Southwark 035,E02006941,5176,5002,124,106,18,31,10,21,19
2021,Southwark 036,E02006942,6452,6120,183,134,49,80,40,40,69
2021,Sandwell 040,E02006943,6923,6442,171,98,73,151,68,83,159
2021,Sandwell 041,E02006944,7370,6920,161,102,59,142,66,76,147
2021,Bradford 062,E02006945,8267,7484,442,323,119,130,65,65,211
2021,Bradford 063,E02006946,4971,4515,242,195,47,87,33,54,127
2021,Bradford 064,E02006947,9078,8338,257,167,90,236,104,132,247
2021,Bradford 065,E02006948,5971,5678,81,48,33,111,49,62,101
2021,Bristol 058,E02006949,6336,5878,301,236,65,73,39,34,84
2021,Bristol 059,E02006950,7179,6838,189,140,49,78,44,34,74
2021,Bristol 060,E02006951,8374,8128,188,150,38,26,12,14,32
2021,Bristol 061,E02006952,7878,7562,220,184,36,58,29,29,38
2021,Barnet 042,E02006953,8519,8019,244,170,74,134,53,81,122
2021,Barnet 043,E02006954,9396,8853,223,150,73,161,56,105,159
2021,Brent 035,E02006955,7098,6829,134,108,26,72,36,36,63
2021,Brent 036,E02006956,8387,7875,235,154,81,136,64,72,141
2021,Salford 031,E02006957,7265,6750,178,114,64,162,79,83,175
2021,Salford 032,E02006958,7416,6923,167,102,65,136,61,75,190
2021,Salford 033,E02006959,7823,7575,152,117,35,55,22,33,41
2021,Salford 034,E02006960,8973,8599,160,120,40,89,36,53,125
2021,Salford 035,E02006961,6246,5835,149,92,57,134,61,73,128
2021,Salford 036,E02006962,4963,4702,114,88,26,87,21,66,60
2021,Salford 037,E02006963,5803,5616,110,81,29,41,14,27,36
2021,Leicester 042,E02006964,6251,5752,227,156,71,132,60,72,140
2021,Leicester 043,E02006965,7920,7216,339,221,118,186,91,95,179
2021,Oadby and Wigston 010,E02006966,7173,6551,345,247,98,132,69,63,145
2021,Oadby and Wigston 011,E02006967,7359,6642,414,294,120,145,76,69,158
2021,Ealing 041,E02006968,7919,7369,311,230,81,113,53,60,126
2021,Ealing 042,E02006969,6010,5719,143,98,45,69,30,39,79
2021,Ealing 043,E02006970,6855,6481,139,75,64,102,49,53,133
2021,Ealing 044,E02006971,7832,7236,229,136,93,165,85,80,202
2021,Hounslow 030,E02006972,5010,4703,138,94,44,70,39,31,99
2021,Hounslow 031,E02006973,7969,7475,217,157,60,141,60,81,136
2021,Stoke-on-Trent 035,E02006974,10369,9276,415,275,140,269,109,160,409
2021,Portsmouth 027,E02006975,9949,9496,224,163,61,88,40,48,141
2021,Portsmouth 028,E02006976,4968,4524,154,95,59,118,41,77,172
2021,Chelmsford 022,E02006978,6828,6447,226,175,51,71,31,40,84
2021,Chelmsford 023,E02006979,6027,5682,212,176,36,60,29,31,73
2021,Rochford 011,E02006980,7151,6540,339,264,75,100,41,59,172
2021,Rochford 012,E02006981,7547,6841,404,303,101,111,58,53,191
2021,South Staffordshire 015,E02006982,11590,10390,687,518,169,213,103,110,300
2021,Manchester 061,E02006983,6688,6248,153,112,41,128,63,65,159
2021,Manchester 062,E02006984,5451,5229,88,69,19,64,21,43,70
2021,Manchester 063,E02006985,8492,7868,218,129,89,232,103,129,174
2021,Manchester 064,E02006986,5813,5415,172,124,48,112,49,63,114
2021,Croydon 046,E02006987,6897,6605,169,124,45,71,23,48,52
2021,Croydon 047,E02006988,6599,6187,222,162,60,106,45,61,84
2021,Plymouth 033,E02006989,5145,4700,192,132,60,109,41,68,144
2021,Plymouth 034,E02006990,6450,5912,244,170,74,130,54,76,164
2021,Greenwich 039,E02006991,5976,5714,143,104,39,50,16,34,69
2021,Greenwich 040,E02006992,7604,7181,196,144,52,103,42,61,124
2021,Greenwich 041,E02006993,7813,7467,172,121,51,85,38,47,89
2021,Greenwich 042,E02006994,7034,6615,157,114,43,117,54,63,145
2021,Newham 038,E02006995,8194,7858,154,114,40,85,36,49,97
2021,Newham 039,E02006996,7956,7561,169,123,46,101,36,65,125
2021,Newham 040,E02006997,6541,6261,134,98,36,72,31,41,74
2021,Newham 041,E02006998,6554,6182,133,86,47,123,55,68,116
2021,Newham 042,E02006999,10345,9909,196,146,50,101,42,59,139
2021,Oldham 036,E02007000,7000,6452,208,134,74,155,75,80,185
2021,Oldham 037,E02007001,7803,7190,207,118,89,204,94,110,202
2021,Rotherham 034,E02007002,11044,9842,601,428,173,212,102,110,389
2021,Pendle 014,E02007003,10198,9217,476,352,124,221,101,120,284
2021,Thurrock 021,E02007004,6086,5726,168,122,46,87,27,60,105
2021,Thurrock 022,E02007005,7718,7305,180,120,60,105,49,56,128
2021,Dorset 031,E02007006,5518,5023,263,203,60,89,41,48,143
2021,Dorset 032,E02007007,6499,5836,341,255,86,119,61,58,203
2021,Lewisham 040,E02007008,5438,5199,133,94,39,54,16,38,52
2021,Lewisham 041,E02007009,8547,8016,239,175,64,158,68,90,134
2021,Bedford 021,E02007010,7912,7273,327,231,96,114,59,55,198
2021,Bedford 022,E02007011,6927,6456,227,164,63,105,41,64,139
2021,Milton Keynes 033,E02007012,7595,7177,201,144,57,93,39,54,124
2021,Milton Keynes 034,E02007013,9140,8777,192,137,55,92,36,56,79
2021,Milton Keynes 035,E02007014,6670,6244,238,184,54,95,42,53,93
2021,Milton Keynes 036,E02007015,8861,8394,243,179,64,110,59,51,114
2021,Milton Keynes 037,E02007016,8525,8006,275,214,61,111,50,61,133
2021,Redbridge 037,E02007017,8233,7625,291,196,95,139,64,75,178
2021,Redbridge 038,E02007018,6648,6220,193,128,65,126,68,58,109
2021,Redbridge 039,E02007019,6484,6157,127,70,57,101,47,54,99
2021,Redbridge 040,E02007020,9045,8396,266,137,129,204,97,107,179
2021,Oxford 020,E02007021,8033,7510,256,177,79,101,50,51,166
2021,County Durham 067,E02007022,11735,10568,611,469,142,211,101,110,345
2021,Wiltshire 063,E02007023,7352,6690,271,187,84,153,68,85,238
2021,Wiltshire 064,E02007024,6614,6034,293,228,65,102,53,49,185
2021,Wiltshire 065,E02007025,7940,7364,277,199,78,129,53,76,170
2021,Wiltshire 066,E02007026,7925,7543,135,96,39,101,48,53,146
2021,East Devon 021,E02007027,10149,9180,560,409,151,150,70,80,259
2021,East Devon 022,E02007028,5416,5061,160,113,47,94,36,58,101
2021,Derbyshire Dales 011,E02007029,10659,9583,600,453,147,172,83,89,304
2021,Cheshire East 052,E02007030,6978,6388,332,259,73,106,54,52,152
2021,Cheshire East 053,E02007031,8240,7541,430,328,102,107,46,61,162
2021,North Norfolk 015,E02007032,6533,5873,308,219,89,138,65,73,214
2021,North Norfolk 016,E02007033,5922,5320,295,213,82,114,59,55,193
2021,Tewkesbury 010,E02007034,7569,7066,284,216,68,97,52,45,122
2021,Tewkesbury 011,E02007035,7440,6787,371,287,84,94,58,36,188
2021,Birmingham 141,E02007038,12735,11585,438,299,139,303,135,168,409
2021,Birmingham 142,E02007039,7562,6945,209,117,92,216,104,112,192
2021,Birmingham 143,E02007040,6934,6461,155,90,65,167,72,95,151
2021,Craven 009,E02007041,9832,8902,585,464,121,133,72,61,212
2021,Hambleton 012,E02007042,6690,6008,362,273,89,114,53,61,206
2021,Hambleton 013,E02007043,5979,5428,252,174,78,106,48,58,193
2021,Ryedale 009,E02007044,7301,6746,271,191,80,138,58,80,146
2021,Ryedale 010,E02007045,6448,5909,310,241,69,92,48,44,137
2021,Ashford 015,E02007046,6617,5992,282,207,75,126,48,78,217
2021,Ashford 016,E02007047,8234,7602,341,256,85,124,54,70,167
2021,Rugby 013,E02007048,7159,6483,402,277,125,113,59,54,161
2021,Rugby 014,E02007049,7330,6895,245,190,55,85,38,47,105
2021,Telford and Wrekin 024,E02007050,7664,7047,311,236,75,133,49,84,173
2021,Telford and Wrekin 025,E02007051,7900,7225,357,263,94,133,61,72,185
2021,Norwich 016,E02007052,6123,5693,223,175,48,90,43,47,117
2021,Norwich 017,E02007053,5935,5592,213,166,47,53,30,23,77
2021,South Norfolk 016,E02007054,8002,7385,312,241,71,129,50,79,176
2021,South Norfolk 017,E02007055,7246,6511,357,265,92,146,75,71,232
2021,Colchester 023,E02007056,7893,7414,266,194,72,110,35,75,103
2021,Colchester 024,E02007057,7063,6614,250,183,67,89,40,49,110
2021,Darlington 016,E02007058,10869,9960,422,296,126,232,88,144,255
2021,Hartlepool 015,E02007059,10084,9029,446,295,151,249,110,139,360
2021,Stockton-on-Tees 025,E02007060,5588,5117,153,105,48,139,60,79,179
2021,Stockton-on-Tees 026,E02007061,7697,7112,216,143,73,179,84,95,190
2021,Stockton-on-Tees 027,E02007062,7115,6618,262,191,71,97,40,57,138
2021,Stockton-on-Tees 028,E02007063,8658,7982,415,312,103,120,64,56,141
2021,South Gloucestershire 033,E02007064,7427,6730,353,248,105,138,62,76,206
2021,South Gloucestershire 034,E02007065,7176,6687,223,162,61,103,40,63,163
2021,South Gloucestershire 035,E02007066,8718,8346,210,156,54,69,38,31,93
2021,South Gloucestershire 036,E02007067,6515,5998,320,243,77,86,43,43,111
2021,Slough 015,E02007068,6442,6071,147,102,45,117,59,58,107
2021,Slough 016,E02007069,7525,6980,218,143,75,162,81,81,165
2021,North Northamptonshire 020,E02007070,6106,5574,279,213,66,93,48,45,160
2021,North Northamptonshire 023,E02007071,9752,8897,456,332,124,176,79,97,223
2021,West Northamptonshire 035,E02007072,7054,6595,230,172,58,103,43,60,126
2021,West Northamptonshire 039,E02007073,7174,6648,281,214,67,102,48,54,143
2021,Southampton 033,E02007074,8239,7912,135,98,37,108,51,57,84
2021,Southampton 034,E02007075,5087,4866,147,113,34,33,10,23,41
2021,Test Valley 016,E02007076,6943,6436,253,188,65,114,48,66,140
2021,Test Valley 017,E02007077,6682,6218,205,152,53,108,40,68,151
2021,Test Valley 018,E02007078,4824,4411,202,156,46,89,40,49,122
2021,Kingston upon Hull 034,E02007079,7713,7057,227,123,104,148,58,90,281
2021,Kingston upon Hull 035,E02007080,7827,7358,272,195,77,88,29,59,109
2021,North East Lincolnshire 024,E02007081,9669,8805,415,298,117,204,76,128,245
2021,Nottingham 041,E02007082,16216,15077,610,460,150,201,105,96,328
2021,Wandsworth 038,E02007083,7249,6935,169,121,48,81,40,41,64
2021,Wandsworth 039,E02007084,9401,8784,302,212,90,157,79,78,158
2021,South Cambridgeshire 022,E02007085,11347,10376,627,504,123,138,66,72,206
2021,Cambridge 015,E02007086,10147,9529,304,236,68,127,45,82,187
2021,Cambridge 014,E02007087,6050,5723,211,170,41,45,18,27,71
2021,North Hertfordshire 016,E02007088,7328,6645,447,358,89,91,47,44,145
2021,North Hertfordshire 017,E02007089,6931,6370,309,229,80,113,45,68,139
2021,St Albans 021,E02007090,5917,5397,290,242,48,85,41,44,145
2021,Stevenage 013,E02007091,6080,5523,332,252,80,96,53,43,129
2021,Welwyn Hatfield 017,E02007092,5240,4783,233,174,59,110,55,55,114
2021,East Hertfordshire 019,E02007093,7719,7030,387,300,87,108,63,45,194
2021,Gateshead 029,E02007094,6566,5838,297,190,107,183,77,106,248
2021,Newcastle upon Tyne 032,E02007095,9075,8350,359,262,97,153,66,87,213
2021,Newcastle upon Tyne 033,E02007096,5664,5134,282,211,71,87,43,44,161
2021,Newcastle upon Tyne 034,E02007097,8501,8105,253,202,51,63,25,38,80
2021,Newcastle upon Tyne 035,E02007098,6109,5510,184,112,72,154,64,90,261
2021,Newcastle upon Tyne 036,E02007099,10135,9788,212,157,55,66,30,36,69
2021,Newcastle upon Tyne 037,E02007100,8325,8021,181,155,26,67,27,40,56
2021,Newcastle upon Tyne 038,E02007101,8668,8163,145,88,57,170,48,122,190
2021,Newcastle upon Tyne 039,E02007102,7247,6851,173,115,58,115,50,65,108
2021,Newcastle upon Tyne 040,E02007103,6066,5595,178,122,56,132,50,82,161
2021,Newcastle upon Tyne 041,E02007104,5156,4754,98,59,39,145,76,69,159
2021,Northumberland 041,E02007105,11886,10591,604,404,200,311,145,166,380
2021,Northumberland 042,E02007106,13866,12525,725,550,175,247,111,136,369
2021,Northumberland 043,E02007107,8486,7631,509,382,127,128,66,62,218
2021,Hackney 030,E02007108,5681,5428,132,98,34,62,30,32,59
2021,Hackney 031,E02007109,7224,6680,239,176,63,143,63,80,162
2021,Hackney 032,E02007110,7001,6600,192,147,45,96,47,49,113
2021,Hackney 033,E02007111,5807,5588,115,93,22,60,25,35,44
2021,Tower Hamlets 034,E02007112,5626,5449,89,67,22,50,17,33,38
2021,Tower Hamlets 035,E02007113,6970,6648,150,112,38,89,35,54,83
2021,Tower Hamlets 036,E02007114,7169,6805,168,105,63,120,45,75,76
2021,Camden 029,E02007115,11205,10430,396,274,122,161,89,72,218
2021,Oxford 019,E02007116,7758,7259,288,209,79,119,47,72,92
2021,Isle of Anglesey 001,W02000001,8011,7131,354,245,109,176,77,99,350
2021,Isle of Anglesey 002,W02000002,6116,5476,302,205,97,114,58,56,224
2021,Isle of Anglesey 003,W02000003,9999,8956,384,261,123,293,122,171,366
2021,Isle of Anglesey 004,W02000004,7116,6358,352,272,80,141,79,62,265
2021,Isle of Anglesey 005,W02000005,7898,7002,422,298,124,162,85,77,312
2021,Isle of Anglesey 006,W02000006,6615,6022,278,179,99,132,54,78,183
2021,Isle of Anglesey 007,W02000007,6522,5878,281,181,100,132,62,70,231
2021,Isle of Anglesey 008,W02000008,5732,5224,265,192,73,84,39,45,159
2021,Isle of Anglesey 009,W02000009,7662,6875,389,286,103,141,82,59,257
2021,Gwynedd 001,W02000010,8375,7960,216,166,50,83,35,48,116
2021,Gwynedd 002,W02000011,7880,7199,293,221,72,163,69,94,225
2021,Gwynedd 003,W02000012,7784,7059,344,258,86,135,82,53,246
2021,Gwynedd 004,W02000013,6097,5572,260,189,71,79,43,36,186
2021,Gwynedd 005,W02000014,6422,5792,315,237,78,107,53,54,208
2021,Gwynedd 006,W02000015,7973,7289,274,205,69,151,58,93,259
2021,Gwynedd 007,W02000016,6043,5498,226,166,60,125,69,56,194
2021,Gwynedd 008,W02000017,7188,6411,346,227,119,190,90,100,241
2021,Gwynedd 009,W02000018,5776,5280,207,147,60,89,43,46,200
2021,Gwynedd 010,W02000019,6393,5825,275,189,86,96,49,47,197
2021,Gwynedd 011,W02000020,6189,5596,260,166,94,111,50,61,222
2021,Gwynedd 012,W02000021,7424,6791,270,187,83,104,45,59,259
2021,Gwynedd 013,W02000022,5355,4806,271,192,79,83,34,49,195
2021,Gwynedd 014,W02000023,5069,4643,200,137,63,79,39,40,147
2021,Gwynedd 015,W02000024,5445,5002,214,151,63,76,27,49,153
2021,Gwynedd 016,W02000025,5882,5306,272,206,66,106,42,64,198
2021,Gwynedd 017,W02000026,6751,6023,323,222,101,139,75,64,266
2021,Conwy 001,W02000027,8152,7327,337,223,114,190,91,99,298
2021,Conwy 002,W02000028,6430,5785,287,196,91,125,69,56,233
2021,Conwy 003,W02000029,5762,5197,290,210,80,86,49,37,189
2021,Conwy 004,W02000030,5669,5090,257,182,75,120,62,58,202
2021,Conwy 005,W02000031,7850,6812,341,218,123,223,95,128,474
2021,Conwy 006,W02000032,8035,7202,373,283,90,143,72,71,317
2021,Conwy 007,W02000033,6565,5905,279,180,99,153,71,82,228
2021,Conwy 008,W02000034,7347,6581,388,291,97,144,68,76,234
2021,Conwy 009,W02000035,8437,7473,421,292,129,206,81,125,337
2021,Conwy 010,W02000036,10783,9421,537,358,179,282,134,148,543
2021,Conwy 011,W02000037,6767,6092,310,225,85,128,51,77,237
2021,Conwy 012,W02000038,5984,5379,301,222,79,97,52,45,207
2021,Conwy 013,W02000039,7484,6742,348,251,97,150,74,76,244
2021,Conwy 014,W02000040,6320,5725,301,214,87,99,51,48,195
2021,Conwy 015,W02000041,8130,7341,388,280,108,141,73,68,260
2021,Denbighshire 001,W02000042,5598,4864,268,167,101,159,73,86,307
2021,Denbighshire 002,W02000043,4996,4407,201,140,61,134,62,72,254
2021,Denbighshire 003,W02000044,5088,4512,239,149,90,102,57,45,235
2021,Denbighshire 004,W02000045,9000,7854,349,217,132,327,120,207,470
2021,Denbighshire 006,W02000047,5157,4559,165,89,76,167,66,101,266
2021,Denbighshire 008,W02000049,6343,5607,340,231,109,143,65,78,253
2021,Denbighshire 009,W02000050,6100,5446,291,192,99,132,72,60,231
2021,Denbighshire 010,W02000051,5086,4507,282,206,76,102,53,49,195
2021,Denbighshire 011,W02000052,4708,4175,216,145,71,140,62,78,177
2021,Denbighshire 012,W02000053,6047,5422,307,212,95,124,58,66,194
2021,Denbighshire 013,W02000054,5891,5249,348,269,79,108,59,49,186
2021,Denbighshire 014,W02000055,5399,4915,258,173,85,86,41,45,140
2021,Denbighshire 015,W02000056,4954,4491,234,172,62,99,49,50,130
2021,Denbighshire 016,W02000057,5981,5371,309,232,77,107,56,51,194
2021,Flintshire 001,W02000058,4904,4239,290,195,95,121,55,66,254
2021,Flintshire 002,W02000059,6251,5476,387,282,105,154,72,82,234
2021,Flintshire 003,W02000060,10129,9050,397,252,145,276,126,150,406
2021,Flintshire 004,W02000061,7138,6398,292,197,95,202,99,103,246
2021,Flintshire 005,W02000062,5841,5222,291,201,90,126,60,66,202
2021,Flintshire 006,W02000063,7849,6904,519,378,141,177,94,83,249
2021,Flintshire 007,W02000064,5782,5207,209,146,63,137,55,82,229
2021,Flintshire 008,W02000065,6880,6173,337,235,102,137,67,70,233
2021,Flintshire 009,W02000066,9270,8327,362,246,116,219,91,128,362
2021,Flintshire 010,W02000067,6489,5842,322,230,92,115,59,56,210
2021,Flintshire 011,W02000068,4964,4456,213,155,58,115,52,63,180
2021,Flintshire 012,W02000069,5978,5345,364,265,99,84,41,43,185
2021,Flintshire 013,W02000070,10194,9205,530,369,161,186,82,104,273
2021,Flintshire 014,W02000071,6759,6069,362,244,118,115,56,59,213
2021,Flintshire 015,W02000072,11011,9972,523,383,140,219,115,104,297
2021,Flintshire 016,W02000073,9683,8759,488,355,133,173,80,93,263
2021,Flintshire 017,W02000074,9318,8402,442,322,120,177,88,89,297
2021,Flintshire 018,W02000075,6062,5516,328,246,82,90,44,46,128
2021,Flintshire 019,W02000076,7011,6282,373,257,116,124,57,67,232
2021,Flintshire 020,W02000077,5823,5230,301,215,86,110,59,51,182
2021,Wrexham 003,W02000080,7428,6644,310,213,97,204,89,115,270
2021,Wrexham 004,W02000081,5559,4979,242,148,94,135,46,89,203
2021,Wrexham 005,W02000082,7193,6457,320,227,93,146,56,90,270
2021,Wrexham 006,W02000083,8164,7429,326,235,91,178,83,95,231
2021,Wrexham 008,W02000085,8558,7718,401,279,122,177,83,94,262
2021,Wrexham 010,W02000087,6371,5714,207,135,72,186,80,106,264
2021,Wrexham 011,W02000088,8217,7582,306,205,101,134,45,89,195
2021,Wrexham 012,W02000089,8054,7381,263,175,88,166,75,91,244
2021,Wrexham 013,W02000090,5418,4770,264,189,75,140,58,82,244
2021,Wrexham 014,W02000091,5873,5261,284,184,100,131,64,67,197
2021,Wrexham 015,W02000092,6377,5723,252,161,91,161,79,82,241
2021,Wrexham 016,W02000093,6235,5546,364,260,104,145,64,81,180
2021,Wrexham 017,W02000094,8378,7448,351,236,115,205,88,117,374
2021,Wrexham 018,W02000095,6150,5532,332,248,84,121,60,61,165
2021,Wrexham 019,W02000096,6184,5538,302,212,90,118,63,55,226
2021,Powys 001,W02000097,8924,8104,445,341,104,139,86,53,236
2021,Powys 002,W02000098,5985,5392,321,228,93,87,48,39,185
2021,Powys 003,W02000099,6326,5742,260,166,94,127,61,66,197
2021,Powys 004,W02000100,5947,5301,330,230,100,102,47,55,214
2021,Powys 005,W02000101,5287,4706,312,225,87,100,58,42,169
2021,Powys 006,W02000102,5911,5259,327,228,99,120,65,55,205
2021,Powys 007,W02000103,5525,4927,331,244,87,105,60,45,162
2021,Powys 008,W02000104,5926,5338,306,219,87,103,49,54,179
2021,Powys 009,W02000105,4824,4275,216,142,74,121,47,74,212
2021,Powys 010,W02000106,6232,5611,338,249,89,103,50,53,180
2021,Powys 011,W02000107,9394,8411,525,372,153,148,69,79,310
2021,Powys 012,W02000108,6907,6119,388,280,108,152,82,70,248
2021,Powys 013,W02000109,5381,4828,297,219,78,98,46,52,158
2021,Powys 014,W02000110,6558,5902,349,253,96,124,79,45,183
2021,Powys 015,W02000111,8139,7327,474,347,127,133,69,64,205
2021,Powys 017,W02000113,7858,7099,396,295,101,144,64,80,219
2021,Powys 018,W02000114,6697,5968,420,311,109,116,58,58,193
2021,Ceredigion 001,W02000116,7083,6309,402,300,102,136,66,70,236
2021,Ceredigion 002,W02000117,8821,8305,308,240,68,92,54,38,116
2021,Ceredigion 003,W02000118,6158,5608,259,185,74,111,61,50,180
2021,Ceredigion 005,W02000120,6773,6002,373,265,108,144,84,60,254
2021,Ceredigion 007,W02000122,6086,5394,325,206,119,117,62,55,250
2021,Ceredigion 008,W02000123,7360,6523,389,289,100,170,86,84,278
2021,Ceredigion 009,W02000124,8297,7304,455,321,134,199,92,107,339
2021,Ceredigion 010,W02000125,7155,6314,383,254,129,157,80,77,301
2021,Pembrokeshire 001,W02000126,7897,7042,420,312,108,168,74,94,267
2021,Pembrokeshire 002,W02000127,9227,8191,472,332,140,208,79,129,356
2021,Pembrokeshire 003,W02000128,6978,6252,372,278,94,137,74,63,217
2021,Pembrokeshire 004,W02000129,6894,6135,383,279,104,138,64,74,238
2021,Pembrokeshire 005,W02000130,6293,5723,238,159,79,133,56,77,199
2021,Pembrokeshire 006,W02000131,6824,6109,320,226,94,144,64,80,251
2021,Pembrokeshire 007,W02000132,6699,6022,335,235,100,126,69,57,216
2021,Pembrokeshire 008,W02000133,7960,7073,441,315,126,162,76,86,284
2021,Pembrokeshire 009,W02000134,7963,7055,403,280,123,213,109,104,292
2021,Pembrokeshire 010,W02000135,6944,6186,309,210,99,192,93,99,257
2021,Pembrokeshire 011,W02000136,8026,7095,420,298,122,194,92,102,317
2021,Pembrokeshire 012,W02000137,7013,6222,313,203,110,178,75,103,300
2021,Pembrokeshire 013,W02000138,9144,8148,368,251,117,260,113,147,368
2021,Pembrokeshire 014,W02000139,7435,6545,416,296,120,155,74,81,319
2021,Pembrokeshire 015,W02000140,6882,6092,319,219,100,171,75,96,300
2021,Pembrokeshire 016,W02000141,5605,4998,295,221,74,118,59,59,194
2021,Carmarthenshire 001,W02000142,5297,4713,250,172,78,124,70,54,210
2021,Carmarthenshire 002,W02000143,5371,4790,278,192,86,122,70,52,181
2021,Carmarthenshire 003,W02000144,7337,6498,375,279,96,168,83,85,296
2021,Carmarthenshire 004,W02000145,6834,6124,355,249,106,119,44,75,236
2021,Carmarthenshire 005,W02000146,6297,5577,364,266,98,134,68,66,222
2021,Carmarthenshire 006,W02000147,8061,7258,353,257,96,158,89,69,292
2021,Carmarthenshire 007,W02000148,4934,4449,204,150,54,121,55,66,160
2021,Carmarthenshire 008,W02000149,6137,5574,269,186,83,110,55,55,184
2021,Carmarthenshire 010,W02000151,7010,6177,345,228,117,167,73,94,321
2021,Carmarthenshire 011,W02000152,8264,7276,403,280,123,206,112,94,379
2021,Carmarthenshire 012,W02000153,8323,7354,441,294,147,192,95,97,336
2021,Carmarthenshire 013,W02000154,7432,6514,387,274,113,218,120,98,313
2021,Carmarthenshire 015,W02000156,8004,7067,391,254,137,193,94,99,353
2021,Carmarthenshire 016,W02000157,9546,8447,475,313,162,218,105,113,406
2021,Carmarthenshire 017,W02000158,5554,4915,313,220,93,117,59,58,209
2021,Carmarthenshire 018,W02000159,5917,5112,291,179,112,172,88,84,342
2021,Carmarthenshire 019,W02000160,7301,6375,404,269,135,192,101,91,330
2021,Carmarthenshire 020,W02000161,4954,4413,197,128,69,142,70,72,202
2021,Carmarthenshire 021,W02000162,7932,6907,438,298,140,224,110,114,363
2021,Carmarthenshire 022,W02000163,5054,4540,212,149,63,85,29,56,217
2021,Carmarthenshire 023,W02000164,7076,6297,362,245,117,169,74,95,248
2021,Carmarthenshire 024,W02000165,6214,5511,282,180,102,133,51,82,288
2021,Carmarthenshire 025,W02000166,8580,7563,376,238,138,241,107,134,400
2021,Carmarthenshire 026,W02000167,9688,8532,408,276,132,279,123,156,469
2021,Swansea 001,W02000168,6199,5450,345,229,116,164,69,95,240
2021,Swansea 002,W02000169,8710,7635,440,288,152,234,114,120,401
2021,Swansea 003,W02000170,8306,7372,402,262,140,173,82,91,359
2021,Swansea 004,W02000171,7978,7082,487,360,127,136,78,58,273
2021,Swansea 005,W02000172,9712,8573,513,347,166,258,123,135,368
2021,Swansea 006,W02000173,7516,6662,393,273,120,182,82,100,279
2021,Swansea 007,W02000174,9133,8038,496,329,167,229,112,117,370
2021,Swansea 008,W02000175,6979,6126,369,236,133,163,77,86,321
2021,Swansea 009,W02000176,8456,7380,410,265,145,226,104,122,440
2021,Swansea 010,W02000177,6597,5813,346,241,105,136,72,64,302
2021,Swansea 011,W02000178,8223,7319,265,152,113,237,101,136,402
2021,Swansea 012,W02000179,6218,5492,383,255,128,136,59,77,207
2021,Swansea 013,W02000180,7511,6589,282,157,125,249,115,134,391
2021,Swansea 014,W02000181,6952,6133,316,196,120,189,82,107,314
2021,Swansea 015,W02000182,7148,6333,327,198,129,209,101,108,279
2021,Swansea 016,W02000183,9702,8805,357,252,105,208,95,113,332
2021,Swansea 017,W02000184,6437,5681,318,203,115,163,83,80,275
2021,Swansea 018,W02000185,4841,4290,278,195,83,83,35,48,190
2021,Swansea 019,W02000186,8014,7123,264,166,98,226,103,123,401
2021,Swansea 021,W02000188,7652,6903,306,210,96,186,99,87,257
2021,Swansea 022,W02000189,7905,7004,442,318,124,172,83,89,287
2021,Swansea 024,W02000191,8490,7746,425,312,113,137,67,70,182
2021,Swansea 025,W02000192,8830,8198,277,201,76,142,56,86,213
2021,Swansea 026,W02000193,8612,8081,274,197,77,106,65,41,151
2021,Swansea 027,W02000194,6317,5784,299,208,91,85,54,31,149
2021,Swansea 028,W02000195,5619,4996,354,250,104,87,46,41,182
2021,Swansea 029,W02000196,6018,5322,315,230,85,151,72,79,230
2021,Swansea 030,W02000197,5897,5247,362,256,106,110,60,50,178
2021,Swansea 031,W02000198,7011,6232,452,329,123,122,65,57,205
2021,Neath Port Talbot 002,W02000200,4889,4253,243,153,90,149,56,93,244
2021,Neath Port Talbot 003,W02000201,5051,4443,228,145,83,120,58,62,260
2021,Neath Port Talbot 004,W02000202,11861,10417,640,423,217,313,145,168,491
2021,Neath Port Talbot 006,W02000204,6360,5570,383,260,123,155,72,83,252
2021,Neath Port Talbot 007,W02000205,5508,4760,313,223,90,177,86,91,258
2021,Neath Port Talbot 008,W02000206,6290,5532,275,185,90,167,85,82,316
2021,Neath Port Talbot 009,W02000207,5020,4420,265,173,92,140,80,60,195
2021,Neath Port Talbot 010,W02000208,12033,10742,595,400,195,276,145,131,420
2021,Neath Port Talbot 012,W02000210,5844,5084,256,164,92,192,96,96,312
2021,Neath Port Talbot 013,W02000211,7321,6432,326,211,115,224,88,136,339
2021,Neath Port Talbot 014,W02000212,7349,6466,349,225,124,219,116,103,315
2021,Neath Port Talbot 015,W02000213,6434,5647,340,214,126,174,85,89,273
2021,Neath Port Talbot 016,W02000214,9184,7981,369,215,154,296,112,184,538
2021,Neath Port Talbot 017,W02000215,8924,7896,325,214,111,285,111,174,418
2021,Neath Port Talbot 018,W02000216,6820,6039,307,198,109,187,101,86,287
2021,Neath Port Talbot 019,W02000217,6076,5374,284,215,69,168,80,88,250
2021,Bridgend 001,W02000218,6263,5479,214,123,91,180,64,116,390
2021,Bridgend 002,W02000219,6868,6110,292,193,99,188,106,82,278
2021,Bridgend 003,W02000220,7567,6662,315,203,112,214,87,127,376
2021,Bridgend 004,W02000221,7278,6365,318,202,116,233,109,124,362
2021,Bridgend 005,W02000222,5918,5179,296,194,102,155,74,81,288
2021,Bridgend 006,W02000223,5686,5108,238,169,69,145,57,88,195
2021,Bridgend 007,W02000224,6121,5411,307,188,119,161,88,73,242
2021,Bridgend 008,W02000225,8433,7385,366,245,121,281,109,172,401
2021,Bridgend 009,W02000226,9565,8524,465,329,136,223,115,108,353
2021,Bridgend 010,W02000227,6942,6128,308,192,116,194,81,113,312
2021,Bridgend 011,W02000228,11335,10402,437,307,130,205,99,106,291
2021,Bridgend 012,W02000229,5828,5146,247,168,79,149,67,82,286
2021,Bridgend 013,W02000230,5431,4838,322,214,108,92,57,35,179
2021,Bridgend 014,W02000231,7881,7116,324,220,104,170,73,97,271
2021,Bridgend 015,W02000232,5442,4879,283,213,70,105,45,60,175
2021,Bridgend 016,W02000233,5852,5196,293,198,95,122,48,74,241
2021,Bridgend 017,W02000234,10108,9068,512,389,123,203,92,111,325
2021,Bridgend 018,W02000235,8896,7937,461,317,144,183,87,96,315
2021,Bridgend 019,W02000236,6723,5901,361,249,112,168,90,78,293
2021,Vale of Glamorgan 001,W02000237,5846,5275,345,272,73,81,47,34,145
2021,Vale of Glamorgan 002,W02000238,6305,5721,315,232,83,77,38,39,192
2021,Vale of Glamorgan 003,W02000239,7628,6870,413,306,107,132,76,56,213
2021,Vale of Glamorgan 004,W02000240,8553,7717,434,304,130,151,69,82,251
2021,Vale of Glamorgan 005,W02000241,9767,8890,523,400,123,140,89,51,214
2021,Vale of Glamorgan 006,W02000242,7780,6980,431,326,105,134,78,56,235
2021,Vale of Glamorgan 007,W02000243,8703,7662,398,250,148,223,106,117,420
2021,Vale of Glamorgan 008,W02000244,9662,8720,488,366,122,177,94,83,277
2021,Vale of Glamorgan 009,W02000245,7785,6930,368,265,103,210,101,109,277
2021,Vale of Glamorgan 010,W02000246,5128,4510,351,264,87,103,56,47,164
2021,Vale of Glamorgan 011,W02000247,8335,7437,458,344,114,145,67,78,295
2021,Vale of Glamorgan 012,W02000248,9909,8837,438,300,138,259,129,130,375
2021,Vale of Glamorgan 013,W02000249,8303,7432,432,307,125,174,75,99,265
2021,Vale of Glamorgan 014,W02000250,11018,9883,544,395,149,219,114,105,372
2021,Vale of Glamorgan 015,W02000251,10359,9301,538,367,171,216,103,113,304
2021,Rhondda Cynon Taf 001,W02000252,8735,7631,383,236,147,249,102,147,472
2021,Rhondda Cynon Taf 002,W02000253,6425,5628,344,239,105,170,75,95,283
2021,Rhondda Cynon Taf 003,W02000254,7506,6638,372,239,133,192,97,95,304
2021,Rhondda Cynon Taf 004,W02000255,6570,5806,285,181,104,183,80,103,296
2021,Rhondda Cynon Taf 005,W02000256,9327,8257,372,236,136,273,119,154,425
2021,Rhondda Cynon Taf 006,W02000257,6869,6070,279,180,99,204,80,124,316
2021,Rhondda Cynon Taf 007,W02000258,5374,4733,239,138,101,144,67,77,258
2021,Rhondda Cynon Taf 008,W02000259,5435,4825,175,103,72,155,74,81,280
2021,Rhondda Cynon Taf 009,W02000260,5416,4755,229,130,99,134,55,79,298
2021,Rhondda Cynon Taf 010,W02000261,7275,6484,300,184,116,188,92,96,303
2021,Rhondda Cynon Taf 011,W02000262,4986,4474,232,144,88,112,39,73,168
2021,Rhondda Cynon Taf 012,W02000263,6001,5283,255,161,94,185,76,109,278
2021,Rhondda Cynon Taf 013,W02000264,5379,4734,220,151,69,160,87,73,265
2021,Rhondda Cynon Taf 014,W02000265,8692,7660,380,240,140,244,98,146,408
2021,Rhondda Cynon Taf 015,W02000266,7072,6264,314,207,107,172,70,102,322
2021,Rhondda Cynon Taf 016,W02000267,6023,5335,246,160,86,159,64,95,283
2021,Rhondda Cynon Taf 017,W02000268,8494,7503,431,298,133,235,107,128,325
2021,Rhondda Cynon Taf 018,W02000269,7782,6884,309,188,121,216,92,124,373
2021,Rhondda Cynon Taf 019,W02000270,6260,5615,294,218,76,128,59,69,223
2021,Rhondda Cynon Taf 020,W02000271,5144,4518,216,132,84,158,66,92,252
2021,Rhondda Cynon Taf 021,W02000272,9416,8397,466,320,146,210,94,116,343
2021,Rhondda Cynon Taf 022,W02000273,9894,8993,341,217,124,220,101,119,340
2021,Rhondda Cynon Taf 023,W02000274,9661,8544,421,264,157,284,126,158,412
2021,Rhondda Cynon Taf 024,W02000275,5752,5156,211,129,82,125,59,66,260
2021,Rhondda Cynon Taf 025,W02000276,6164,5504,277,183,94,130,68,62,253
2021,Rhondda Cynon Taf 026,W02000277,6633,5950,342,211,131,107,55,52,234
2021,Rhondda Cynon Taf 027,W02000278,8520,7685,441,327,114,150,87,63,244
2021,Rhondda Cynon Taf 028,W02000279,7310,6531,345,225,120,161,67,94,273
2021,Rhondda Cynon Taf 029,W02000280,8969,8062,446,321,125,159,73,86,302
2021,Rhondda Cynon Taf 030,W02000281,7156,6387,400,284,116,147,86,61,222
2021,Rhondda Cynon Taf 031,W02000282,10892,9824,558,396,162,205,98,107,305
2021,Merthyr Tydfil 002,W02000284,8763,7808,363,211,152,229,104,125,363
2021,Merthyr Tydfil 003,W02000285,7899,7003,408,255,153,173,85,88,315
2021,Merthyr Tydfil 004,W02000286,6384,5730,210,130,80,201,74,127,243
2021,Merthyr Tydfil 005,W02000287,7871,7046,335,217,118,197,92,105,293
2021,Merthyr Tydfil 006,W02000288,7651,6774,325,193,132,206,89,117,346
2021,Merthyr Tydfil 007,W02000289,8210,7182,403,252,151,239,126,113,386
2021,Caerphilly 001,W02000290,8103,7101,317,194,123,267,98,169,418
2021,Caerphilly 002,W02000291,6680,5920,265,169,96,192,90,102,303
2021,Caerphilly 003,W02000292,5491,4848,239,145,94,133,54,79,271
2021,Caerphilly 004,W02000293,5645,4997,231,140,91,167,74,93,250
2021,Caerphilly 005,W02000294,5366,4705,262,161,101,160,81,79,239
2021,Caerphilly 006,W02000295,9016,8008,424,297,127,223,102,121,361
2021,Caerphilly 007,W02000296,7012,6137,319,190,129,219,91,128,337
2021,Caerphilly 008,W02000297,7063,6164,317,215,102,202,100,102,380
2021,Caerphilly 009,W02000298,6832,6083,304,196,108,167,68,99,278
2021,Caerphilly 010,W02000299,5946,5246,257,162,95,157,77,80,286
2021,Caerphilly 011,W02000300,7959,7028,374,249,125,212,101,111,345
2021,Caerphilly 012,W02000301,7518,6696,290,199,91,182,89,93,350
2021,Caerphilly 013,W02000302,9458,8426,423,293,130,237,115,122,372
2021,Caerphilly 014,W02000303,6737,6016,319,209,110,156,70,86,246
2021,Caerphilly 015,W02000304,5217,4627,239,166,73,137,59,78,214
2021,Caerphilly 016,W02000305,5811,5138,303,212,91,127,56,71,243
2021,Caerphilly 017,W02000306,4847,4272,247,177,70,118,58,60,210
2021,Caerphilly 018,W02000307,6089,5417,287,182,105,153,65,88,232
2021,Caerphilly 019,W02000308,8313,7352,372,254,118,210,88,122,379
2021,Caerphilly 020,W02000309,6443,5671,331,244,87,151,63,88,290
2021,Caerphilly 021,W02000310,5013,4450,246,168,78,143,66,77,174
2021,Caerphilly 022,W02000311,9230,8194,389,259,130,262,118,144,385
2021,Caerphilly 023,W02000312,6906,6057,351,220,131,193,91,102,305
2021,Caerphilly 024,W02000313,10046,9113,485,342,143,172,92,80,276
2021,Blaenau Gwent 001,W02000314,6270,5505,309,201,108,180,77,103,276
2021,Blaenau Gwent 002,W02000315,4983,4449,225,131,94,115,51,64,194
2021,Blaenau Gwent 003,W02000316,6308,5561,268,163,105,176,87,89,303
2021,Blaenau Gwent 004,W02000317,7343,6493,317,210,107,183,84,99,350
2021,Blaenau Gwent 005,W02000318,8588,7611,339,218,121,259,118,141,379
2021,Blaenau Gwent 006,W02000319,7649,6803,311,190,121,219,93,126,316
2021,Blaenau Gwent 007,W02000320,7734,6901,328,222,106,212,100,112,293
2021,Blaenau Gwent 008,W02000321,8152,7187,353,213,140,239,102,137,373
2021,Blaenau Gwent 009,W02000322,6335,5612,252,167,85,170,64,106,301
2021,Torfaen 001,W02000323,5672,5106,218,142,76,147,76,71,201
2021,Torfaen 002,W02000324,6659,5856,298,193,105,175,79,96,330
2021,Torfaen 003,W02000325,6854,6052,296,183,113,182,79,103,324
2021,Torfaen 004,W02000326,8412,7357,458,313,145,245,108,137,352
2021,Torfaen 005,W02000327,5637,4974,316,217,99,148,76,72,199
2021,Torfaen 006,W02000328,7121,6354,345,231,114,154,57,97,268
2021,Torfaen 007,W02000329,7635,6788,385,282,103,192,77,115,270
2021,Torfaen 008,W02000330,6739,5952,359,252,107,155,82,73,273
2021,Torfaen 009,W02000331,6052,5345,257,163,94,174,79,95,276
2021,Torfaen 010,W02000332,7158,6376,268,174,94,214,94,120,300
2021,Torfaen 011,W02000333,5919,5243,299,200,99,128,60,68,249
2021,Torfaen 012,W02000334,6271,5530,353,258,95,149,61,88,239
2021,Torfaen 013,W02000335,7145,6408,368,254,114,135,83,52,234
2021,Monmouthshire 001,W02000336,8164,7378,462,356,106,139,68,71,185
2021,Monmouthshire 002,W02000337,7234,6499,322,214,108,146,85,61,267
2021,Monmouthshire 003,W02000338,8139,7241,466,349,117,157,84,73,275
2021,Monmouthshire 004,W02000339,10573,9512,544,394,150,183,84,99,334
2021,Monmouthshire 005,W02000340,6922,6128,459,360,99,124,80,44,211
2021,Monmouthshire 006,W02000341,8055,7155,518,383,135,141,76,65,241
2021,Monmouthshire 007,W02000342,9017,8145,537,395,142,107,61,46,228
2021,Monmouthshire 008,W02000343,7778,6979,386,284,102,166,84,82,247
2021,Monmouthshire 009,W02000344,8140,7363,448,336,112,142,73,69,187
2021,Monmouthshire 010,W02000345,7623,6779,391,267,124,166,72,94,287
2021,Monmouthshire 011,W02000346,7349,6613,420,308,112,139,71,68,177
2021,Newport 001,W02000347,7620,6794,449,333,116,154,86,68,223
2021,Newport 002,W02000348,7215,6399,373,270,103,157,72,85,286
2021,Newport 003,W02000349,7755,6913,265,170,95,242,88,154,335
2021,Newport 004,W02000350,9331,8384,487,345,142,177,99,78,283
2021,Newport 005,W02000351,5830,5191,296,209,87,133,64,69,210
2021,Newport 006,W02000352,6372,5733,275,184,91,156,70,86,208
2021,Newport 007,W02000353,6824,6139,327,232,95,156,81,75,202
2021,Newport 008,W02000354,5520,4908,252,159,93,135,57,78,225
2021,Newport 009,W02000355,9620,8687,497,352,145,176,88,88,260
2021,Newport 010,W02000356,4910,4334,165,89,76,147,60,87,264
2021,Newport 011,W02000357,7725,7010,278,193,85,186,85,101,251
2021,Newport 012,W02000358,6153,5532,361,280,81,98,56,42,162
2021,Newport 013,W02000359,10840,9895,386,253,133,239,113,126,320
2021,Newport 014,W02000360,6461,5889,286,209,77,105,55,50,181
2021,Newport 015,W02000361,10999,9837,428,297,131,290,131,159,444
2021,Newport 016,W02000362,6587,5879,375,275,100,144,65,79,189
2021,Newport 017,W02000363,5466,4852,261,151,110,145,74,71,208
2021,Newport 018,W02000364,8633,7986,207,125,82,226,101,125,214
2021,Newport 019,W02000365,7972,7238,291,202,89,184,77,107,259
2021,Newport 020,W02000366,8025,7282,420,295,125,131,74,57,192
2021,Cardiff 001,W02000367,5851,5295,358,260,98,76,48,28,122
2021,Cardiff 002,W02000368,5389,4832,353,277,76,97,49,48,107
2021,Cardiff 003,W02000369,9024,8306,406,307,99,135,66,69,177
2021,Cardiff 004,W02000370,6275,5587,416,314,102,96,53,43,176
2021,Cardiff 005,W02000371,8597,7823,349,261,88,158,76,82,267
2021,Cardiff 006,W02000372,7874,7224,372,293,79,116,60,56,162
2021,Cardiff 007,W02000373,6587,5897,299,202,97,162,84,78,229
2021,Cardiff 008,W02000374,5611,5017,323,244,79,106,59,47,165
2021,Cardiff 009,W02000375,6830,6194,280,159,121,140,72,68,216
2021,Cardiff 010,W02000376,6295,5742,326,253,73,82,49,33,145
2021,Cardiff 011,W02000377,7265,6589,301,209,92,153,76,77,222
2021,Cardiff 012,W02000378,7104,6409,408,303,105,104,47,57,183
2021,Cardiff 013,W02000379,5989,5374,174,120,54,172,75,97,269
2021,Cardiff 014,W02000380,7516,6759,442,339,103,121,67,54,194
2021,Cardiff 015,W02000381,6147,5478,274,178,96,138,54,84,257
2021,Cardiff 016,W02000382,5598,5014,204,117,87,149,61,88,231
2021,Cardiff 017,W02000383,7085,6374,313,210,103,147,69,78,251
2021,Cardiff 018,W02000384,5388,4887,300,244,56,76,41,35,125
2021,Cardiff 019,W02000385,6581,6022,331,238,93,102,66,36,126
2021,Cardiff 020,W02000386,7225,6485,399,309,90,115,57,58,226
2021,Cardiff 021,W02000387,5564,5019,311,223,88,79,44,35,155
2021,Cardiff 022,W02000388,5495,4900,283,183,100,116,51,65,196
2021,Cardiff 023,W02000389,7959,7122,371,278,93,166,83,83,300
2021,Cardiff 024,W02000390,5991,5467,292,229,63,91,58,33,141
2021,Cardiff 025,W02000391,9099,8654,222,169,53,99,49,50,124
2021,Cardiff 026,W02000392,8441,7684,471,340,131,118,61,57,168
2021,Cardiff 027,W02000393,6165,5557,253,176,77,140,67,73,215
2021,Cardiff 028,W02000394,9378,9049,200,156,44,64,36,28,65
2021,Cardiff 029,W02000395,6285,5805,246,179,67,86,40,46,148
2021,Cardiff 030,W02000396,7257,6800,258,188,70,98,42,56,101
2021,Cardiff 031,W02000397,6149,5495,294,210,84,164,91,73,196
2021,Cardiff 032,W02000398,12091,11763,215,158,57,69,37,32,44
2021,Cardiff 033,W02000399,10452,9891,293,208,85,115,61,54,153
2021,Cardiff 034,W02000400,6034,5629,247,189,58,73,33,40,85
2021,Cardiff 035,W02000401,5641,5154,278,203,75,90,48,42,119
2021,Cardiff 036,W02000402,11011,10267,327,230,97,211,95,116,206
2021,Cardiff 037,W02000403,7271,6566,274,184,90,195,86,109,236
2021,Cardiff 038,W02000404,5973,5449,224,144,80,156,67,89,144
2021,Cardiff 039,W02000405,7063,6299,208,128,80,244,87,157,312
2021,Cardiff 040,W02000406,9518,8785,379,280,99,152,72,80,202
2021,Cardiff 041,W02000407,6178,5492,239,147,92,193,78,115,254
2021,Cardiff 042,W02000408,7019,6476,246,152,94,152,72,80,145
2021,Cardiff 043,W02000409,5676,5059,233,157,76,157,78,79,227
2021,Cardiff 044,W02000410,8138,7526,263,168,95,151,75,76,198
2021,Cardiff 045,W02000411,6205,5478,272,177,95,190,93,97,265
2021,Cardiff 046,W02000412,6413,5831,255,162,93,157,72,85,170
2021,Powys 020,W02000414,5764,5084,389,291,98,97,47,50,194
2021,Merthyr Tydfil 008,W02000415,8760,7783,285,168,117,263,115,148,429
2021,Powys 021,W02000416,9850,8584,508,354,154,303,135,168,455
2021,Neath Port Talbot 020,W02000417,9640,8393,477,291,186,310,135,175,460
2021,Carmarthenshire 027,W02000418,11729,10471,602,429,173,232,133,99,424
2021,Denbighshire 017,W02000419,10694,9500,440,291,149,261,135,126,493
2021,Ceredigion 011,W02000421,11032,9761,686,519,167,199,103,96,386
2021,Cardiff 048,W02000422,7023,6684,204,153,51,66,36,30,69
2021,Cardiff 049,W02000423,9538,9043,208,138,70,129,62,67,158
2021,Wrexham 021,W02000424,6440,5802,344,248,96,112,63,49,182
2021,Wrexham 022,W02000425,8071,7343,387,297,90,126,69,57,215
2021,Wrexham 023,W02000426,9447,8394,494,347,147,186,88,98,373
2021,Neath Port Talbot 021,W02000427,10638,9239,475,274,201,345,143,202,579
2021,Swansea 032,W02000428,10083,8946,592,411,181,208,108,100,337
